bigram,2022-10-01,2022-11-01,2022-12-01,2023-01-01,2023-02-01,2023-03-01,2023-04-01,Total
climate change,20,53,19,29,22,22,7,172
greenhouse gas,3,23,5,6,5,9,2,53
natural gas,4,5,3,7,3,0,0,22
gas emissions,2,20,6,5,3,6,2,44
fossil fuels,6,10,3,8,7,5,2,41
renewable energy,4,6,6,5,7,4,1,33
global warming,2,21,3,9,2,4,2,43
united nations,1,18,5,4,3,7,1,39
colorado river,2,1,0,1,3,3,0,10
fossil fuel,1,10,4,5,7,1,1,29
climate conference,1,16,3,3,1,0,0,24
developing countries,1,13,1,0,1,2,0,18
los angeles,0,1,2,3,4,4,0,14
biden administration,2,5,7,2,2,7,0,25
clean energy,1,11,3,4,4,3,1,27
federal government,6,6,3,5,6,2,0,28
gas stoves,0,1,0,4,1,0,0,6
sea level,6,13,0,3,3,3,1,29
extreme weather,7,8,0,4,4,5,1,29
weather service,2,2,0,7,7,2,1,21
white house,4,5,0,2,1,4,0,16
level rise,6,10,0,3,3,2,1,25
president biden,3,5,1,3,0,6,0,18
responsible solar,0,0,0,0,1,0,0,1
heat pumps,0,0,0,0,0,1,1,2
world leaders,0,13,0,1,1,4,1,20
hurricane ian,5,4,1,2,1,0,0,13
national weather,2,3,0,6,6,2,1,20
carbon dioxide,2,5,1,2,4,2,1,17
puerto rico,1,2,0,3,1,0,0,7
english language,0,1,2,2,1,0,0,6
language spoken,0,1,2,2,1,0,0,6
low income,0,8,1,6,1,2,0,18
carbon emissions,5,9,1,3,3,1,0,22
coal plants,0,2,2,1,1,1,0,7
power plants,1,4,3,3,5,3,0,19
degrees celsius,1,7,1,4,1,3,1,18
heat waves,0,11,1,2,1,5,0,20
salt lake,0,0,0,1,2,0,0,3
el sheikh,1,13,0,2,0,0,0,16
electric vehicles,1,1,4,4,2,3,1,16
sharm el,1,13,0,2,0,0,0,16
climate action,4,8,1,4,1,3,0,21
al jaber,0,0,0,3,0,1,0,4
alabama power,0,0,1,0,0,0,0,1
climate crisis,0,9,3,0,4,2,0,18
climate scientists,1,5,0,4,2,2,2,16
heat pump,0,0,0,0,0,1,1,2
income countries,0,9,0,0,2,1,0,12
inflation reduction,1,6,5,2,0,3,2,19
reduction act,1,6,5,2,0,3,2,19
southern california,1,0,1,4,3,4,0,13
u.n climate,2,14,0,2,0,0,0,18
climate activists,1,2,1,3,1,3,0,11
cultivated meat,0,2,0,0,0,0,0,2
gas stove,0,0,0,4,1,0,0,5
heavy rain,1,6,0,4,2,3,0,16
washington d.c,2,4,0,1,3,3,0,13
rising seas,2,5,1,1,3,1,0,13
upside foods,0,2,0,0,0,0,0,2
atmospheric rivers,0,0,0,4,1,7,1,13
climate goals,0,7,2,2,1,3,0,15
climate policy,0,7,1,1,1,0,2,12
northern bangladesh,0,0,0,0,0,1,0,1
winter storm,1,0,0,4,6,1,0,12
european union,1,8,0,1,0,4,1,15
public health,0,4,2,3,1,1,1,12
climate scientist,1,2,0,6,1,4,1,15
dead sea,0,1,0,0,0,0,0,1
degrees fahrenheit,0,1,1,5,3,2,1,13
planet money,0,5,3,1,0,0,0,9
told npr,2,3,2,0,1,5,2,15
fort myers,3,1,0,1,1,0,0,6
ice sheets,1,2,0,0,0,0,0,3
international climate,0,7,0,0,0,2,0,9
polar bears,0,0,1,1,0,2,0,4
president joe,3,3,1,2,2,2,1,14
san francisco,0,3,0,4,1,1,1,10
sierra nevada,0,0,1,2,3,4,0,10
executive director,0,1,1,3,5,3,2,15
florida power,0,0,1,0,0,0,0,1
kirk siegler,2,0,0,0,4,0,0,6
national park,3,1,2,0,0,1,0,7
population growth,0,1,0,0,4,2,0,7
water supply,1,1,0,1,3,3,0,9
joe biden,2,4,1,2,2,1,1,13
power light,0,0,1,0,0,0,0,1
sea levels,2,4,2,0,2,2,0,12
sheikh egypt,0,10,0,1,0,0,0,11
tropical storm,2,3,0,0,0,0,0,5
willow project,0,0,0,0,0,3,0,3
abu dhabi,0,0,0,3,0,1,0,4
aerial view,2,2,2,1,0,1,0,8
air quality,0,1,1,2,3,1,1,9
atmospheric administration,1,1,1,5,2,3,0,13
atmospheric river,0,0,0,5,1,2,0,8
coffee pods,0,0,0,1,0,0,0,1
coral reefs,0,2,3,0,0,1,0,6
cut emissions,0,4,2,1,2,2,1,12
energy transition,1,4,0,0,3,3,0,11
global climate,0,9,0,1,1,0,0,11
heavy snow,0,0,0,2,3,1,0,6
human caused,0,1,0,2,1,5,3,12
human rights,2,3,1,0,2,0,0,8
sea ice,1,1,3,0,1,0,0,6
short wave,1,1,1,2,0,4,0,9
storm surge,4,4,0,0,1,0,1,10
walaa alshaer,0,0,0,0,1,0,0,1
water resources,0,0,1,3,2,3,0,9
weather events,1,4,0,2,2,2,0,11
air pollution,0,1,1,3,3,2,0,10
bottom image,0,1,0,0,0,0,0,1
development banks,1,2,0,0,0,0,0,3
drinking water,1,1,1,2,0,3,1,9
energy prices,0,3,2,1,0,2,0,8
gas industry,1,2,0,2,2,0,1,8
hurricane maria,1,1,0,2,0,0,0,4
low lying,2,2,0,2,2,2,0,10
methane emissions,1,4,1,1,0,0,0,7
million acres,1,0,1,0,0,2,1,5
million people,4,3,0,1,0,3,0,11
national oceanic,1,1,1,5,2,2,0,12
piedmont lithium,0,1,0,0,0,0,0,1
prime minister,1,5,0,0,1,1,0,8
rebecca hersher,1,1,1,3,1,2,0,9
river basin,3,1,0,1,0,0,0,5
short term,2,2,1,4,1,1,0,11
solar panels,0,2,1,2,1,0,0,6
top image,0,1,0,0,0,0,0,1
tyrone turner,0,1,0,0,0,0,0,1
vice president,2,3,0,2,1,1,0,9
warning systems,0,4,0,0,0,1,0,5
water levels,0,1,0,2,0,2,0,5
world bank,2,3,0,0,0,0,0,5
caused climate,0,0,0,2,1,5,3,11
climate disasters,1,4,1,1,2,0,1,10
climate driven,0,5,0,2,0,0,0,7
climate negotiations,0,7,0,1,0,2,0,10
climate science,1,0,0,1,1,3,0,6
climate talks,0,6,1,2,0,1,0,10
cow dung,0,1,0,0,0,1,0,2
developing nations,0,7,1,0,0,0,0,8
district energy,3,0,0,0,0,0,0,3
energy projects,0,1,1,3,2,0,0,7
gas boilers,3,0,0,0,0,0,0,3
jet stream,0,0,0,1,1,1,1,4
nations climate,1,4,1,3,0,0,0,9
north america,4,3,0,0,1,2,0,10
north carolina,1,2,1,0,1,0,0,5
northern california,1,0,1,3,2,2,0,9
rolling fork,0,0,0,0,0,2,0,2
social media,0,1,1,3,0,5,0,10
stop oil,0,1,0,0,0,0,0,1
turner hide,0,1,0,0,0,0,0,1
arab emirates,0,1,0,3,0,2,0,6
burning fossil,1,2,2,2,0,1,1,9
climate related,1,4,2,0,1,0,0,8
coming decades,0,2,1,3,3,0,0,9
developed countries,1,7,2,0,0,0,0,10
electric vehicle,1,3,2,0,2,0,0,8
emergency management,2,2,0,1,2,0,1,8
extreme storms,0,7,0,2,0,0,0,9
future generations,1,2,2,4,0,0,0,9
gas cooking,0,0,0,3,1,0,0,4
greenhouse gases,1,2,0,2,2,2,0,9
hurricane center,1,3,0,0,0,0,0,4
hurricane fiona,1,1,0,1,0,0,0,3
ice sheet,1,1,0,0,0,0,0,2
letzte generation,0,0,1,1,0,0,0,2
low carbon,1,1,0,1,1,2,0,6
myers beach,1,1,0,0,1,0,0,3
national geographic,0,2,1,0,0,0,0,3
petroleum reserve,1,0,0,0,0,3,0,4
potent greenhouse,0,5,1,2,0,0,1,9
rebecca ramirez,1,2,2,2,0,4,0,11
reduce emissions,0,2,1,2,2,2,1,10
siegler npr,2,0,0,0,2,0,0,4
solar projects,0,0,0,1,1,0,0,2
united arab,0,1,0,3,0,2,0,6
world's largest,0,7,0,1,1,0,1,10
central u.s,1,0,0,0,0,0,0,1
changing climate,1,3,1,2,0,1,0,8
children classes,0,0,0,0,1,0,0,1
climate finance,0,4,0,0,0,0,0,4
coalfield children,0,0,0,0,1,0,0,1
concerned scientists,0,3,0,6,0,0,0,9
consulting firm,0,0,2,0,3,0,0,5
consumer product,0,0,0,4,1,0,0,5
diaa hadid,2,0,0,0,0,0,0,2
environmental protection,0,2,1,3,1,1,1,9
extreme heat,0,3,1,3,0,1,0,8
gas plants,0,0,2,1,0,0,0,3
ghansadih mine,0,0,0,0,1,0,0,1
hadid npr,2,0,0,0,0,0,0,2
heat trapping,1,2,1,2,2,0,0,8
heavy rains,2,1,0,4,0,0,0,7
industrialized countries,0,5,0,0,1,2,0,8
lake powell,0,1,0,1,0,2,0,4
local governments,1,1,0,4,0,2,0,8
local officials,1,3,0,2,2,0,0,8
maya lin,0,1,0,0,0,0,0,1
mississippi river,1,2,0,0,0,0,0,3
mount washington,0,0,0,0,2,0,0,2
navajo nation,0,0,0,0,0,2,0,2
nitrogen dioxide,0,0,0,2,1,0,0,3
offshore wind,0,0,0,1,1,0,0,2
page county,0,0,0,0,1,0,0,1
park service,3,0,1,0,0,0,0,4
pattie gonia,1,0,0,0,0,0,0,1
power outages,0,0,0,3,3,1,0,7
private sector,1,6,1,0,1,0,0,9
product safety,0,0,0,4,1,0,0,5
rainfall records,0,0,0,2,0,0,0,2
reduce greenhouse,0,4,1,2,1,2,0,10
regenerative agriculture,0,1,0,0,0,0,0,1
safety commission,0,0,0,4,1,0,0,5
santa barbara,0,0,0,4,1,1,0,6
severe weather,0,3,0,1,0,0,1,5
steam loop,3,0,0,0,0,0,0,3
supply chain,3,1,0,0,1,3,0,8
tackle climate,1,3,3,1,0,1,1,10
whitebark pine,0,0,0,0,0,1,0,1
wildlife crossing,0,0,1,0,0,0,0,1
alabama political,0,0,1,0,0,0,0,1
antarctic peninsula,0,1,0,0,0,0,0,1
billion dollars,0,2,0,2,3,0,0,7
billion people,0,5,0,0,0,2,0,7
biological diversity,1,0,3,0,0,0,0,4
california department,0,0,0,4,0,1,0,5
climate pollution,0,1,0,0,1,3,0,5
climate summit,1,6,0,1,0,0,0,8
cooking stoves,0,0,0,2,1,0,0,3
cultivated meats,0,1,0,0,0,0,0,1
executive producer,0,4,2,1,1,0,0,8
fatima tuj,0,0,0,0,0,1,0,1
federal agencies,4,0,0,1,0,1,0,6
fire country,0,0,1,0,0,0,0,1
friends school,0,0,0,0,1,0,0,1
global temperatures,1,1,1,1,0,0,2,6
hudson bay,0,0,1,0,0,0,0,1
lead author,1,0,1,2,2,1,0,7
limit global,0,4,1,2,0,2,0,9
loop system,3,0,0,0,0,0,0,3
middle east,1,3,0,2,0,2,0,8
mohamed sadek,0,0,0,1,0,0,0,1
monsoon rains,2,2,0,0,0,1,0,5
oil companies,1,0,0,1,2,0,0,4
pacific ocean,1,2,2,2,1,0,0,8
people living,0,2,1,1,2,0,0,6
private investment,0,3,0,0,0,0,0,3
saint louis,0,1,0,0,1,0,0,2
san bernardino,0,0,0,0,2,1,0,3
santa cruz,0,0,0,5,0,2,0,7
scientists warn,0,4,1,1,1,1,0,8
social cost,0,0,0,0,1,0,0,1
supreme court,1,0,1,1,0,1,0,4
tornado hit,0,1,0,0,0,0,1,2
tuj johora,0,0,0,0,0,1,0,1
u.s government,0,1,1,1,3,1,1,8
vast majority,1,1,2,5,0,0,0,9
weather patterns,1,2,0,2,0,1,1,7
west africa,0,1,0,1,1,1,0,4
wind development,0,0,0,1,1,0,0,2
york city,0,1,0,3,1,1,0,6
address climate,0,1,0,0,2,3,1,7
angeles county,0,0,0,0,2,1,0,3
atlantic coast,1,3,0,0,1,0,0,5
barrier reef,0,2,0,0,0,0,0,2
carbon footprint,3,3,0,1,1,0,0,8
climate impacts,1,3,1,0,1,0,1,7
coal fired,1,1,1,0,1,1,0,5
coal power,0,0,1,0,1,1,0,3
coastal communities,1,1,1,0,2,1,1,7
conspiracy theory,0,0,0,0,0,1,0,1
county calif,0,0,0,1,0,4,0,5
cut greenhouse,1,5,0,0,1,0,0,7
dioxide emissions,1,2,1,0,1,0,1,6
emerging economies,0,4,1,0,1,1,0,7
energy agency,0,0,0,2,2,2,1,7
energy systems,3,0,0,0,0,0,0,3
environmental impact,1,1,2,1,0,2,0,7
flash flooding,1,1,0,3,2,0,0,7
food security,0,3,1,0,0,1,0,5
front lines,0,3,1,0,1,2,1,8
fuel industry,0,2,2,1,0,1,0,6
gavin newsom,0,1,1,2,0,4,0,8
global carbon,1,3,0,0,0,3,0,7
google podcasts,0,0,2,2,0,4,0,8
heavy duty,0,1,1,0,0,0,0,2
john kerry,0,5,0,0,1,1,0,7
julia simon,0,0,0,0,1,2,1,4
local news,1,4,1,1,1,0,0,8
lower carbon,3,1,0,0,1,0,0,5
management agency,2,0,0,1,2,0,1,6
michael kaloki,1,1,0,0,0,0,0,2
montecito calif,0,0,0,1,0,0,0,1
monterey county,0,0,0,1,1,1,1,4
mountain lion,0,0,1,0,0,0,0,1
nathan rott,0,1,1,1,0,2,0,5
national oil,0,0,0,1,0,1,0,2
natural resources,2,3,2,0,0,1,0,8
north slope,0,0,0,0,0,3,0,3
oil company,0,0,0,4,1,1,0,6
paris agreement,0,2,0,0,0,3,0,5
parking lot,0,1,0,3,0,1,0,5
parris island,0,1,0,0,0,0,0,1
peace river,1,0,0,0,0,0,0,1
podcasts spotify,0,5,3,0,0,0,0,8
power grid,1,2,0,2,1,0,0,6
pre industrial,1,3,1,1,0,0,1,7
private investors,0,2,0,0,0,0,0,2
sami yenigun,0,4,1,1,1,0,0,7
santa monica,0,0,1,0,0,0,0,1
severe storms,2,0,1,0,1,1,0,5
terry dunn,0,0,1,0,0,0,0,1
truck manufacturers,0,0,1,0,0,1,0,2
twitter facebook,0,5,3,0,0,0,0,8
van nuys,0,0,1,0,0,0,0,1
warmer temperatures,0,2,1,3,1,1,0,8
water level,0,3,0,0,1,1,0,5
water scarcity,0,1,0,0,0,2,1,4
water supplies,1,2,0,1,1,2,0,7
weeks ago,3,0,2,0,0,1,0,6
west valley,0,0,0,0,3,0,0,3
whale deaths,0,0,0,0,1,0,0,1
wind turbines,0,1,1,1,2,0,0,5
world heritage,0,2,0,0,0,0,0,2
world resources,1,6,0,0,0,0,1,8
yellowhammer news,0,0,1,0,0,0,0,1
alaska native,0,0,3,0,0,2,0,5
alex hager,1,1,0,1,0,0,0,3
annenberg wildlife,0,0,1,0,0,0,0,1
annual climate,0,7,0,0,0,0,0,7
antonio guterres,0,4,1,0,0,1,0,6
associate professor,0,0,1,4,0,1,1,7
audio engineer,1,0,2,0,0,4,0,7
barrier islands,2,2,0,0,0,0,0,4
carbon credits,0,3,0,0,0,0,0,3
carbon neutral,0,2,1,2,0,0,0,5
carving team,0,1,0,0,0,0,0,1
change conference,1,4,0,0,0,0,0,5
civil rights,0,1,0,2,0,0,1,4
clean air,3,0,1,0,0,1,0,5
climate legislation,0,1,0,0,0,2,1,4
climate policies,1,1,1,1,0,0,0,4
climate warming,0,2,3,1,0,0,0,6
cold weather,0,0,0,2,3,0,0,5
considerthis npr.org,0,4,1,1,1,0,0,7
countries including,0,3,0,1,0,3,0,7
developing world,0,4,1,0,1,1,0,7
dhabi national,0,0,0,1,0,1,0,2
drop electric,0,5,2,0,0,0,0,7
dust storms,0,0,1,0,2,0,0,3
emission vehicles,0,0,0,0,0,2,0,2
emperor penguins,1,0,0,0,0,0,0,1
environmental justice,0,0,0,1,1,2,1,5
environmental social,0,0,4,0,0,0,1,5
equatorial guinea,0,0,0,0,0,1,0,1
esg investing,0,0,5,0,0,0,0,5
facebook newsletter,0,5,2,0,0,0,0,7
farm bill,0,0,0,1,0,0,1,2
fastest growing,1,0,0,0,4,0,0,5
flood forecasting,0,0,0,0,0,1,0,1
flood prone,1,0,0,2,1,1,0,5
florida politics,0,0,1,0,0,0,0,1
free episodes,0,5,2,0,0,0,0,7
fuel prices,2,1,0,0,1,0,0,4
future climate,0,2,0,1,1,1,0,5
future storms,2,0,0,2,1,0,0,5
gas operations,0,3,0,0,0,0,0,3
gas prices,1,1,2,0,0,0,0,4
heat wave,0,2,0,1,0,1,0,4
hurricane katrina,1,1,0,0,0,0,0,2
ice carving,0,1,0,0,0,0,0,1
indigenous communities,0,0,2,0,0,2,1,5
indigenous people,0,0,3,0,0,2,1,6
infrared burner,0,0,0,1,1,0,0,2
international development,1,2,0,0,1,0,0,4
international energy,0,0,0,1,2,2,1,6
money subscribe,0,5,2,0,0,0,0,7
monica mountains,0,0,1,0,0,0,0,1
national hurricane,1,3,0,0,0,0,0,4
natural world,0,2,2,0,0,0,0,4
news segment,0,4,1,1,1,0,0,7
newsletter subscribe,0,5,2,0,0,0,0,7
oil drilling,0,0,0,0,0,3,0,3
palo alto,0,0,0,0,1,0,0,1
paris climate,1,2,1,1,0,2,0,7
participating regions,0,4,1,1,1,0,0,7
people died,0,1,1,2,0,0,1,5
polar bear,1,0,2,1,0,0,0,4
political reporter,0,0,1,0,0,0,0,1
poorer countries,0,5,0,0,0,1,0,6
powderly texas,0,1,0,0,0,0,0,1
power plant,1,2,1,2,0,0,0,6
president biden's,4,1,0,0,0,0,1,6
production facility,0,2,0,1,0,0,0,3
protection agency,0,1,0,3,1,1,0,6
rainy season,1,1,0,0,0,2,0,4
recent storms,0,0,0,3,0,1,0,4
resources institute,1,5,0,0,0,0,1,7
ricci shryock,0,4,0,1,1,0,0,6
river water,1,0,0,0,2,0,0,3
school playground,0,0,0,1,0,0,0,1
snow carving,0,1,0,0,0,0,0,1
solar company,0,0,0,0,2,0,0,2
solar development,0,1,0,0,1,0,0,2
south carolina,0,4,1,0,1,0,0,6
sponsor free,0,5,2,0,0,0,0,7
spotify apple,0,0,1,2,0,4,0,7
spotify pocketcasts,0,5,2,0,0,0,0,7
sultan al,0,0,0,3,0,1,0,4
vicinity energy,3,0,0,0,0,0,0,3
vulnerable communities,1,2,0,0,0,2,0,5
warming emissions,0,3,1,0,0,1,0,5
warning centre,0,0,0,0,0,1,0,1
washington post,0,2,0,0,0,2,1,5
wind farm,0,3,0,0,1,0,0,4
yeah yeah,2,1,0,3,0,0,0,6
year's climate,0,5,0,0,0,1,0,6
abu dhabi's,0,0,0,2,0,0,0,2
aerial photo,0,1,0,0,0,2,0,3
afp getty,0,1,0,0,0,0,1,2
air force,1,1,0,0,1,0,0,3
anil oza,0,0,0,2,0,4,0,6
annual meetings,1,2,0,0,0,1,1,5
atchison county,1,0,0,0,0,0,0,1
average temperatures,0,0,0,1,0,2,0,3
bad news,2,0,0,0,2,0,0,4
beach fla,0,2,0,0,1,0,0,3
biden administration's,0,1,2,1,0,1,0,5
boko haram,0,0,1,0,0,0,0,1
brian lafoe,0,0,0,2,0,0,0,2
buy food,0,1,1,0,1,0,0,3
caption climate,0,1,2,2,0,1,0,6
carbon fuel,3,0,0,0,1,0,0,4
carbon markets,0,2,0,0,0,0,0,2
carly biedul,0,0,0,0,2,0,0,2
central valley,0,0,0,2,0,2,0,4
climate advocates,0,4,0,0,1,0,0,5
climate agreement,0,2,1,1,0,2,0,6
climate central,1,0,0,1,0,0,0,2
climate envoy,0,1,0,2,0,1,0,4
climate migration,1,3,0,0,1,0,0,5
climate resilience,0,2,2,0,0,0,1,5
co2 emissions,0,2,0,0,0,2,1,5
coal companies,1,0,0,0,0,0,0,1
colorado boulder,0,1,3,1,0,0,1,6
columbia university,0,0,0,0,3,0,0,3
commuter traffic,0,0,1,2,0,0,0,3
computer models,1,0,0,1,1,2,0,5
congo basin,0,0,0,0,0,0,1,1
coral reef,0,3,0,0,0,0,0,3
cruz county,0,0,0,3,0,2,0,5
cultivated chicken,0,2,0,0,0,0,0,2
cutting emissions,1,4,1,0,0,0,0,6
damage caused,1,3,0,0,0,2,0,6
datu odin,1,0,0,0,0,0,0,1
development finance,0,3,0,0,0,0,0,3
driven disasters,0,2,0,2,0,0,0,4
east palo,0,0,0,0,1,0,0,1
eating insects,0,0,0,0,0,1,0,1
economic development,0,3,0,0,1,2,0,6
electric cars,0,3,0,0,0,1,0,4
electric grid,0,1,1,1,2,0,0,5
emissions reductions,2,2,0,0,0,0,0,4
energy sources,0,1,1,2,0,0,1,5
federal judge,0,1,1,0,0,2,0,4
fight climate,0,4,0,0,1,0,0,5
fired power,1,1,1,0,1,1,0,5
food insecurity,1,0,1,0,1,1,0,4
forest loss,0,0,0,0,0,0,1,1
freezing temperatures,0,1,0,0,2,1,1,5
friday night,0,1,0,0,1,1,1,4
frozen ground,0,1,0,2,0,0,0,3
gas infrastructure,2,0,1,0,1,1,0,5
gas pollution,0,2,0,0,2,1,0,5
gas powered,0,0,0,1,2,2,0,5
gaston county,0,1,0,0,0,0,0,1
gisele grayson,1,3,1,0,1,0,0,6
global south,0,3,0,0,1,1,0,5
government agencies,0,3,1,2,0,0,0,6
greenhouse gasses,1,3,1,1,0,0,0,6
growing body,0,0,0,3,1,0,0,4
growth management,1,0,0,0,0,0,0,1
gulf coast,1,2,0,0,1,0,0,4
health risks,0,1,0,2,1,0,0,4
heavy rainfall,1,1,0,1,0,0,0,3
income communities,0,0,1,4,0,1,0,6
infrastructure law,0,0,2,2,0,0,0,4
jeff brady,0,0,0,3,1,0,0,4
journal nature,0,0,2,0,2,1,1,6
la nina,0,0,0,1,0,0,1,2
lake city,0,0,0,1,2,0,0,3
local opposition,0,0,0,0,2,0,0,2
lower income,0,4,0,0,2,0,0,6
maguindanao's datu,1,0,0,0,0,0,0,1
main goal,0,0,5,0,0,1,0,6
mary louise,1,1,1,0,1,0,0,4
meats space,0,1,0,0,0,0,0,1
monastery school,0,1,0,0,0,0,0,1
mount kilimanjaro,0,2,1,0,0,0,0,3
moving forward,0,2,0,0,0,3,1,6
natural disasters,2,1,0,1,1,1,0,6
news conference,1,1,0,1,0,1,1,5
odin sinsuat,1,0,0,0,0,0,0,1
oil project,0,0,0,0,0,2,0,2
palm oil,0,0,0,0,0,0,1,1
photo provided,0,0,0,0,0,3,0,3
planet warming,0,3,0,0,0,1,0,4
police officers,0,0,1,0,1,0,0,2
power company,0,1,1,1,0,0,0,3
president donald,2,0,1,1,1,0,0,5
program director,1,0,0,0,1,3,1,6
public radio,2,0,0,2,2,0,0,6
public radio's,0,1,0,2,2,0,0,5
rachel cleetus,0,2,0,4,0,0,0,6
rainfall data,0,0,0,2,0,0,0,2
real estate,2,0,0,2,0,0,0,4
reducing emissions,1,1,0,0,2,1,0,5
report released,0,5,0,0,0,1,0,6
research suggests,1,3,0,1,0,0,0,5
resources hide,0,0,0,2,0,1,0,3
richard trumka,0,0,0,4,1,0,0,5
rising temperatures,0,3,0,2,0,0,0,5
san diego,1,1,0,1,1,0,0,4
save lives,0,1,0,2,0,2,0,5
shikshan prayog,0,1,0,0,0,0,0,1
shortwave npr.org,1,0,0,2,0,3,0,6
sinsuat town,1,0,0,0,0,0,0,1
slack's students,0,0,0,1,0,0,0,1
special counsel,0,0,0,1,0,0,0,1
square miles,0,2,0,0,1,1,0,4
strong winds,0,0,0,2,3,1,0,6
study published,1,0,3,0,0,1,1,6
surface temperatures,0,0,0,1,0,1,0,2
swayam shikshan,0,1,0,0,0,0,0,1
temperature data,0,0,0,1,0,0,0,1
tree health,0,0,1,0,0,0,0,1
trump administration,0,1,0,1,1,1,0,4
u.n report,0,3,0,0,0,1,0,4
uma valeti,0,1,0,0,0,0,0,1
utility companies,0,0,3,1,0,0,0,4
vicinity energy's,3,0,0,0,0,0,0,3
vulnerable countries,0,4,0,0,0,0,0,4
wallis annenberg,0,0,1,0,0,0,0,1
war ii,3,1,0,1,1,0,0,6
warming climate,0,4,1,0,0,0,1,6
weather forecasts,1,2,0,0,1,0,0,4
western hudson,0,0,1,0,0,0,0,1
wide range,1,0,0,0,0,2,0,3
william troop,0,3,1,1,1,0,0,6
willow oil,0,0,0,0,0,2,0,2
win win,1,1,0,0,1,0,0,3
world economic,0,0,1,0,0,1,0,2
world war,3,1,0,1,1,0,0,6
addressing climate,0,2,0,1,1,0,0,4
agoura hills,0,0,1,0,0,0,0,1
air conditioner,0,0,0,0,0,1,1,2
al gore,0,2,0,0,0,0,0,2
alaska's north,0,0,0,0,0,2,0,2
ambitious climate,0,3,1,1,0,0,0,5
animal cells,0,2,0,0,0,0,0,2
animal feed,0,1,0,0,1,1,0,3
annual meeting,0,0,0,0,0,2,0,2
appliance manufacturers,0,0,0,2,1,0,0,3
arctic ocean,0,0,0,0,0,1,0,1
artificial intelligence,0,2,0,1,0,0,0,3
banning gas,0,0,0,2,1,0,0,3
baseball diamond,0,1,0,0,0,0,0,1
billion annually,0,2,1,0,0,0,0,3
bipartisan infrastructure,0,1,0,2,0,0,0,3
blackwell ap,1,2,0,1,1,0,0,5
blue flame,0,0,0,2,1,0,0,3
caption people,0,2,0,0,3,0,0,5
caption residents,2,0,0,1,0,2,0,5
caption top,0,1,0,0,0,0,0,1
carbon intensive,3,0,1,1,0,0,0,5
carbon offsets,0,2,0,0,1,0,0,3
ceo uma,0,1,0,0,0,0,0,1
chicken breast,0,1,0,0,0,0,0,1
climate activist,0,1,0,0,1,2,0,4
climate aid,0,2,0,0,0,0,0,2
climate data,1,0,0,1,1,0,2,5
climate displacement,1,0,2,0,1,0,0,4
climate financing,1,3,0,0,0,0,0,4
climate impact,0,1,0,4,0,0,0,5
climate justice,0,1,1,0,1,0,0,3
closed due,1,0,0,1,2,0,0,4
coal mine,0,1,0,0,1,0,0,2
connor donevan,0,3,0,1,1,0,0,5
contributed reporting,1,1,0,1,1,1,0,5
cooking oil,0,0,1,0,1,0,0,2
cost effective,1,2,1,0,0,1,0,5
county commissioner,1,0,1,0,0,0,0,2
county n.c,0,1,0,0,1,0,0,2
cut climate,1,0,0,0,1,3,0,5
daily lives,0,2,0,2,0,1,0,5
damaged homes,1,1,0,0,0,1,0,3
deb haaland,0,0,0,0,1,2,0,3
decade ago,1,1,0,0,3,0,0,5
desoto county,1,0,0,0,0,0,0,1
district steam,3,0,0,0,0,0,0,3
donald trump,3,0,1,0,1,0,0,5
drug administration,0,2,0,0,0,1,0,3
duty trucks,0,1,1,0,0,0,0,2
eat bugs,0,0,0,0,0,1,0,1
economic forum,0,0,1,0,0,1,0,2
efficient heat,0,0,0,0,0,0,1,1
el paso,1,1,0,0,0,0,0,2
electric appliances,0,1,0,1,1,0,0,3
emergency services,0,0,1,1,0,1,0,3
endangered species,2,0,0,0,0,0,0,2
energy company,0,1,0,2,2,0,0,5
energy markets,1,0,2,1,0,0,0,4
environmental advocates,1,0,0,1,0,1,0,3
environmental regulations,2,0,2,0,0,0,0,4
eric orsborn,0,0,0,0,1,0,0,1
esme nicholson,0,0,1,2,0,0,0,3
federal emergency,2,0,0,1,1,0,0,4
financial institutions,1,1,0,0,0,1,0,3
flood waters,1,0,0,1,0,0,0,2
florida's atlantic,1,2,0,0,0,0,0,3
food chain,0,1,0,0,2,2,0,5
foods ceo,0,1,0,0,0,0,0,1
fort worth,0,1,0,0,0,1,1,3
francis tarasiewicz,0,0,0,0,2,0,0,2
francisco bay,0,0,0,3,1,0,0,4
fuel projects,0,0,0,0,0,1,0,1
gas furnaces,0,0,0,0,0,1,1,2
gas utility,0,0,0,2,1,0,0,3
getty hide,0,4,1,0,0,0,0,5
glen canyon,0,1,0,1,0,0,0,2
global population,0,2,0,0,0,2,1,5
governor gavin,0,1,0,1,0,3,0,5
greta thunberg,0,1,0,0,1,1,0,3
hard time,0,0,2,0,1,1,0,4
health experts,0,0,0,2,1,1,0,4
heavy storms,0,0,0,3,0,1,0,4
heritage sites,0,2,0,0,0,0,0,2
highly efficient,3,0,0,0,0,0,1,4
hit hard,1,0,0,1,0,0,0,2
hit hardest,2,2,0,0,0,0,0,4
hollywood sign,0,0,1,0,2,0,0,3
houser's property,0,0,0,0,1,0,0,1
hurricane julia,1,0,0,0,0,0,0,1
indigenous peoples,0,0,3,0,0,1,0,4
indoor air,0,0,0,2,1,0,0,3
industrial times,1,3,0,1,0,0,0,5
intense rainfall,0,0,0,3,0,0,0,3
intergovernmental panel,2,0,0,1,0,1,1,5
interior secretary,0,0,0,0,1,2,0,3
james tucker,0,0,0,0,0,1,1,2
janet yellen,1,1,0,0,1,0,0,3
jose sanchez,0,0,1,1,1,0,0,3
justin sullivan,0,0,1,3,0,1,0,5
katie hobbs,0,0,0,0,2,0,0,2
key climate,0,0,0,1,0,1,1,3
lajas arriba,0,1,0,0,0,0,0,1
lake institute,0,0,0,0,2,0,0,2
land border,0,4,0,0,0,0,0,4
laurie thomas,1,0,0,0,0,0,0,1
law professor,1,0,0,1,1,1,0,4
limit emissions,3,0,0,0,0,2,0,5
limit warming,1,0,0,2,0,1,0,4
marcio jose,0,0,1,1,1,0,0,3
marine life,1,2,0,0,0,1,0,4
marine protected,0,0,0,0,1,1,0,2
massive amounts,1,1,0,1,0,1,0,4
matt ozug,0,4,0,0,0,0,0,4
mayor eric,0,0,0,0,1,0,0,1
miami herald,0,0,1,0,0,0,0,1
migrant center,0,1,0,0,0,0,0,1
million barrels,0,1,0,1,0,2,0,4
million euros,0,3,0,0,0,0,0,3
monday morning,0,0,1,2,0,0,0,3
morning edition,1,1,1,0,0,0,0,3
mount kenya,0,2,0,0,0,0,0,2
mountain lions,0,0,1,0,0,0,0,1
mountain range,0,0,1,1,1,1,0,4
move forward,0,2,0,1,0,2,0,5
national climate,0,2,0,0,1,1,0,4
native communities,0,0,1,0,0,1,0,2
native villages,0,0,2,0,0,1,0,3
neha mankani,1,0,0,0,0,0,0,1
nevada conifers,0,0,0,0,0,1,0,1
nevada mountains,0,0,1,1,2,1,0,5
news outlets,0,0,1,1,0,0,0,2
news release,0,2,1,0,0,1,0,4
news sites,0,0,1,0,0,0,0,1
nitrous oxide,1,1,0,0,0,0,0,2
npr climate,0,0,2,2,0,1,0,5
npr's kirk,2,0,0,0,2,0,0,4
npr's nathan,0,0,1,1,0,2,0,4
ontario canada,0,0,0,0,0,1,0,1
owens lake,0,0,0,0,2,0,0,2
pacific northwest,1,0,1,2,1,0,0,5
past decade,0,3,1,0,1,0,0,5
peer reviewed,0,0,0,1,1,0,1,3
people live,1,0,0,1,1,2,0,5
people missing,1,1,0,0,0,0,0,2
people safe,0,0,0,4,0,0,0,4
picture alliance,0,1,0,0,1,0,0,2
plant based,0,2,0,0,0,1,0,3
policy director,0,0,1,3,1,0,0,5
power lines,1,2,0,1,1,0,0,5
powered cars,0,1,0,0,2,2,0,5
pregnant woman,1,0,0,0,0,0,0,1
pregnant women,1,0,0,0,0,0,0,1
president al,0,2,0,0,0,0,0,2
presidential envoy,0,3,0,0,1,0,0,4
proposed site,0,0,0,0,0,3,0,3
puerto ricans,1,0,0,2,0,0,0,3
puerto rico's,0,1,0,2,0,0,0,3
quil lawrence,1,1,0,0,0,0,0,2
rare earths,0,0,0,1,0,0,0,1
rebecca blackwell,1,2,0,1,1,0,0,5
recent days,1,1,0,1,1,1,0,5
reelection bid,0,0,1,0,0,1,0,2
regulating gas,0,0,0,2,1,0,0,3
renewable sources,0,1,1,1,1,1,0,5
researchers found,1,0,0,2,0,2,0,5
river flooding,2,1,0,0,0,1,0,4
ron desantis,2,1,1,1,0,0,0,5
salinas river,0,0,0,1,0,1,0,2
sanchez ap,0,0,1,1,1,0,0,3
sarah slack,0,0,0,1,0,0,0,1
saturday morning,0,1,0,1,1,0,0,3
science teacher,0,0,0,1,0,0,0,1
secretary deb,0,0,0,0,1,2,0,3
secretary janet,1,1,0,0,1,0,0,3
service meteorologist,1,1,0,0,0,2,0,4
slack hopes,0,0,0,1,0,0,0,1
social justice,1,0,0,0,1,1,0,3
solar energy,1,1,1,0,2,0,0,5
solar ralston,0,0,0,0,1,0,0,1
south africa,0,2,0,0,1,0,0,3
south florida,1,1,2,1,0,0,0,5
southern pakistan,2,0,0,0,0,0,0,2
speaking spanish,0,1,0,0,1,1,0,3
special presidential,0,3,0,0,1,0,0,4
stephanie wolf,0,1,0,0,0,0,0,1
stop funding,0,0,0,0,1,1,0,2
storm clouds,0,0,0,0,2,0,1,3
storms heat,0,3,0,0,0,1,0,4
sullivan getty,0,0,1,3,0,1,0,5
tackling climate,3,1,0,0,1,0,0,5
told reporters,0,2,1,0,1,1,0,5
toothed whales,0,0,0,0,0,1,0,1
treasury secretary,1,1,0,0,1,0,0,3
tv series,0,0,1,0,0,0,1,2
u.n secretary,0,4,0,0,0,1,0,5
u.s department,2,1,0,2,0,0,0,5
u.s treasury,1,1,0,0,1,0,0,3
urban heat,0,0,0,1,0,0,0,1
victor gensini,0,0,0,1,0,1,0,2
walks past,0,1,0,1,0,0,1,3
waste daniel,1,0,0,0,0,0,0,1
waste heat,3,0,0,0,0,0,0,3
water crisis,0,0,0,0,2,1,0,3
water insecurity,0,0,0,0,0,1,0,1
water quality,0,2,0,2,0,1,0,5
water systems,0,1,0,2,0,0,0,3
water vapor,1,0,0,2,0,2,0,5
wealthier countries,0,4,0,0,0,0,0,4
weather pattern,0,1,0,3,0,0,1,5
weather related,0,2,1,1,0,0,0,4
wet winter,0,0,0,1,1,2,0,4
widespread flooding,1,0,0,0,1,2,0,4
winter carnival,0,1,0,0,0,0,0,1
winter storms,0,0,0,0,1,2,0,3
winter weather,0,0,0,0,3,2,0,5
world's poorest,1,1,1,0,0,0,0,3
world's population,0,0,0,0,0,3,0,3
year's u.n,1,3,0,0,0,0,0,4
1st grade,0,0,0,0,1,0,0,1
aaron scott,0,0,2,0,0,2,0,4
acre lithium,0,1,0,0,0,0,0,1
agricultural sector,0,1,0,1,0,1,0,3
agriculture research,0,0,0,1,0,0,1,2
ali zaidi,0,2,0,0,0,0,0,2
alpine resort,0,0,0,1,0,1,0,2
amazon rainforest,0,1,0,0,0,0,1,2
american art,0,0,0,1,0,0,0,1
antarctic ice,0,2,0,0,0,0,0,2
apple tv,0,0,0,0,0,0,1,1
arid west,0,0,0,1,1,0,0,2
atlantic ocean,0,0,0,1,2,0,0,3
au chien,1,0,0,0,0,0,0,1
aya batrawy,0,0,0,2,0,0,0,2
bangladesh's flood,0,0,0,0,0,1,0,1
baseball park,0,1,0,0,0,0,0,1
battery storage,0,0,1,1,0,0,0,2
beaufort sea,0,0,0,0,0,2,0,2
beaver tail,0,0,0,0,1,0,0,1
ben flynn's,0,0,2,0,0,0,0,2
berly mccoy,0,0,1,1,0,2,0,4
biden signed,0,0,0,2,0,1,0,3
biggest challenges,0,0,0,0,2,0,0,2
biodiversity conference,0,0,1,0,0,0,0,1
biodiversity loss,0,0,3,0,0,0,0,3
blister rust,0,0,0,0,0,1,0,1
boat ride,0,1,0,0,0,1,0,2
bonita springs,1,0,0,0,0,0,0,1
borough park,0,0,0,1,0,0,0,1
brian ferguson,0,0,0,1,0,0,0,1
brine shrimp,0,0,0,0,2,0,0,2
british government,0,0,0,1,0,0,0,1
brooklyn's j.h.s,0,0,0,1,0,0,0,1
calif jan,0,0,0,1,0,0,0,1
california's department,0,0,0,1,1,1,0,3
california's water,0,0,0,1,1,1,0,3
car companies,0,0,0,1,1,1,0,3
carbon capture,0,0,1,1,1,0,0,3
carbon pollution,0,0,1,0,1,2,0,4
carbon project,1,1,0,0,0,1,0,3
catastrophic warming,0,0,0,0,0,3,1,4
central america,1,1,0,0,1,0,0,3
central arizona,1,0,0,0,1,0,0,2
central california,0,0,0,1,1,2,0,4
change scientists,0,1,0,0,1,1,1,4
charging stations,0,0,0,1,1,0,0,2
chase bank,0,0,0,0,0,1,0,1
chief executive,1,0,0,0,1,1,0,3
city officials,2,0,0,0,1,0,0,3
clean water,0,0,0,1,0,2,0,3
climate adaptation,0,1,1,1,0,0,0,3
climate correspondent,0,0,2,1,0,1,0,4
climate fueled,1,1,0,0,2,0,0,4
climate risks,0,2,0,1,0,0,0,3
climate strike,0,0,0,0,2,0,0,2
climate warms,1,0,1,1,0,1,0,4
cobalt mine,1,0,0,0,0,0,0,1
cold temperatures,0,0,0,1,1,0,0,2
collapsed buildings,0,1,0,0,0,0,0,1
collect data,0,2,0,1,0,0,0,3
coming days,0,0,0,2,0,1,1,4
commission cpsc,0,0,0,1,1,0,0,2
conference cop27,1,1,1,0,0,0,0,3
congressional delegation,0,0,0,0,0,3,0,3
continue research,0,1,0,0,0,0,0,1
cop27 u.n,0,2,0,1,0,0,0,3
countries deal,0,4,0,0,0,0,0,4
county citizens,0,0,0,0,1,0,0,1
county missouri,1,0,0,0,0,0,0,1
covington tenn,0,0,0,0,0,0,1,1
credit card,0,0,0,0,0,1,0,1
credit cards,1,0,0,0,0,1,0,2
david romero,0,0,0,0,1,0,1,2
deadly floods,0,2,0,0,0,1,0,3
debris flows,0,0,0,3,1,0,0,4
defense council,0,2,2,0,0,0,0,4
democratic republic,1,1,0,0,0,0,1,3
developed nations,0,2,0,0,0,0,0,2
dixie fire,0,0,0,1,1,0,0,2
doug naselroad,0,1,0,0,0,0,0,1
drag queen,1,0,0,0,0,0,0,1
draw attention,0,1,0,0,0,0,0,1
drilling camp,0,0,0,0,0,2,0,2
drilling project,0,0,0,0,0,2,0,2
eastern australia,0,1,0,0,1,0,0,2
eastern kentucky,1,1,0,0,0,0,0,2
eat insects,0,0,0,0,0,1,0,1
eighth graders,0,0,0,1,0,0,0,1
el salvador,1,0,0,0,0,0,0,1
eleanor beardsley,0,1,0,1,0,0,0,2
elizabeth maruma,0,0,3,0,0,0,0,3
emily feng,0,1,0,0,1,0,0,2
emily schwing,0,0,2,0,0,0,0,2
emissions warming,0,2,2,0,0,0,0,4
emperor penguin,1,1,0,0,0,0,0,2
energy development,0,0,0,0,2,0,0,2
energy efficient,0,1,0,1,1,0,1,4
energy forum,0,0,0,2,1,0,0,3
energy information,0,0,2,0,1,0,0,3
energy supplies,0,0,2,0,0,0,0,2
enric sala,0,1,0,0,0,0,0,1
environmental activists,0,2,0,0,1,1,0,4
environmental science,0,0,1,2,1,0,0,4
environmental studies,0,0,1,2,0,0,1,4
eric westervelt,0,0,0,2,0,0,0,2
european commission,0,1,0,0,0,2,0,3
executive secretary,0,0,3,0,0,0,0,3
exploratory drilling,0,0,0,0,0,2,0,2
extreme drought,0,0,1,1,1,0,0,3
extreme event,0,1,0,0,0,0,0,1
ezra david,0,0,0,0,1,0,1,2
fallen dramatically,0,0,0,0,0,2,0,2
federal climate,0,0,0,0,0,1,1,2
federal funding,0,1,2,1,0,0,0,4
file photo,0,0,0,1,0,1,0,2
final decision,0,0,0,0,0,1,0,1
finance corporation,0,3,0,0,0,0,0,3
fire chief,0,0,1,1,0,0,1,3
flash floods,2,0,0,0,0,1,0,3
flood warning,0,0,0,2,0,1,0,3
flooded street,1,0,0,1,0,0,0,2
flooding peace,1,0,0,0,0,0,0,1
food safety,0,1,0,0,0,1,0,2
food system,0,2,1,0,0,0,0,3
food waste,0,1,1,0,0,1,0,3
forecasting warning,0,0,0,0,0,1,0,1
foreign minister,0,1,0,2,0,0,0,3
forest service,1,0,1,0,0,0,1,3
fork miss,0,0,0,0,0,2,0,2
francisquito creek,0,0,0,0,1,0,0,1
freeport illinois,1,0,0,0,0,0,0,1
fuel companies,0,1,0,1,1,1,0,4
gas furnace,0,0,0,1,0,0,1,2
gas plant,0,0,2,0,0,0,0,2
gas supply,0,1,0,0,1,0,0,2
gas utilities,0,0,0,1,1,0,0,2
generation activists,0,0,1,0,0,0,0,1
generation hold,0,0,1,1,0,0,0,2
geographic hide,0,1,0,0,0,0,0,1
german government,0,0,1,1,0,0,0,2
global challenges,1,2,0,0,0,0,0,3
global development,1,1,0,0,0,0,0,2
global emissions,0,1,0,1,0,1,0,3
global greenhouse,0,2,0,0,0,1,0,3
golabari village,0,0,0,0,0,1,0,1
governor katie,0,0,0,0,2,0,0,2
governor's office,1,0,0,1,0,0,0,2
green park,0,0,0,0,1,0,0,1
green party,0,0,1,1,0,0,0,2
greenland ice,0,1,0,0,0,0,0,1
grow food,1,1,1,0,0,1,0,4
growing cities,0,0,0,0,2,0,0,2
gti energy,0,0,0,1,1,0,0,2
guet n'dar,0,1,0,0,0,0,0,1
guet ndar,1,0,0,0,1,0,0,2
gunggandji sea,0,1,0,0,1,0,0,2
hard hit,1,1,0,1,1,0,0,4
hardest hit,3,1,0,0,0,0,0,4
harold davis,0,0,0,2,0,0,0,2
harvest public,1,0,1,1,0,0,0,3
health specialists,0,0,1,0,0,0,0,1
henry epp,0,0,0,2,0,0,0,2
hersher npr,0,0,0,2,1,1,0,4
hills calif,0,0,1,0,0,0,0,1
hindman settlement,0,1,0,0,0,0,0,1
home country,1,1,0,0,0,0,0,2
hotter planet,0,3,0,1,0,0,0,4
housing crisis,0,0,2,0,1,0,0,3
housing development,0,0,0,0,2,0,0,2
huge quantities,0,1,0,0,1,0,0,2
human health,0,0,1,0,2,1,0,4
human lives,0,1,0,0,3,0,0,4
ice shelf,0,1,0,0,1,0,0,2
incredibly potent,0,2,0,0,0,0,0,2
industry analysts,0,0,1,0,0,0,0,1
information administration,0,0,2,0,1,0,0,3
interior department,0,0,0,0,1,1,0,2
international airport,1,1,0,0,2,0,0,4
international efforts,0,2,0,1,1,0,0,4
interpreter melilla,0,2,0,0,0,0,0,2
isla urbana,0,0,0,0,0,1,0,1
italian island,0,1,0,0,0,0,0,1
james california,0,0,0,2,0,1,0,3
jensen beach,0,1,0,0,0,0,0,1
joe biden's,1,0,0,1,0,1,0,3
lake bed,0,0,0,0,2,0,0,2
lake chad,0,0,1,0,0,0,0,1
lake dries,1,0,0,0,2,0,0,3
lake mead,1,0,0,1,0,1,0,3
largest city,1,0,1,1,1,0,0,4
las vegas,0,0,0,1,1,0,0,2
late night,0,0,0,0,0,0,1,1
latit latit,0,0,0,0,0,1,0,1
law enforcement,0,2,0,0,0,0,1,3
lawrence npr,1,1,0,0,0,0,0,2
left millions,0,0,0,0,1,0,0,1
legislative session,0,0,0,0,2,0,0,2
lemaire channel,0,1,0,0,0,0,0,1
levee board,1,0,0,0,0,0,0,1
levee broke,0,0,0,0,0,1,1,2
limit oil,0,0,0,0,0,1,0,1
lm otero,0,1,0,0,1,0,0,2
lodgepole chipmunk,0,0,1,0,0,0,0,1
low pressure,0,0,0,0,3,0,0,3
lower quality,1,0,0,2,0,0,0,3
madam secretary,0,0,1,0,0,0,0,1
majida begum,0,0,0,0,0,1,0,1
major disaster,0,1,0,1,0,1,1,4
major storm,0,0,0,0,2,1,0,3
marburg virus,0,0,0,0,0,1,0,1
maria hit,0,0,0,1,1,0,0,2
marine biodiversity,0,0,0,0,1,0,0,1
maruma mrema,0,0,3,0,0,0,0,3
matrix paid,0,0,1,0,0,0,0,1
meat industry,0,1,0,0,0,0,0,1
meat production,0,1,0,0,0,0,0,1
medical center,0,1,1,0,2,0,0,4
meet climate,0,2,0,0,1,0,1,4
melilla spain,0,1,0,0,0,0,0,1
melting glaciers,1,1,1,0,0,0,0,3
mid south,0,0,0,0,0,2,0,2
mike ancona,3,0,0,0,0,0,0,3
mine jharia,0,0,0,0,1,0,0,1
mitigate climate,1,2,0,0,1,0,0,4
mobile homes,1,1,0,0,0,1,0,3
money managers,0,0,3,0,0,0,0,3
moore reef,0,1,0,0,1,0,0,2
mother nature,0,2,1,0,0,0,1,4
mountain dulcimer,0,1,0,0,0,0,0,1
move faster,0,1,2,1,0,0,0,4
myers fla,1,0,0,1,0,0,0,2
national laboratory,1,2,0,0,1,0,0,4
national petroleum,0,0,0,0,0,3,0,3
national portrait,0,1,0,0,0,0,0,1
nations secretary,0,3,1,0,0,0,0,4
news round,0,0,0,0,0,2,0,2
nicknamed icefin,0,0,0,0,1,0,0,1
night tornado,0,0,0,0,0,0,1,1
nonprofit organization,0,0,0,1,1,1,0,3
npr's rebecca,0,0,0,3,1,0,0,4
nuclear fusion,0,0,0,0,1,0,0,1
nuclear power,0,1,0,2,0,1,0,4
oakland calif,0,0,0,0,0,1,1,2
ocean temperatures,0,3,0,0,0,0,0,3
oil industry,1,0,0,0,1,0,1,3
oil prices,1,0,0,0,1,2,0,4
oil production,1,0,0,0,1,2,0,4
olson getty,1,0,0,2,0,1,0,4
operations manager,3,0,0,0,0,0,0,3
opportunities related,0,0,2,0,0,0,0,2
otero ap,0,1,0,0,1,0,0,2
palm beach,0,1,0,0,0,0,0,1
partially submerged,1,0,0,0,0,1,0,2
pecatonica river,1,0,0,0,0,0,0,1
people stand,1,0,0,0,1,0,1,3
people talk,1,1,0,0,0,1,0,3
people's lives,0,1,1,0,1,1,0,4
peter schorsch,0,0,1,0,0,0,0,1
plan calls,0,3,0,0,1,0,0,4
planet heating,0,0,0,1,1,0,1,3
plastic pollution,1,0,0,1,1,0,0,3
plastic recycling,1,0,1,0,0,0,0,2
plastic trash,1,0,1,0,0,0,0,2
pointe au,1,0,0,0,0,0,0,1
population lives,1,0,0,0,1,2,0,4
portrait gallery,0,1,0,0,0,0,0,1
prediction center,0,0,0,2,2,0,0,4
prepared remarks,1,2,0,0,0,0,0,3
pressure system,0,0,1,0,3,0,0,4
private funding,0,3,0,1,0,0,0,4
private jet,1,0,1,0,0,0,0,2
produce tornadoes,0,0,0,0,0,1,0,1
production facilities,0,1,0,0,0,1,0,2
public schools,1,2,0,0,0,0,0,3
public support,0,0,0,1,2,0,0,3
puerto rican,0,1,0,1,0,0,0,2
rain storms,0,1,0,1,0,1,0,3
rainfall triggered,0,1,0,0,0,0,0,1
ramirez edited,1,1,2,0,0,0,0,4
recycling facility,1,0,0,0,0,0,0,1
reliable energy,0,0,1,0,0,1,0,2
replace gas,2,0,0,0,0,1,1,4
report found,2,0,1,0,0,0,0,3
reporter julia,0,0,0,0,1,1,0,2
resources defense,0,2,2,0,0,0,0,4
rich countries,0,3,0,0,0,0,0,3
rising sea,1,0,2,0,1,0,0,4
river communities,1,0,0,0,0,0,0,1
river flows,0,0,0,0,1,1,0,2
robot nicknamed,0,0,0,0,1,0,0,1
rooftop solar,1,0,0,1,0,0,0,2
rural communities,0,1,0,0,2,1,0,4
russia's invasion,0,3,0,1,0,0,0,4
russian river,0,0,0,1,0,0,0,1
sabin center,0,0,0,0,1,0,0,1
salt water,0,2,0,0,0,1,0,3
san francisquito,0,0,0,0,1,0,0,1
san gabriel,0,0,0,0,2,0,0,2
sarah handel,0,4,0,0,0,0,0,4
saturday afternoon,0,1,0,0,1,0,0,2
school district,0,1,1,0,0,0,0,2
scott olson,1,0,0,2,0,1,0,4
sea country,0,1,0,0,1,0,0,2
seeking comment,0,0,0,0,1,0,0,1
senegal october,0,2,0,0,0,0,0,2
settlement school,0,1,0,0,0,0,0,1
simon npr,0,0,0,0,0,1,1,2
single cash,0,1,0,0,0,0,0,1
snow totals,0,0,0,1,0,0,0,1
soil health,1,1,0,0,0,0,1,3
solar farm,0,3,0,0,0,0,0,3
solar plant,0,0,0,0,1,0,0,1
southeast asia,0,0,0,0,0,1,1,2
southern california's,0,0,1,1,1,1,0,4
southern italian,0,1,0,0,0,0,0,1
southern philippines,1,0,0,0,0,0,0,1
spend money,0,1,0,1,0,1,0,3
stanford university,0,2,0,1,0,1,0,4
station kqed,0,1,0,2,0,1,0,4
stay safe,1,0,0,3,0,0,0,4
store carbon,1,1,0,2,0,0,0,4
storm hit,1,0,0,1,0,0,1,3
storm surges,0,2,0,0,0,0,0,2
storm system,0,0,0,1,0,3,0,4
stormwater infrastructure,0,0,0,2,0,0,0,2
stove manufacturers,0,0,0,1,1,0,0,2
study found,0,1,0,2,1,0,0,4
sullivan ind,0,0,0,0,0,0,1,1
sunamganj northern,0,0,0,0,0,1,0,1
sunamganj region,0,0,0,0,0,1,0,1
susan phillips,2,0,0,0,0,0,0,2
taking action,0,2,2,0,0,0,0,4
tangible impacts,0,1,2,1,0,0,0,4
tells npr,0,0,2,0,0,1,1,4
tent encampment,1,0,0,0,0,0,0,1
thawing permafrost,0,1,0,0,0,0,0,1
thwaites glacier,0,0,0,0,1,0,0,1
today's episode,0,0,2,2,0,0,0,4
town southern,1,0,0,0,0,0,0,1
toyota prius,0,0,0,0,1,0,0,1
transportation sector,0,0,1,0,0,2,0,3
trapping pollution,0,1,1,0,1,0,0,3
triggered landslides,0,1,0,0,0,0,0,1
tuesday morning,0,0,0,1,1,0,0,2
u.n conference,0,2,0,0,0,2,0,4
u.s climate,0,1,1,1,0,1,0,4
u.s economy,1,0,3,0,0,0,0,4
u.s energy,0,0,2,0,1,0,0,3
u.s forest,1,0,1,0,0,0,1,3
urban grid,0,0,0,0,1,0,0,1
utility company,1,1,0,0,0,1,0,3
utility industry,0,0,0,1,1,0,0,2
vehicle batteries,1,2,0,0,0,0,0,3
video piece,0,0,0,1,0,0,0,1
virginia tech,0,0,0,0,1,0,0,1
vocal fry,0,0,0,0,0,1,0,1
warn people,0,3,0,0,0,1,0,4
washington observatory,0,0,0,0,2,0,0,2
water floods,1,0,0,1,0,0,0,2
water funds,0,0,0,0,0,1,0,1
water infrastructure,0,1,0,1,0,1,0,3
water policy,0,1,0,1,1,1,0,4
water pollution,0,1,0,0,0,3,0,4
wealthier nations,0,3,0,0,0,0,0,3
weather disasters,0,2,0,1,1,0,0,4
weather event,0,1,0,1,1,1,0,4
weather prediction,0,0,0,2,2,0,0,4
west antarctica,0,1,0,0,0,0,0,1
western u.s,0,0,1,1,0,1,0,3
western wildfires,1,0,0,0,0,0,0,1
wfpl hide,0,1,0,0,0,0,0,1
whitney museum,0,0,0,1,0,0,0,1
wind chill,0,0,0,0,3,0,0,3
wind power,0,2,0,0,2,0,0,4
wolf wfpl,0,1,0,0,0,0,0,1
women wait,1,0,0,0,0,0,0,1
20th century,0,2,0,1,0,0,0,3
27th conference,0,3,0,0,0,0,0,3
abd el,0,2,0,0,0,0,0,2
abe levine,0,1,2,0,0,0,0,3
accurate warnings,1,1,0,0,0,0,0,2
action network,0,1,0,1,0,0,1,3
action tracker,1,1,0,0,0,1,0,3
administration cleared,0,0,0,0,0,1,0,1
administration official,0,0,0,0,1,1,0,2
aerial vehicles,0,0,0,0,1,0,0,1
african continent,0,3,0,0,0,0,0,3
agencies plan,3,0,0,0,0,0,0,3
ago pattie,1,0,0,0,0,0,0,1
agricultural land,0,0,0,0,0,1,1,2
agriculture sector,0,0,0,1,0,0,0,1
air council,3,0,0,0,0,0,0,3
air monitor,0,0,0,1,1,0,0,2
air resources,0,1,1,1,0,0,0,3
al jaber's,0,0,0,2,0,0,0,2
alarm bells,1,0,0,0,1,1,0,3
america branch,0,0,0,0,0,1,0,1
america hundreds,3,0,0,0,0,0,0,3
america's remaining,0,0,1,0,0,0,0,1
american foulbrood,0,0,0,1,0,0,0,1
american migration,0,0,0,0,2,0,0,2
amtrak spokesperson,3,0,0,0,0,0,0,3
andres island,1,0,0,0,0,0,0,1
angeles river,0,0,0,0,1,0,0,1
angers environmental,3,0,0,0,0,0,0,3
answer questions,1,1,1,0,0,0,0,3
antarctic survey,1,0,0,0,1,0,0,2
anti poverty,1,0,0,0,0,0,0,1
apollo theatre,0,0,0,0,0,0,1,1
appalachian school,0,1,0,0,0,0,0,1
approach yellen,1,0,0,0,0,0,0,1
arcadia fla,1,0,0,0,0,0,0,1
arched ceilings,3,0,0,0,0,0,0,3
arctic sea,0,0,1,0,1,0,0,2
asset transfers,1,0,0,0,0,0,0,1
assistant secretary,0,1,0,0,2,0,0,3
atlanta hide,0,0,0,0,1,0,0,1
attract private,0,2,0,0,0,0,0,2
average temperature,0,0,0,1,0,0,0,1
aviation administration,0,0,0,0,1,0,0,1
baby fund,1,0,0,0,0,0,0,1
baptist church,0,1,0,0,0,0,0,1
bare rock,1,1,0,0,0,0,0,2
beach florida,1,1,1,0,0,0,0,3
benefit dozens,3,0,0,0,0,0,0,3
berger ap,1,0,0,1,0,1,0,3
bernardino mountains,0,0,0,0,1,1,0,2
betsy johnson,1,0,0,0,0,0,0,1
biden ali,0,2,0,0,0,0,0,2
biden's commitment,3,0,0,0,0,0,0,3
bigger threat,0,1,0,0,0,2,0,3
biggest climate,0,3,0,0,0,0,0,3
bill dicroce,3,0,0,0,0,0,0,3
billion tons,0,1,0,0,1,0,0,2
bitter gourd,0,0,0,0,0,1,0,1
blocked roads,0,0,0,1,0,1,0,2
bloody sunday,0,0,0,2,0,0,0,2
bloomberg news,1,0,0,1,1,0,0,3
boilers ran,3,0,0,0,0,0,0,3
boraks wfae,0,1,0,0,0,0,0,1
borbor kealah,0,0,0,1,0,0,0,1
border restrictions,0,1,0,0,0,0,0,1
bottom line,0,0,0,1,2,0,0,3
bring water,0,0,0,0,0,1,0,1
british antarctic,1,0,0,0,1,0,0,2
british columbia,0,0,0,1,1,1,0,3
brooklyn n.y,1,0,0,1,0,0,0,2
buckeye ariz,0,0,0,0,1,0,0,1
building built,3,0,0,0,0,0,0,3
building codes,1,1,0,0,0,0,0,2
building owners,3,0,0,0,0,0,0,3
building space,3,0,0,0,0,0,0,3
burn natural,3,0,0,0,0,0,0,3
california's plan,0,0,0,0,0,1,0,1
called stop,0,1,0,0,0,0,0,1
called willow,0,0,0,0,0,3,0,3
camila domonoske,0,0,1,0,1,0,0,2
canada's western,0,0,1,0,0,0,0,1
capital expense,3,0,0,0,0,0,0,3
capitol hill,0,0,0,0,1,0,0,1
caption anjali,0,0,0,0,1,0,0,1
caption international,0,3,0,0,0,0,0,3
caption police,0,0,1,0,1,0,0,2
caption president,1,2,0,0,0,0,0,3
caption rescuers,1,1,0,0,0,0,0,2
caption water,1,0,0,1,0,1,0,3
carbon cap,0,0,0,0,1,0,0,1
carbon sources,1,0,0,1,0,0,0,2
carbon storage,1,0,1,0,0,0,0,2
carlos rodríguez,0,1,0,0,0,0,0,1
cars sold,0,0,0,0,0,1,0,1
cast doubt,0,0,0,2,1,0,0,3
catastrophic floods,0,2,0,0,0,0,0,2
catastrophic impacts,1,0,1,0,1,0,0,3
caused widespread,1,0,0,0,1,0,0,2
cbs drama,0,0,1,0,0,0,0,1
central africa,0,0,0,0,0,2,1,3
central coast,0,0,0,2,0,1,0,3
ceo bill,3,0,0,0,0,0,0,3
chain link,0,1,0,1,0,0,0,2
chancellor olaf,0,1,1,1,0,0,0,3
change helped,0,2,0,0,0,0,0,2
change means,0,1,0,1,0,1,0,3
change michael,0,0,2,0,0,0,1,3
change threatens,0,2,0,0,0,0,0,2
changing weather,1,1,0,0,0,0,1,3
charging infrastructure,0,0,0,0,0,2,0,2
cheapest alternative,3,0,0,0,0,0,0,3
cheat sheet,0,0,0,0,0,3,0,3
chief scientist,0,1,1,1,0,0,0,3
chief sustainability,0,3,0,0,0,0,0,3
childhood asthma,0,0,0,1,1,0,0,2
chilling effect,0,1,2,0,0,0,0,3
choling monastery,0,1,0,0,0,0,0,1
christine drazan,1,0,0,0,0,0,0,1
city council,0,1,0,0,0,0,0,1
city parks,1,0,0,0,0,0,0,1
city's master,0,0,0,0,1,0,0,1
civil disobedience,0,1,0,1,0,0,0,2
civil resistance,0,1,0,0,0,0,0,1
class neighborhood,0,0,1,0,1,0,0,2
classified documents,0,0,0,1,0,0,0,1
clean electricity,0,1,0,1,0,1,0,3
cleaner burners,0,0,0,1,1,0,0,2
cleaner fuels,0,0,0,0,1,2,0,3
cleaner options,0,0,1,0,0,0,0,1
climate activism,0,1,0,0,0,1,0,2
climate adviser,0,3,0,0,0,0,0,3
climate anxiety,0,1,0,0,0,0,0,1
climate chaos,0,1,0,0,0,1,0,2
climate commitments,0,2,0,0,0,1,0,3
climate connections,0,1,0,1,0,0,0,2
climate economist,0,0,0,0,1,0,0,1
climate emergency,1,0,0,0,2,0,0,3
climate experts,0,1,0,1,1,0,0,3
climate friendly,0,3,0,0,0,0,0,3
climate john,0,2,0,0,0,0,0,2
climate leaders,0,2,0,0,0,0,0,2
climate meeting,0,3,0,0,0,0,0,3
climate negotiator,0,2,0,0,0,0,0,2
climate protection,0,0,1,1,0,0,0,2
climate research,0,0,1,2,0,0,0,3
climate risk,0,3,0,0,0,0,0,3
climate trace,0,2,0,0,0,0,0,2
close america's,0,0,1,0,0,0,0,1
coal company,1,0,0,0,0,0,0,1
coal gas,0,0,2,1,0,0,0,3
coal industry,1,0,0,0,2,0,0,3
coal mining,1,1,0,0,1,0,0,3
coal oil,0,0,1,0,0,2,0,3
coal oven,0,0,0,0,1,0,0,1
coal pile,3,0,0,0,0,0,0,3
coal river,1,0,0,0,0,0,0,1
coal workers,0,0,0,0,1,0,0,1
coast guard,1,1,0,0,0,0,0,2
coastal community,0,0,1,0,0,0,0,1
cold air,0,0,0,1,2,0,0,3
colleagues found,1,0,0,0,0,2,0,3
combating climate,0,1,0,0,1,0,0,2
combustion emissions,0,0,0,0,1,0,0,1
coming months,0,1,0,0,2,0,0,3
commissioner j.c,1,0,0,0,0,0,0,1
commons hide,2,0,0,0,0,0,0,2
communities affected,0,0,0,0,0,2,0,2
concerns including,0,1,0,0,1,1,0,3
concrete dirt,0,0,0,1,0,0,0,1
conservative politics,0,0,0,0,1,0,0,1
conspiracy theories,0,0,0,0,0,1,0,1
cooking stove,0,1,0,1,1,0,0,3
coral skeletons,0,1,0,0,0,0,0,1
corporate profits,1,1,0,0,0,0,0,2
correspondent lauren,0,1,0,1,0,1,0,3
countries agreed,1,2,0,0,0,0,0,3
countries pay,0,2,0,0,0,0,0,2
country focused,1,0,0,0,0,0,0,1
cover crops,0,1,0,0,0,0,0,1
creative commons,2,0,0,0,0,0,0,2
cross border,2,1,0,0,0,0,0,3
crude oil,0,2,0,0,0,1,0,3
culture war,0,0,0,1,1,0,0,2
current global,0,3,0,0,0,0,0,3
cut planet,0,0,0,0,0,1,0,1
cutting greenhouse,0,2,0,0,0,0,1,3
cyclone gabrielle,0,0,0,0,1,0,0,1
da silva,0,1,0,0,1,0,1,3
daily life,0,2,0,0,0,1,0,3
dallas fort,0,1,0,0,0,1,1,3
damage fund,0,3,0,0,0,0,0,3
damon randall,0,0,0,0,1,0,0,1
danger due,1,0,0,0,0,0,0,1
daniel swain,0,0,0,1,0,1,1,3
data collection,0,0,0,1,1,0,0,2
data sheet,0,0,0,1,0,0,0,1
david boraks,0,1,0,0,0,0,0,1
dawn chorus,0,0,0,1,0,0,0,1
deadly heat,0,2,0,0,0,1,0,3
death toll,2,1,0,0,0,0,0,3
debris basins,0,0,0,1,0,0,0,1
decades ago,1,1,0,0,1,0,0,3
decarbonize huge,3,0,0,0,0,0,0,3
decision memo,0,0,0,0,0,1,0,1
deep snow,0,0,0,2,0,1,0,3
dejong ap,0,2,0,1,0,0,0,3
demand action,0,1,0,1,1,0,0,3
demand imbalance,0,0,0,1,0,0,0,1
deputy mayor,1,0,0,0,0,0,0,1
der leyen,0,0,0,0,0,1,0,1
design firm,1,0,0,0,0,0,0,1
destroyed home,0,1,0,0,0,0,1,2
destructive storms,2,0,0,1,0,0,0,3
detailed brickwork,3,0,0,0,0,0,0,3
devastating floods,1,1,0,0,0,1,0,3
development plan,0,0,0,0,0,1,0,1
diesel powered,0,0,0,0,0,1,0,1
dire warnings,0,2,0,1,0,0,0,3
disaster response,3,0,0,0,0,0,0,3
disaster risk,0,3,0,0,0,0,0,3
displacement climate,0,0,0,0,2,0,0,2
ditch natural,3,0,0,0,0,0,0,3
dollar agriculture,0,0,0,1,0,0,0,1
dora mathew,0,0,2,0,0,0,0,2
dorothy moss,0,1,0,0,0,0,0,1
doug ducey,0,0,0,1,2,0,0,3
dozen people,0,2,0,1,0,0,0,3
dpa picture,0,1,0,0,1,0,0,2
dr pepper,0,0,0,1,0,0,0,1
drama series,0,0,1,0,0,0,0,1
drastically cut,0,0,0,0,0,1,0,1
driving climate,1,1,0,0,0,1,0,3
dry conditions,0,0,1,1,0,0,0,2
dubai united,0,0,0,1,0,1,0,2
earth heats,0,2,0,0,0,0,0,2
earth's land,0,0,2,0,0,0,0,2
easily ditch,3,0,0,0,0,0,0,3
east africa,0,2,0,0,0,0,0,2
economic growth,0,1,0,0,2,0,0,3
edible insects,0,0,0,0,0,1,0,1
efficient buildings,0,3,0,0,0,0,0,3
egyptian resort,0,2,0,1,0,0,0,3
el akkad's,0,0,0,1,0,0,0,1
el fattah,0,2,0,0,0,0,0,2
electric generation,3,0,0,0,0,0,0,3
electric homes,0,1,0,0,0,0,0,1
electric post,0,0,0,1,0,0,0,1
electricity generation,0,1,0,1,1,0,0,3
electricity grid,0,2,0,0,0,1,0,3
elevated canopy,0,0,0,0,0,1,0,1
eliminate greenhouse,0,0,1,1,0,1,0,3
elite conspires,0,0,0,0,0,1,0,1
emily kwong,0,0,1,1,0,1,0,3
emily winter,0,1,0,0,0,0,0,1
encourage people,1,0,0,2,0,0,0,3
encouraging people,0,0,0,0,1,1,0,2
endanger people,0,0,1,1,1,0,0,3
energy facility,0,0,0,0,1,0,0,1
energy industry,0,0,0,1,1,1,0,3
energy laboratory,0,0,0,1,0,2,0,3
energy solutions,0,1,0,0,0,2,0,3
energy storage,0,1,0,0,0,0,0,1
energy system,0,0,1,1,0,0,0,2
energy's district,3,0,0,0,0,0,0,3
english channel,0,1,0,0,0,0,0,1
ensure reliable,0,0,1,0,0,0,0,1
environment programme,0,2,0,0,0,1,0,3
environment reporter,0,0,0,1,0,1,0,2
environmental change,0,0,1,0,0,1,0,2
environmental defense,0,0,0,1,1,0,0,2
eric silagy,0,0,1,0,0,0,0,1
eunice foote,0,0,0,0,0,1,0,1
evan gora,0,0,1,0,0,0,0,1
event attribution,0,1,0,0,0,0,0,1
executive officer,1,0,0,1,0,1,0,3
experienced flooding,1,0,0,0,0,1,0,2
exploration canals,0,1,0,0,0,0,0,1
export import,0,1,0,0,0,0,0,1
extensive damage,0,1,0,0,0,0,0,1
facebook page,0,0,1,0,1,0,0,2
facility siting,0,0,0,0,1,0,0,1
facing mounting,0,3,0,0,0,0,0,3
fairmount park,1,0,0,0,0,0,0,1
falling prices,1,0,0,0,0,0,0,1
fargo branch,0,0,0,0,0,1,0,1
farmed oysters,0,0,0,0,0,0,1,1
favorable terms,0,3,0,0,0,0,0,3
federal aviation,0,0,0,0,1,0,0,1
federal land,0,0,1,0,1,0,0,2
federal money,1,0,2,0,0,0,0,3
federal policy,1,1,1,0,0,0,0,3
federal reserve,0,1,0,0,1,1,0,3
feet lower,0,0,0,0,1,0,0,1
fertile soil,0,0,1,0,0,1,0,2
financial industry,0,0,2,0,1,0,0,3
fir trees,0,0,1,0,0,0,0,1
fire department,0,0,0,0,2,0,0,2
firm matrix,0,0,1,0,0,0,0,1
fish species,0,1,0,0,0,0,1,2
fishing boat,1,0,0,0,0,1,0,2
flash flood,0,2,0,1,0,0,0,3
flexible system,3,0,0,0,0,0,0,3
flickr creative,2,0,0,0,0,0,0,2
floating mat,0,0,0,0,0,1,0,1
flood control,1,1,0,0,1,0,0,3
flood events,0,1,0,0,1,0,1,3
flood insurance,1,0,0,1,0,0,0,2
flood risk,1,1,0,0,0,1,0,3
flood warnings,0,2,0,1,0,0,0,3
flooded roads,0,0,0,3,0,0,0,3
flooded roadways,1,0,0,1,0,1,0,3
flooding residents,0,0,0,1,0,1,0,2
fly screen,1,0,0,0,0,0,0,1
food companies,0,1,0,0,0,0,0,1
food crops,0,1,0,0,0,0,0,1
food production,0,2,1,0,0,0,0,3
food supplements,1,0,0,0,0,0,0,1
forcing people,2,0,0,0,1,0,0,3
forest fire,0,0,1,0,0,0,1,2
forest fires,1,1,0,0,0,0,1,3
fork mississippi,0,0,0,0,0,2,0,2
fort lauderdale,0,2,0,0,0,0,0,2
fox news,0,0,0,1,0,1,0,2
frank johnson,0,0,0,1,1,0,0,2
free market,0,0,1,0,0,0,0,1
frequent flooding,2,0,0,0,1,0,0,3
fried dough,0,0,0,0,1,0,0,1
fuel infrastructure,0,2,0,0,1,0,0,3
fuel policy,0,0,0,0,1,0,0,1
fuel source,3,0,0,0,0,0,0,3
fuel standard,0,0,0,0,1,0,0,1
future warming,0,2,0,0,0,1,0,3
gabriel nagel,0,1,0,0,0,0,0,1
gabriel spitzer,0,0,3,0,0,0,0,3
gallup getty,0,1,1,1,0,0,0,3
garden designed,0,0,0,0,0,1,0,1
gas companies,1,2,0,0,0,0,0,3
gas methane,0,0,0,0,1,1,0,2
gas pipeline,0,1,1,0,0,0,0,2
gas projects,0,0,0,1,0,1,0,2
gas ranges,0,0,0,1,1,0,0,2
gather monday,0,0,0,0,1,0,0,1
gen zers,0,0,0,0,0,1,0,1
generate electricity,2,1,0,0,0,0,0,3
generation plant,1,0,0,0,0,0,0,1
gerlache strait,0,1,0,0,0,0,0,1
giant floating,0,0,0,0,0,1,0,1
glacial melt,1,1,0,0,0,1,0,3
glaciers melt,0,2,0,0,0,1,0,3
global elite,0,0,0,0,0,1,0,1
global elites,0,0,0,0,0,1,0,1
global energy,0,0,0,1,1,1,0,3
global north,0,2,0,0,1,0,0,3
global weather,0,2,0,1,0,0,0,3
gonia hide,1,0,0,0,0,0,0,1
gourd vines,0,0,0,0,0,1,0,1
gov gavin,0,0,1,1,0,1,0,3
gov ron,1,0,1,1,0,0,0,3
governance issues,0,0,2,0,0,0,1,3
government survey,0,0,1,0,0,0,0,1
grace kaiser,1,0,0,0,0,0,0,1
grand bahama,0,1,0,0,0,0,0,1
gravity storage,0,1,0,0,0,0,0,1
greenhouse emissions,0,2,0,0,0,0,0,2
greenpeace found,1,0,0,0,0,0,0,1
greenville california,0,0,0,0,1,0,0,1
griffith park,0,0,1,0,0,0,0,1
groundwater levels,0,0,0,0,1,1,0,2
grow meat,0,2,0,0,0,0,0,2
gun violence,0,0,0,0,1,0,0,1
gutierrez hedges,0,0,1,0,0,0,0,1
hager kunc,0,0,0,1,0,0,0,1
half ago,1,0,0,0,0,0,0,1
halle parker,2,0,0,0,0,0,0,2
health care,1,2,0,0,0,0,0,3
health concerns,0,0,0,1,0,0,0,1
health effects,0,0,0,2,1,0,0,3
health organization,0,0,0,0,1,1,0,2
heat illness,0,1,0,1,0,0,0,2
heat island,0,0,0,1,0,0,0,1
heaviest toll,0,0,0,0,1,0,0,1
heavily damaged,0,1,0,0,0,0,1,2
heavy monsoon,0,2,0,0,0,0,0,2
heavy traffic,0,0,0,0,0,1,0,1
helped drive,0,2,0,0,0,0,0,2
helped write,1,0,0,0,1,0,0,2
hersher reports,0,0,0,2,1,0,0,3
hey ailsa,0,1,0,1,1,0,0,3
hey leila,0,0,2,0,1,0,0,3
hillsides scarred,0,0,0,1,0,0,0,1
hindman ky,0,1,0,0,0,0,0,1
historic independence,3,0,0,0,0,0,0,3
hit florida,0,3,0,0,0,0,0,3
hit southwest,0,0,0,0,1,0,0,1
homeless people,0,0,0,0,2,0,0,2
hot day,1,1,0,1,0,0,0,3
hot water,1,1,0,0,1,0,0,3
hotter climate,0,1,0,1,0,0,0,2
hotter earth,0,2,0,0,0,0,0,2
hour boat,0,0,0,0,0,1,0,1
house speaker,1,0,0,1,1,0,0,3
housing shortage,0,0,2,0,1,0,0,3
huge mudslide,1,0,0,0,0,0,0,1
huge swaths,3,0,0,0,0,0,0,3
human actions,0,0,2,0,0,0,0,2
human activities,0,0,1,1,0,1,0,3
human food,0,0,0,0,0,1,0,1
humpback whale,0,0,0,0,1,0,1,2
hurricane nicole,0,2,0,0,0,0,0,2
hurricane season,0,3,0,0,0,0,0,3
hybrid vehicle,0,0,0,0,1,0,0,1
ice age,1,1,0,0,0,1,0,3
idabel okla,0,1,0,0,0,0,0,1
illinois university,0,0,0,1,0,1,0,2
immigration authorities,0,1,1,0,0,0,0,2
immigration policy,0,0,1,0,0,0,0,1
import bank,0,1,0,0,0,0,0,1
improve air,0,0,0,0,0,1,0,1
include climate,0,2,0,1,0,0,0,3
increasingly common,0,1,0,2,0,0,0,3
increasingly disruptive,0,0,1,2,0,0,0,3
incredibly difficult,0,0,1,1,1,0,0,3
independence hall,3,0,0,0,0,0,0,3
independently verified,3,0,0,0,0,0,0,3
indian reservation,0,0,0,0,0,2,0,2
industrialized nations,0,3,0,0,0,0,0,3
industry lobbyists,1,0,0,0,1,0,0,2
infant formula,1,0,0,0,0,0,0,1
infrared burners,0,0,0,1,1,0,0,2
infrastructure decisions,0,0,0,3,0,0,0,3
inger andersen,0,2,0,0,0,1,0,3
intense storms,0,0,0,0,1,1,1,3
intensive future,3,0,0,0,0,0,0,3
international financial,1,1,0,0,0,0,0,2
international ice,0,1,0,0,0,0,0,1
international union,1,2,0,0,0,0,0,3
irene flores,0,1,0,0,0,0,0,1
island nations,0,1,0,0,0,1,0,2
j.c deriso,1,0,0,0,0,0,0,1
joanne bland,0,0,0,1,0,0,0,1
jobs report,0,0,0,0,0,1,0,1
john hornewer,0,0,0,0,1,0,0,1
joint statement,0,2,0,0,1,0,0,3
jordan river,0,1,0,0,0,0,0,1
joseph ingrao,3,0,0,0,0,0,0,3
juneau alaska,0,0,0,0,0,1,0,1
justice department,0,0,0,1,0,0,0,1
kaiser pattie,1,0,0,0,0,0,0,1
kale carrots,1,0,0,0,0,0,0,1
karen nabity,0,0,0,0,1,0,0,1
kenyan ice,0,1,0,0,0,0,0,1
keurig dr,0,0,0,1,0,0,0,1
key role,0,1,0,1,0,1,0,3
kimberly paynter,1,0,0,0,0,0,0,1
kunc hide,0,0,0,1,0,0,0,1
la times,0,0,1,1,0,0,0,2
lajas puerto,0,1,0,0,0,0,0,1
lamar county,0,1,0,0,0,0,0,1
land loss,1,1,0,0,0,0,0,2
landscape bed,1,0,0,0,0,0,0,1
largest emitter,0,3,0,0,0,0,0,3
largest reservoir,0,1,0,1,0,0,0,2
largest single,0,0,1,0,2,0,0,3
late 1800s,0,1,0,1,0,1,0,3
late december,0,0,0,3,0,0,0,3
lauren esposito,1,0,0,0,0,0,0,1
lauren frayer,0,1,0,0,0,1,0,2
lawmakers approved,0,0,0,0,1,0,0,1
leaders including,0,3,0,0,0,0,0,3
leuser ecosystem,0,0,0,0,0,0,1,1
level oil,0,0,0,0,0,2,0,2
levels rise,0,1,0,0,0,1,0,2
lexington coal,1,0,0,0,0,0,0,1
liberty bell,3,0,0,0,0,0,0,3
life maya,0,1,0,0,0,0,0,1
light trucks,0,0,0,1,0,1,0,2
lighting system,0,1,0,0,0,0,0,1
lithium mine,0,1,0,0,0,0,0,1
live animals,0,1,0,0,0,0,1,2
liz metzger,0,0,0,0,0,3,0,3
local communities,0,1,0,1,0,1,0,3
local levee,1,0,0,0,0,0,0,1
local people,1,1,0,0,1,0,0,3
local races,0,1,0,0,0,0,0,1
logging industry,1,0,0,2,0,0,0,3
louis senegal,0,1,0,0,1,0,0,2
low water,0,1,0,2,0,0,0,3
lower elevation,0,0,0,0,0,1,0,1
lula da,0,1,0,0,1,0,1,3
machine learning,0,1,0,1,0,0,0,2
major cities,0,0,0,0,2,1,0,3
major flooding,1,0,0,1,0,0,0,2
major retrofits,3,0,0,0,0,0,0,3
major water,1,0,0,1,0,1,0,3
major winter,0,0,0,0,1,1,0,2
makes sense,0,0,0,2,0,1,0,3
mama baby,1,0,0,0,0,0,0,1
mamadou thiam,0,1,0,0,0,0,0,1
managed retreat,1,0,0,0,0,0,0,1
mandating federal,3,0,0,0,0,0,0,3
mankani peeks,1,0,0,0,0,0,0,1
manufacturers association,0,0,1,0,0,1,0,2
mara hoplamazian,0,0,0,2,0,0,0,2
marine biologist,0,1,0,0,1,0,0,2
mario tama,0,0,1,0,1,1,0,3
maritime affairs,0,0,0,0,1,0,0,1
masdar city,0,0,0,1,0,0,0,1
mass extinction,0,1,1,0,0,1,0,3
master development,0,0,0,0,0,1,0,1
master plan,0,0,0,0,1,0,0,1
matt guilhem,0,0,0,1,0,1,0,2
maximum sustained,1,2,0,0,0,0,0,3
mcnamee getty,1,0,1,0,0,0,0,2
mental health,0,0,0,1,0,1,0,2
merrick garland,0,0,0,1,0,0,0,1
metropolitan water,1,0,0,1,0,1,0,3
meyers director,0,0,0,0,1,0,0,1
michael hey,0,0,2,0,0,0,1,3
middle school,0,0,0,1,0,0,0,1
miles north,0,1,0,1,0,0,0,2
miller plays,0,0,0,0,0,0,1,1
million acre,0,1,0,0,0,2,0,3
million gallons,0,1,0,2,0,0,0,3
million homes,1,0,2,0,0,0,0,3
million jobs,0,1,0,0,0,1,0,2
mine walaa,0,0,0,0,1,0,0,1
mining permits,1,1,0,0,0,0,0,2
missouri river,1,0,0,0,0,0,0,1
monday evening,0,0,0,1,0,0,0,1
money directly,0,3,0,0,0,0,0,3
montgomery alabama,0,1,1,0,0,0,0,2
morning leila,0,0,0,1,0,1,1,3
mountain pine,0,0,0,0,0,1,0,1
mountain snow,0,0,0,2,0,0,0,2
mountain watch,1,0,0,0,0,0,0,1
mountaineer mine,1,0,0,0,0,0,0,1
mountainous regions,0,0,0,2,1,0,0,3
multibillion dollar,0,0,0,1,0,0,0,1
multiple people,0,0,1,0,0,0,1,2
national academy,1,0,0,1,1,0,0,3
national effort,0,0,0,0,1,1,0,2
national guard,2,0,0,0,0,0,1,3
national jurisdiction,0,0,0,0,1,1,0,2
national level,0,1,1,0,0,1,0,3
national parks,0,1,1,1,0,0,0,3
national renewable,0,0,0,1,0,2,0,3
nations annual,0,3,0,0,0,0,0,3
nations summit,0,0,0,1,0,1,0,2
nature conservancy,1,0,1,0,0,0,1,3
nazma akter,0,0,0,0,0,1,0,1
neighborhood ballpark,0,1,0,0,0,0,0,1
noah berger,1,0,0,1,0,1,0,3
noah caldwell,0,3,0,0,0,0,0,3
nonprofit climate,1,1,0,0,1,0,0,3
nonprofit organizations,0,1,0,1,0,0,0,2
norfolk va,0,1,0,0,1,0,0,2
north american,0,0,0,0,1,1,0,2
north woods,1,0,0,0,0,0,0,1
northern gaston,0,1,0,0,0,0,0,1
northern illinois,0,0,0,1,0,1,0,2
npr.org listen,0,0,0,1,0,2,0,3
npr's aya,0,0,0,2,0,0,0,2
npr's camila,0,0,1,0,1,0,0,2
npr's eleanor,0,1,0,1,0,0,0,2
npr's emily,0,1,0,0,1,0,0,2
npr's eric,0,0,0,2,0,0,0,2
npr's questions,0,0,0,0,2,0,0,2
nur jahan,0,0,0,0,0,1,0,1
obama administration,1,0,0,0,1,1,0,3
ocean floor,0,0,0,0,1,2,0,3
oil executives,1,0,0,1,1,0,0,3
oil plantations,0,0,0,0,0,0,1,1
op ed,0,0,0,1,1,0,0,2
operates philadelphia's,3,0,0,0,0,0,0,3
operations landfills,0,1,0,0,0,0,0,1
organic farming,0,1,0,0,0,0,0,1
oyster farming,0,0,0,0,0,0,1,1
oyster shell,1,0,0,0,0,0,0,1
pakistan earlier,0,3,0,0,0,0,0,3
pape dieye,0,0,0,0,1,0,0,1
past week,0,1,0,1,1,0,0,3
pastry brush,0,0,1,0,0,0,0,1
path forward,0,0,2,0,0,1,0,3
pay attention,0,0,1,0,2,0,0,3
paynter whyy,1,0,0,0,0,0,0,1
pencil shaped,0,0,0,0,1,0,0,1
people gathered,0,2,0,0,1,0,0,3
people speak,0,0,0,1,0,0,0,1
people who've,0,1,0,1,0,0,0,2
people's attention,0,1,0,1,0,1,0,3
permanently frozen,0,1,0,0,0,0,0,1
permian basin,1,1,0,0,0,0,0,2
person holding,0,0,1,0,1,0,0,2
peter dejong,0,2,0,1,0,0,0,3
peter walala,0,1,0,0,0,0,0,1
philadelphia museum,2,0,0,0,0,0,0,2
philadelphia's steam,3,0,0,0,0,0,0,3
philadelphia's streets,3,0,0,0,0,0,0,3
philip davis,0,1,0,0,0,0,0,1
phoebe plummer,0,1,0,0,0,0,0,1
pile sitting,3,0,0,0,0,0,0,3
pinaki roy,0,0,0,0,1,0,0,1
plastic bottles,1,0,0,0,0,0,0,1
plastic plates,0,0,0,1,0,0,0,1
plastics ban,0,0,0,1,0,0,0,1
policy analysts,0,0,0,1,1,0,0,2
policy reporter,0,0,1,0,0,1,0,2
policy research,0,1,0,0,1,0,0,2
political blowback,0,0,2,0,1,0,0,3
political leaders,1,0,0,1,0,1,0,3
political power,0,0,0,0,0,2,0,2
politics publisher,0,0,1,0,0,0,0,1
pond formed,0,1,0,0,0,1,0,2
poor countries,0,1,1,0,0,1,0,3
poor people,0,0,0,0,0,2,0,2
poorer nations,0,2,0,0,0,0,0,2
pop culture,0,0,1,0,0,0,1,2
possibly dozens,0,0,0,0,0,0,1,1
poverty strategies,1,0,0,0,0,0,0,1
power industry,0,0,2,0,0,0,0,2
powered trucks,0,0,0,0,0,1,0,1
powerful greenhouse,0,1,0,0,1,0,0,2
powerful storm,0,0,0,1,1,0,0,2
powerful threats,1,0,0,0,0,0,0,1
powerful tornado,0,0,0,0,0,1,0,1
powerful winter,0,0,0,2,1,0,0,3
presidential medal,0,1,0,0,0,0,0,1
press conference,0,1,0,0,1,1,0,3
press release,0,1,1,0,0,1,0,3
pretty hard,0,1,1,0,0,1,0,3
previous government's,0,1,1,1,0,0,0,3
price tag,0,0,2,1,0,0,0,3
primary mode,0,0,0,0,1,1,0,2
princeton university,0,0,0,0,2,0,0,2
private finance,0,1,0,0,0,0,0,1
processing operation,0,1,0,0,0,0,0,1
produce electricity,0,2,0,0,0,0,0,2
producing electricity,0,0,2,0,0,0,0,2
professor emeritus,0,0,0,0,1,2,0,3
projects built,0,0,0,0,1,0,0,1
property borders,0,1,0,0,0,0,0,1
proposed development,0,0,0,0,1,1,0,2
protect future,0,0,2,1,0,0,0,3
provide funding,0,3,0,0,0,0,0,3
public hearings,1,0,0,0,1,0,0,2
public media,1,0,1,1,0,0,0,3
public media's,0,0,0,1,0,0,1,2
public relations,0,0,1,1,1,0,0,3
public service,0,0,1,0,0,0,0,1
public transit,0,1,0,0,1,1,0,3
published wednesday,1,0,0,0,1,0,0,2
publisher peter,0,0,1,0,0,0,0,1
quality wood,1,0,0,2,0,0,0,3
quarter century,0,0,0,0,1,0,0,1
quebec winter,0,1,0,0,0,0,0,1
queen pattie,1,0,0,0,0,0,0,1
quick succession,0,0,0,1,1,0,0,2
raised hundreds,0,2,0,0,0,0,0,2
rake excess,1,0,0,0,0,0,0,1
rare earth,0,1,0,1,0,1,0,3
raw materials,0,1,0,0,0,1,0,2
raw sewage,0,0,0,1,0,0,0,1
real time,1,1,0,0,0,0,0,2
rebecca leber,0,1,0,0,0,0,0,1
rebecca shearer,0,0,0,0,0,0,1,1
recent interview,0,1,1,1,0,0,0,3
recent protest,0,0,1,1,0,0,0,2
recent study,0,0,1,0,1,1,0,3
recent weeks,0,1,0,2,0,0,0,3
recently received,0,0,2,1,0,0,0,3
record levels,0,3,0,0,0,0,0,3
recreation director,0,1,0,0,0,0,0,1
recycling bins,1,0,1,0,0,0,0,2
red brick,3,0,0,0,0,0,0,3
regan griffin,1,0,0,0,0,0,0,1
related disaster,0,1,0,0,0,0,0,1
related disasters,1,1,0,1,0,0,0,3
released thursday,0,1,1,0,0,0,0,2
relentless storms,0,0,0,1,0,0,0,1
remain popular,0,0,0,0,1,0,0,1
remaining coal,0,0,1,0,0,0,0,1
remaining glaciers,0,1,0,0,0,0,0,1
renewable future,0,1,0,0,0,0,0,1
reporter emily,0,0,2,0,1,0,0,3
republican candidates,0,1,0,0,1,0,0,2
research firm,0,0,1,2,0,0,0,3
research organization,0,1,0,1,0,0,1,3
residual steam,3,0,0,0,0,0,0,3
resort town,0,3,0,0,0,0,0,3
resources board,0,1,1,1,0,0,0,3
restore power,1,1,0,0,0,0,0,2
resume efforts,0,0,0,0,1,0,0,1
retire coal,0,0,1,0,1,0,0,2
richer countries,0,2,1,0,0,0,0,3
rick spinrad,0,1,1,1,0,0,0,3
rights memorial,0,1,0,0,0,0,0,1
rio verde,0,0,0,0,1,0,0,1
rising prices,2,0,0,0,0,0,0,2
river mountain,1,0,0,0,0,0,0,1
river's water,0,0,0,1,0,0,0,1
rob jackson,1,1,0,1,0,0,0,3
rock hard,0,1,0,1,0,0,0,2
rock outcrop,0,1,0,0,0,0,0,1
roger houser's,0,0,0,0,1,0,0,1
rolwaling sangag,0,1,0,0,0,0,0,1
romero lankao,0,0,0,0,0,2,0,2
ronald meyers,0,0,0,0,1,0,0,1
san andres,1,0,0,0,0,0,0,1
sangag choling,0,1,0,0,0,0,0,1
satellites sensors,0,1,0,0,0,1,0,2
saturday night,1,0,0,0,1,0,1,3
saudi arabia,1,0,0,1,0,0,0,2
save money,0,0,0,1,1,0,1,3
sbr enterprises,0,0,0,0,1,0,0,1
school students,0,0,0,1,0,0,0,1
science fiction,0,1,0,0,1,1,0,3
scientific evidence,0,0,0,1,1,0,0,2
scripps institution,1,0,0,1,0,1,0,3
sean gallup,0,1,1,1,0,0,0,3
seasonal floods,0,0,0,0,0,1,0,1
seek asylum,0,1,1,0,0,0,0,2
senate bill,0,0,0,0,1,0,0,1
senior reporter,0,1,0,1,0,0,0,2
series fire,0,0,1,0,0,0,0,1
service commissioner,0,0,1,0,0,0,0,1
seventh child,1,0,0,0,0,0,0,1
severe housing,0,0,2,0,1,0,0,3
shadowy global,0,0,0,0,0,1,0,1
shaped robot,0,0,0,0,1,0,0,1
shareholder resolutions,0,0,0,0,0,1,1,2
ship's bow,0,1,0,0,0,0,0,1
shrinking colorado,0,0,0,1,2,0,0,3
sidewalk grates,3,0,0,0,0,0,0,3
sienna miller,0,0,0,0,0,0,1,1
sierra club's,0,0,0,0,1,2,0,3
significant amount,1,1,0,0,0,0,1,3
single house,0,0,2,1,0,0,0,3
single source,0,0,1,0,2,0,0,3
siting project,0,0,0,0,1,0,0,1
snowplow businesses,0,0,0,2,0,0,0,2
snowy winter,0,0,0,0,2,0,0,2
sofía córdova's,0,0,0,1,0,0,0,1
solar park,0,0,1,1,0,0,0,2
solar plants,0,0,0,0,1,0,0,1
solar power,0,1,1,0,1,0,0,3
solar powered,1,0,0,0,0,2,0,3
solutions reporter,0,0,0,0,1,1,0,2
sonoma county,0,0,0,2,0,0,0,2
soot pollution,0,0,0,1,0,0,0,1
south america,0,1,0,0,0,2,0,3
south pacific,0,1,0,1,1,0,0,3
south sudan,0,1,0,0,0,0,0,1
southern edge,0,0,1,0,0,0,0,1
southwest california,0,0,0,0,1,0,0,1
southwestern coast,1,1,0,0,0,0,0,2
st louis,1,0,0,0,1,0,0,2
state's efforts,0,0,0,0,0,1,0,1
state's largest,1,1,1,0,0,0,0,3
steam carried,3,0,0,0,0,0,0,3
steam system,3,0,0,0,0,0,0,3
steven bingler,1,0,0,0,0,0,0,1
stop piedmont,0,1,0,0,0,0,0,1
store energy,0,1,1,0,0,0,0,2
storm hits,0,0,0,3,0,0,0,3
storm nalgae,1,0,0,0,0,0,0,1
storm nicole,0,1,0,0,0,0,0,1
storm related,1,0,0,1,0,1,0,3
storm sweeps,0,1,0,0,1,0,0,2
storm water,0,0,0,1,0,0,0,1
strategic dialogue,0,0,0,1,0,1,0,2
strongest storms,0,0,0,0,1,0,0,1
study authors,0,0,0,2,0,1,0,3
study warns,0,1,0,0,1,0,0,2
submerged village,1,0,0,0,0,0,0,1
sunday ap,1,0,0,0,0,1,0,2
sunday march,0,0,0,1,0,1,0,2
sunday night,0,0,0,1,1,1,0,3
supply chains,0,0,1,0,0,1,0,2
supply demand,0,0,0,1,0,0,0,1
surface temperature,0,0,0,1,0,0,0,1
surma river,0,0,0,0,0,1,0,1
susan ralston,0,0,0,0,1,0,0,1
sustainability officer,0,3,0,0,0,0,0,3
sustained winds,1,2,0,0,0,0,0,3
tama getty,0,0,1,0,1,1,0,3
task force,2,0,0,0,0,0,0,2
team kenya,0,1,0,0,0,0,0,1
tent flap,1,0,0,0,0,0,0,1
term climate,1,0,0,1,1,0,0,3
term solutions,1,1,1,0,0,0,0,3
threatened species,1,0,0,0,0,1,0,2
tina kotek,1,0,0,0,0,0,0,1
tiny particles,1,0,0,1,0,0,0,2
told lawmakers,0,0,0,0,1,1,1,3
told morning,1,0,1,0,0,0,0,2
told rai,0,1,0,0,0,0,0,1
ton coal,3,0,0,0,0,0,0,3
tornado activity,0,0,0,0,0,1,1,2
tornado alley,0,0,0,0,0,2,1,3
tornado tore,0,0,0,0,0,1,0,1
toyota unveiled,0,0,0,0,1,0,0,1
trees die,0,0,1,0,0,1,0,2
trinity baptist,0,1,0,0,0,0,0,1
truck standards,0,0,0,0,0,1,0,1
trucks sold,0,0,0,1,0,1,0,2
turbines nearby,0,1,0,0,1,0,0,2
typical american,0,0,0,0,2,0,0,2
u.n environment,0,2,0,0,0,1,0,3
u.s efforts,1,1,0,0,1,0,0,3
u.s emissions,0,1,0,1,0,0,0,2
u.s environmental,0,1,1,0,0,1,0,3
u.s fish,1,0,0,0,0,1,0,2
u.s special,0,2,0,0,1,0,0,3
u.s territory,1,1,0,0,0,0,0,2
underground aquifers,0,0,0,0,1,1,0,2
underground network,3,0,0,0,0,0,0,3
underground pipes,3,0,0,0,0,0,0,3
undo title,0,0,1,0,0,0,0,1
unidentified aerial,0,0,0,0,1,0,0,1
united kingdom,0,1,0,0,0,1,0,2
university found,0,0,0,0,2,0,0,2
university's carbon,3,0,0,0,0,0,0,3
upper atmosphere,0,0,0,0,1,0,1,2
upper midwest,0,0,0,0,2,1,0,3
urban cores,3,0,0,0,0,0,0,3
urge banks,0,0,0,0,0,1,0,1
utah's capitol,0,0,0,0,1,0,0,1
vegetable garden,0,0,0,0,0,1,0,1
vehicle development,0,1,0,0,0,1,0,2
verde foothills,0,0,0,0,1,0,0,1
vessel strikes,0,0,0,0,1,0,0,1
veterans memorial,0,1,0,0,0,0,0,1
vietnam veterans,0,1,0,0,0,0,0,1
voluntary standards,0,0,0,1,1,0,0,2
volusia county,0,2,0,0,0,0,0,2
von der,0,0,0,0,0,1,0,1
vulnerable people,1,1,0,0,0,0,1,3
vulnerable require,1,0,0,0,0,0,0,1
waggle dance,0,0,0,0,0,1,0,1
warmer air,0,0,0,2,0,1,0,3
warming center,0,0,0,0,2,0,0,2
warming centers,0,0,0,0,2,0,0,2
warming effect,1,0,0,0,0,0,0,1
warming oceans,1,1,0,0,1,0,0,3
warming planet,0,1,0,1,0,1,0,3
warning system,0,2,0,0,0,1,0,3
water diversions,0,0,0,0,2,0,0,2
water fund,0,0,0,0,0,1,0,1
water source,0,1,1,0,0,1,0,3
wealthy countries,0,3,0,0,0,0,0,3
weather alerts,1,0,0,0,2,0,0,3
weather disaster,1,1,0,0,0,0,0,2
weather forecasting,0,1,0,0,0,0,1,2
weather service's,0,1,0,1,1,0,0,3
weather whiplash,0,0,0,2,0,1,0,3
wet weather,0,0,0,1,1,1,0,3
wetlands watch,0,1,0,0,0,0,0,1
wfae hide,0,1,0,0,0,0,0,1
white cedar,0,1,0,2,0,0,0,3
whyy hide,1,0,0,0,0,0,0,1
wild celery,0,0,0,0,0,1,0,1
wild weather,0,0,0,1,1,0,1,3
wildfire burned,0,1,0,0,0,0,0,1
wildlife service,1,0,0,0,0,1,0,2
willow master,0,0,0,0,0,1,0,1
win mcnamee,1,0,1,0,0,0,0,2
wind damage,0,1,0,0,1,0,0,2
wind energy,0,0,0,0,1,0,0,1
wind industry,0,0,0,0,1,0,0,1
windsor ontario,0,0,0,0,0,1,0,1
wong parodi,0,1,0,0,0,0,0,1
world health,0,0,0,0,1,1,0,2
world's marine,0,0,0,0,1,0,0,1
wreaked havoc,0,2,0,1,0,0,0,3
wynne ark,0,0,0,0,0,0,1,1
yale climate,0,1,0,1,0,0,0,2
year's meeting,0,1,0,1,0,1,0,3
1.5c target,0,0,0,1,0,0,0,1
15th birthday,0,0,0,0,1,0,0,1
19th century,0,1,0,1,0,0,0,2
33rd edition,0,0,0,1,0,0,0,1
350juneau sawed,0,0,0,0,0,1,0,1
a.m wednesday,0,1,0,0,0,0,0,1
abdo mohemad,0,1,0,0,0,0,0,1
abē levine,0,1,1,0,0,0,0,2
abigail dillen,0,0,0,0,0,2,0,2
absolutely critical,0,1,0,1,0,0,0,2
academy curator,1,0,0,0,0,0,0,1
accelerated transition,0,0,1,0,0,0,0,1
accelerator companies,0,2,0,0,0,0,0,2
access sensitive,0,0,0,2,0,0,0,2
aceh province,0,0,0,0,0,0,1,1
achieve net,0,0,1,0,0,0,0,1
acronym esg,0,0,2,0,0,0,0,2
act allocated,0,0,2,0,0,0,0,2
act quickly,0,0,0,1,1,0,0,2
act rule,0,0,1,0,0,0,0,1
action plan,0,2,0,0,0,0,0,2
activist greta,0,1,0,0,0,1,0,2
activist protest,0,0,0,0,1,0,0,1
activists blocking,0,0,1,0,0,0,0,1
activists protest,0,0,0,1,0,0,0,1
activists sit,0,0,1,1,0,0,0,2
activists threw,0,0,1,0,0,0,0,1
adah crandall,0,1,0,0,0,0,0,1
adam woodhouse,0,0,0,0,0,2,0,2
adaptation fund,0,1,0,0,0,0,0,1
adaptation projects,0,2,0,0,0,0,0,2
adding plywood,0,0,2,0,0,0,0,2
additional private,0,2,0,0,0,0,0,2
address global,0,1,0,0,0,1,0,2
address health,0,0,0,1,1,0,0,2
administration awarded,0,0,1,0,0,0,0,1
administration noaa,0,1,0,0,0,1,0,2
administration's branch,0,0,2,0,0,0,0,2
administrator michael,0,0,0,1,0,1,0,2
advanced economies,1,1,0,0,0,0,0,2
aerial survey,0,0,1,0,0,0,0,1
affect climate,1,0,0,1,0,0,0,2
affected reporter,0,0,2,0,0,0,0,2
africa east,0,0,0,0,0,2,0,2
ag research,0,0,0,1,0,0,0,1
ag water,1,0,0,0,0,0,0,1
aggressive action,0,0,0,1,0,0,1,2
aging infrastructure,0,0,0,0,1,1,0,2
ago esg,0,0,2,0,0,0,0,2
ago people,1,1,0,0,0,0,0,2
agricultural community,0,0,0,0,0,1,0,1
agriculture holds,0,1,0,0,0,0,0,1
agua dulce,0,0,0,0,1,0,0,1
ahlefeld surveys,0,0,0,0,0,0,1,1
ahlefeld's son,0,0,0,0,0,0,1,1
ahmed al,0,0,0,1,0,0,0,1
air act,0,0,0,0,0,1,0,1
air conditioners,0,0,0,1,0,0,1,2
air conditioning,0,1,0,0,0,0,1,2
air masses,0,0,0,0,0,1,1,2
air southward,0,0,0,0,1,0,0,1
air temperature,0,0,0,1,0,0,0,1
akter recalls,0,0,0,0,0,1,0,1
alaa abd,0,2,0,0,0,0,0,2
alabama free,0,0,1,0,0,0,0,1
alabama mississippi,0,0,0,0,0,1,0,1
alabama public,0,0,1,0,0,0,0,1
alaska climate,0,0,1,0,0,0,0,1
alaska pipeline,0,0,0,0,0,1,0,1
alaska's critical,0,0,0,0,0,1,0,1
albany vt,0,0,0,2,0,0,0,2
albatross fledgling,0,1,0,0,0,0,0,1
alert system,0,0,0,0,1,0,0,1
alex jones,0,0,0,0,1,1,0,2
algae called,0,0,0,0,0,1,0,1
alice fordham,1,0,0,0,0,0,0,1
alley submerged,1,0,0,0,0,0,0,1
alliance dpa,0,0,0,0,1,0,0,1
allison aubrey,0,1,0,0,0,0,0,1
allowing neighborhood,0,1,0,0,0,0,0,1
alongside profits,0,0,2,0,0,0,0,2
alpine chipmunk,0,0,1,0,0,0,0,1
alternative proteins,0,1,1,0,0,0,0,2
amazon home,0,0,0,0,0,0,1,1
amazonia rainforest,0,0,1,0,0,0,0,1
ambassador bridge,0,0,0,0,0,1,0,1
ambassador felson,0,1,0,0,0,0,0,1
ambitious goal,1,1,0,0,0,0,0,2
ambitious legislation,0,0,1,1,0,0,0,2
ambitious stuff,0,0,2,0,0,0,0,2
america's energy,0,1,1,0,0,0,0,2
american flag,1,1,0,0,0,0,0,2
american homes,0,0,2,0,0,0,0,2
american household,0,0,0,0,1,0,0,1
american international,0,0,0,0,1,0,0,1
american lung,0,1,0,1,0,0,0,2
american public,0,0,0,1,1,0,0,2
american southwest,0,0,0,0,0,1,0,1
american west,0,0,0,0,0,1,1,2
americana detail,0,0,0,1,0,0,0,1
amherst n.y,0,0,0,1,0,0,0,1
amra pasic,0,0,2,0,0,0,0,2
amy mayer,0,0,0,0,0,1,0,1
ancient glaciers,1,0,0,0,0,0,0,1
andrew fisher,0,0,0,1,0,0,0,1
andrew innerarity,0,0,0,1,0,1,0,2
andrew noyes,0,1,0,0,0,0,0,1
andy devries,0,0,2,0,0,0,0,2
angela kocherga,0,1,0,0,0,0,0,1
angeles saturday,0,0,0,0,1,0,0,1
angeles world,0,0,1,0,0,0,0,1
anger johnsen,0,0,1,1,0,0,0,2
ani dasgupta,0,2,0,0,0,0,0,2
animal health,0,0,0,1,0,1,0,2
animal species,1,0,1,0,0,0,0,2
anissa suharsono,0,0,0,0,1,0,0,1
anna canny,0,0,0,0,0,1,0,1
anna jane,0,0,0,0,0,0,1,1
anna king,0,0,0,0,0,1,0,1
announced sunday,0,0,0,0,0,1,0,1
annual average,0,0,0,0,0,1,0,1
annual carbon,1,0,0,0,0,1,0,2
annual emissions,0,0,0,0,0,1,1,2
annual mining,0,0,0,0,1,0,0,1
annual u.n,0,2,0,0,0,0,0,2
antczak ap,0,0,0,0,1,0,0,1
anti immigrant,1,1,0,0,0,0,0,2
anti wind,0,0,0,0,1,0,0,1
antónio guterres,0,2,0,0,0,0,0,2
ap photo,0,0,0,1,0,0,0,1
appalachian kentucky,0,1,0,0,0,0,0,1
appalachian music,0,1,0,0,0,0,0,1
appears countries,0,2,0,0,0,0,0,2
approach investing,0,0,2,0,0,0,0,2
aptos california,0,0,0,1,0,0,0,1
aquifers groundwater,0,0,0,0,0,1,0,1
arachnology lauren,1,0,0,0,0,0,0,1
arctic permafrost,0,1,0,0,0,0,0,1
areal view,1,0,0,0,0,0,0,1
ariz mayor,0,0,0,0,1,0,0,1
arizona promotes,0,0,0,0,1,0,0,1
arlington va,1,0,0,0,0,0,0,1
army corps,0,2,0,0,0,0,0,2
arriba neighborhood,0,1,0,0,0,0,0,1
art hide,0,0,0,1,0,0,0,1
artist karin,0,1,0,0,0,0,0,1
artist sofía,0,0,0,1,0,0,0,1
arts instruction,0,0,0,0,1,0,0,1
asian countries,0,0,1,0,0,1,0,2
asphalt pavement,0,0,0,1,0,0,0,1
assistant administrator,1,0,0,1,0,0,0,2
assistant professor,0,0,0,1,0,0,1,2
associate director,0,0,2,0,0,0,0,2
association oil,0,1,0,0,1,0,0,2
astrid caldas,0,0,0,2,0,0,0,2
astrid drive,0,0,0,1,0,0,0,1
athan manuel,0,0,0,0,0,2,0,2
atlanta share,0,0,0,0,1,0,0,1
atmosphere callaway,0,0,0,0,0,0,1,1
atmosphere companies,0,2,0,0,0,0,0,2
atmospheric research,1,0,0,0,1,0,0,2
attacked officials,0,0,1,0,0,0,0,1
attending classes,0,0,0,0,1,0,0,1
attribution science,0,2,0,0,0,0,0,2
audio interview,0,1,1,0,0,0,0,2
australian government,0,1,0,0,0,0,0,1
autauga county,0,0,0,1,0,0,0,1
author enric,0,1,0,0,0,0,0,1
auto industry,0,0,0,0,1,1,0,2
auto workers,0,0,0,0,0,1,0,1
automotive industry,0,0,0,0,0,1,0,1
autonomous region,1,0,0,0,0,0,0,1
average emissions,0,0,0,0,0,1,0,1
average fell,0,1,0,0,0,0,1,2
avoid catastrophic,0,0,1,0,0,0,0,1
avoid detection,0,0,0,0,1,0,0,1
avoid runaway,0,1,0,1,0,0,0,2
baby boomers,0,1,0,0,0,1,0,2
baby brother,1,0,0,0,0,0,0,1
background helps,1,0,0,0,0,0,0,1
backup plan,0,1,0,0,0,0,0,1
bad information,0,0,0,0,1,0,0,1
bad reputation,0,1,0,0,0,0,0,1
bad weather,0,0,0,0,0,1,0,1
bahamas prime,0,1,0,0,0,0,0,1
baja california,0,0,0,0,1,0,0,1
balancing act,0,0,0,1,0,1,0,2
balfour south,0,1,0,0,0,0,0,1
ballesteros surveys,0,1,0,0,0,0,0,1
ballfield's floodlights,0,1,0,0,0,0,0,1
balloons buchanan,0,0,0,0,1,0,0,1
ban gas,0,0,0,1,1,0,0,2
bangladesh fatima,0,0,0,0,0,1,0,1
bangladesh hundreds,0,0,0,0,0,1,0,1
bangladesh jahan,0,0,0,0,0,1,0,1
banks including,0,1,0,0,0,1,0,2
bar drilling,0,0,0,0,0,1,0,1
barack obama,0,1,0,0,0,0,0,1
barbara county,0,0,0,2,0,0,0,2
bare driveways,0,0,0,2,0,0,0,2
bargny senegal,1,0,0,0,0,0,0,1
barrier island,1,0,0,0,0,0,0,1
based company,1,0,0,0,1,0,0,2
based research,1,0,0,1,0,0,0,2
basic human,0,0,0,1,1,0,0,2
basin ag,1,0,0,0,0,0,0,1
basin forest,0,0,0,0,0,0,1,1
basins nets,0,0,0,1,0,0,0,1
bat cave,0,0,0,0,0,1,0,1
bats congregate,0,0,0,0,0,1,0,1
bats dwell,0,0,0,0,0,1,0,1
battering california,0,0,0,1,0,1,0,2
battery plant,0,0,0,0,0,2,0,2
beach causeway,0,1,0,0,0,0,0,1
beach fl,1,0,0,0,0,0,0,1
beach ny,0,0,0,0,1,0,0,1
beach town,0,1,0,0,0,0,0,1
beachfront property,0,0,2,0,0,0,0,2
bear walks,0,0,1,0,0,0,0,1
bearing spodumene,0,1,0,0,0,0,0,1
beauregard ala,0,0,1,0,0,0,0,1
beding nepal,0,1,0,0,0,0,0,1
bedroom house,0,0,2,0,0,0,0,2
beetle infestations,0,0,0,0,0,1,0,1
begins putting,0,0,1,0,0,0,0,1
begum lives,0,0,0,0,0,1,0,1
begum stands,0,0,0,0,0,1,0,1
bell center,2,0,0,0,0,0,0,2
bella tonkonogy,0,2,0,0,0,0,0,2
bellamy pailthorp,0,0,0,0,1,0,0,1
bellingshausen sea,0,1,0,0,0,0,0,1
belvidere fire,0,0,0,0,0,0,1,1
belvidere ill,0,0,0,0,0,0,1,1
benard mwenja's,1,0,0,0,0,0,0,1
berkeley calif,0,1,0,1,0,0,0,2
berkeley national,0,1,0,0,1,0,0,2
berlin rob,0,0,0,0,0,1,0,1
bernard's mound,1,0,0,0,0,0,0,1
berry islands,0,1,0,0,0,0,0,1
bessemer city,0,1,0,0,0,0,0,1
bezos earth,0,2,0,0,0,0,0,2
bhutto zardari,0,1,0,0,0,0,0,1
bicicleta stretches,0,0,0,1,0,0,0,1
biden greets,0,0,0,0,0,1,0,1
biden promised,1,0,0,0,0,0,0,1
biden's administration,0,0,0,0,0,1,0,1
bigger companies,0,1,0,0,0,0,0,1
bigger picture,0,0,1,1,0,0,0,2
bigger storms,0,0,0,2,0,0,0,2
biggest city,1,1,0,0,0,0,0,2
biggest source,0,0,0,0,1,1,0,2
bike race,0,0,0,1,0,0,0,1
bikes saturday,0,0,0,1,0,0,0,1
bilawal bhutto,0,1,0,0,0,0,0,1
bill passed,0,0,0,2,0,0,0,2
billion deal,0,0,0,0,1,0,0,1
billion dollar,0,0,0,2,0,0,0,2
billion euros,0,1,1,0,0,0,0,2
billion forest,0,0,0,2,0,0,0,2
billion single,0,0,0,1,0,0,0,1
biodiversity framework,0,0,1,0,0,0,0,1
biodiversity protect,0,1,0,0,0,0,0,1
biomass burning,1,0,0,0,0,0,0,1
bitter cold,0,0,1,0,1,0,0,2
black browed,0,1,0,0,0,0,0,1
black paint,0,0,1,0,0,0,0,1
blackout response,0,0,0,0,1,0,0,1
blade cutting,0,0,0,2,0,0,0,2
blazing heat,2,0,0,0,0,0,0,2
bleached skeletons,0,0,0,0,0,1,0,1
bleaching event,0,2,0,0,0,0,0,2
blm plan,0,0,0,0,0,1,0,1
blow past,1,1,0,0,0,0,0,2
board hopes,1,0,0,0,0,0,0,1
boat house,0,0,0,0,0,0,1,1
bob hall,0,0,2,0,0,0,0,2
bob jordan,0,0,1,0,0,0,0,1
bob schroeder,0,0,0,0,0,1,0,1
boilers generate,2,0,0,0,0,0,0,2
bold action,0,0,2,0,0,0,0,2
bolendra acharya,0,1,0,0,0,0,0,1
bomb cyclones,0,0,0,1,0,0,0,1
bonita beach,1,1,0,0,0,0,0,2
boost biodiversity,0,1,0,0,0,0,0,1
boosting investment,0,1,0,0,0,0,0,1
border challenges,1,1,0,0,0,0,0,2
border patrol,0,1,0,0,0,0,0,1
born educator,0,0,0,0,1,0,0,1
borrowed money,1,0,0,0,0,0,0,1
boston gathered,0,0,0,0,0,1,0,1
boston holds,0,0,0,0,0,1,0,1
bottled water,0,0,0,0,0,2,0,2
bottom lines,0,0,2,0,0,0,0,2
boulder colorado,0,1,0,0,0,0,0,1
boulder laden,1,0,0,0,0,0,0,1
brackish water,0,1,0,0,0,1,0,2
branch mine,1,0,0,0,0,0,0,1
brave rain,0,1,0,0,0,0,0,1
brianna scott,0,1,1,0,0,0,0,2
brick building,2,0,0,0,0,0,0,2
brine fly,0,0,0,0,2,0,0,2
bring climate,0,1,0,0,0,0,1,2
bring supplies,0,0,0,1,0,0,0,1
bringing critical,0,0,0,0,0,1,0,1
broad support,0,1,0,0,0,1,0,2
broader fossil,0,0,0,1,0,0,0,1
broke records,0,1,0,0,0,1,0,2
broken lighting,0,1,0,0,0,0,0,1
brooklyn explains,0,0,0,1,0,0,0,1
brother zaman,1,0,0,0,0,0,0,1
brothers ian,0,1,0,0,0,0,0,1
browed albatross,0,1,0,0,0,0,0,1
brown algae,0,0,0,0,0,1,0,1
bryce crocker,1,0,0,0,0,0,0,1
buckeye arizona,0,0,0,0,1,0,0,1
buddhist religious,0,1,0,0,0,0,0,1
build clean,0,1,0,0,1,0,0,2
build homes,1,0,0,0,0,1,0,2
build resilience,0,1,0,0,1,0,0,2
build scientific,0,0,0,1,0,0,0,1
building levees,1,1,0,0,0,0,0,2
building materials,1,0,0,0,0,0,0,1
buildings operated,2,0,0,0,0,0,0,2
bulldozer moves,0,0,0,1,0,0,0,1
bullfrog marina,0,0,0,0,0,1,0,1
burger laughter,0,0,0,0,0,1,0,1
buried alive,1,0,0,0,0,0,0,1
burn coal,0,0,0,0,0,2,0,2
burn hydrogen,0,1,1,0,0,0,0,2
burn scar,0,0,0,2,0,0,0,2
burner improvements,0,0,0,1,1,0,0,2
burning power,1,0,0,1,0,0,0,2
burns sustained,0,0,0,0,1,0,0,1
bus carried,0,1,0,0,0,0,0,1
busiest freeways,0,0,1,0,0,0,0,1
business school,0,0,2,0,0,0,0,2
busy freeways,0,0,0,0,2,0,0,2
busy road,1,0,0,0,1,0,0,2
butter sauce,0,1,0,0,0,0,0,1
buy credits,0,1,0,0,0,0,0,1
caked remains,0,1,0,0,0,0,0,1
calif california,0,0,0,0,1,0,0,1
calif costello,0,0,0,1,0,0,0,1
calif flooding,0,0,0,0,0,1,0,1
calif marcio,0,0,1,1,0,0,0,2
calif president,0,0,0,0,0,1,0,1
california academy,1,0,0,0,0,1,0,2
california air,0,0,1,1,0,0,0,2
california brian,0,0,0,1,0,0,0,1
california central,0,0,0,1,0,0,0,1
california coast,0,0,0,1,0,0,0,1
california governor,0,0,0,1,0,1,0,2
california hub,0,0,0,1,0,0,0,1
california irvine,0,0,0,0,1,1,0,2
california john,0,0,0,0,1,0,0,1
california mexico,0,0,0,0,1,0,0,1
california nathan,0,0,0,0,0,1,0,1
california people,0,0,0,0,1,1,0,2
california recently,0,1,0,0,0,1,0,2
california residents,0,0,0,1,0,0,1,2
california wade,0,0,0,1,0,0,0,1
california weather,0,0,0,0,0,2,0,2
california's coastline,0,0,0,1,0,0,0,1
california's drought,0,0,0,0,1,1,0,2
called climate,0,2,0,0,0,0,0,2
called cultivated,0,2,0,0,0,0,0,2
called foraminifera,0,0,0,0,0,2,0,2
called sargassum,0,0,0,0,0,1,0,1
called woke,0,0,2,0,0,0,0,2
cambodian vendors,0,0,0,0,0,1,0,1
canada's automotive,0,0,0,0,0,1,0,1
canadian press,0,1,1,0,0,0,0,2
canadian technical,0,0,0,0,0,1,0,1
canals cut,0,1,0,0,0,0,0,1
candidate betsy,1,0,0,0,0,0,0,1
candidate christine,1,0,0,0,0,0,0,1
candidate tina,1,0,0,0,0,0,0,1
canyon ariz,0,0,0,0,0,1,0,1
canyon institute,0,0,0,1,0,0,0,1
canyon national,0,0,0,1,0,0,0,1
capital city,0,0,0,2,0,0,0,2
caption buckeye,0,0,0,0,1,0,0,1
caption cars,1,0,0,1,0,0,0,2
caption debris,0,0,0,0,1,1,0,2
caption eric,0,0,1,1,0,0,0,2
caption family,0,1,0,0,0,0,1,2
caption flooding,1,1,0,0,0,0,0,2
caption heavy,0,1,0,0,0,1,0,2
caption james,0,0,0,0,0,0,1,1
caption laurie,1,0,0,0,0,0,0,1
caption leading,0,0,0,0,0,2,0,2
caption mankani,1,0,0,0,0,0,0,1
caption maya,0,1,0,0,0,0,0,1
caption radhika,0,0,0,0,1,0,0,1
caption ralston,0,0,0,0,1,0,0,1
caption rising,1,0,0,0,1,0,0,2
caption riverboats,0,0,0,0,0,1,0,1
caption signs,0,2,0,0,0,0,0,2
caption storm,0,0,0,0,2,0,0,2
caption students,0,0,0,1,0,0,0,1
caption terry,0,0,1,0,0,0,0,1
caption toyota,0,0,0,0,1,0,0,1
caption tree,0,0,1,0,0,0,1,2
caption upside,0,1,0,0,0,0,0,1
capture carbon,0,0,1,0,0,0,1,2
capture technology,0,0,1,0,0,0,0,1
car hauler,0,0,0,0,0,1,0,1
car shoppers,0,0,0,0,1,0,0,1
caracas venezuela,0,0,0,0,0,1,0,1
carbon bomb,0,0,0,0,0,2,0,2
carbon credit,0,2,0,0,0,0,0,2
carbon monoxide,1,0,0,0,1,0,0,2
carbon offset,0,2,0,0,0,0,0,2
carbon sequestration,0,1,0,0,0,0,0,1
card replicas,0,0,0,0,0,1,0,1
cardboard cutout,0,0,1,0,0,0,0,1
cardon community,0,0,0,0,0,1,0,1
carl de,0,0,0,0,0,0,1,1
carlos island,1,0,0,0,0,0,0,1
caroline atoll,0,1,0,0,0,0,0,1
carrie johnson,0,0,0,1,0,0,0,1
carried meltwater,1,0,0,0,0,0,0,1
carry buckets,0,0,0,0,0,1,0,1
carry fried,0,0,0,0,0,1,0,1
carry thunberg,0,0,0,0,1,0,0,1
carrying chrysler,0,0,0,0,0,1,0,1
cars charge,0,0,0,0,0,1,0,1
cars trucks,0,0,0,0,0,1,0,1
carving events,0,1,0,0,0,0,0,1
carving festival,0,1,0,0,0,0,0,1
casale director,0,0,0,0,1,0,0,1
cash crop,0,1,0,0,0,0,0,1
cash crops,0,1,0,0,0,0,0,1
catastrophic damage,0,1,0,0,0,1,0,2
catastrophic effects,0,0,0,1,0,1,0,2
catastrophic flooding,0,1,0,0,0,0,1,2
catastrophic levels,0,0,1,0,0,0,0,1
caused floods,0,1,0,0,0,0,0,1
caused global,0,1,0,0,0,0,0,1
causing cyclones,0,0,0,0,0,1,0,1
causing extensive,0,1,0,0,0,0,0,1
causing massive,0,0,0,1,0,1,0,2
cedar logs,0,0,0,2,0,0,0,2
cell cultures,0,1,0,0,0,0,0,1
cell lines,0,1,0,0,0,0,0,1
cell phone,0,0,0,1,0,1,0,2
celsius compared,0,2,0,0,0,0,0,2
center search,1,0,0,0,0,0,0,1
central banks,0,1,0,0,0,0,0,1
central florida,0,1,0,0,0,0,0,1
central texas,0,0,0,0,0,1,1,2
central winter,0,0,0,1,0,0,0,1
century ago,0,0,0,0,1,1,0,2
ceo keith,0,1,0,0,0,0,0,1
challenges facing,0,0,1,0,0,1,0,2
challenges posed,0,1,0,1,0,0,0,2
challenges wind,0,0,0,0,1,0,0,1
cham province,0,0,0,0,0,1,0,1
change attribution,0,0,0,0,0,1,0,1
change drastically,0,0,2,0,0,0,0,2
change earlier,0,0,2,0,0,0,0,2
change global,0,2,0,0,0,0,0,2
change including,0,2,0,0,0,0,0,2
change intensifies,0,1,0,0,0,1,0,2
change makes,0,1,0,1,0,0,0,2
change npr,0,0,2,0,0,0,0,2
change people,1,1,0,0,0,0,0,2
change poorer,0,1,0,0,0,0,0,1
change predicted,0,0,0,1,0,0,0,1
change rebecca,0,0,0,0,1,1,0,2
change solution,2,0,0,0,0,0,0,2
change storms,0,0,0,2,0,0,0,2
change summit,0,2,0,0,0,0,0,2
change susan,0,0,0,0,2,0,0,2
change themed,1,0,0,0,0,0,0,1
change winters,0,0,0,2,0,0,0,2
change.for npr,0,0,0,2,0,0,0,2
changing agriculture,0,2,0,0,0,0,0,2
changing consumption,0,0,0,0,0,2,0,2
changing planet,0,1,0,0,0,0,0,1
characterize esg,0,0,2,0,0,0,0,2
charlotte harbor,1,0,0,0,0,0,0,1
chefornak aims,0,0,2,0,0,0,0,2
chefornak alaska,0,0,2,0,0,0,0,2
chefornak's tribal,0,0,2,0,0,0,0,2
chemical energy,0,1,0,0,0,0,0,1
chemical fertilizers,0,1,0,0,0,0,0,1
chief shawn,0,0,0,0,0,0,1,1
child samira,1,0,0,0,0,0,0,1
chilly morning,0,0,0,0,1,0,0,1
chipmunk tamias,0,0,1,0,0,0,0,1
choksi chugh,0,0,0,1,0,0,0,1
chorus ii,0,0,0,1,0,0,0,1
chris hipkins,0,0,0,0,1,0,0,1
chris stapleton,0,1,0,0,0,0,0,1
christoph bals,0,0,1,1,0,0,0,2
christopher alam,0,0,0,0,0,1,0,1
christopher blank,0,1,0,0,0,0,0,1
christopher michel,1,0,0,0,0,0,0,1
chrysler pacificas,0,0,0,0,0,1,0,1
chualar calif,0,0,0,1,0,0,0,1
church parking,0,0,0,0,0,1,0,1
church stands,0,1,0,0,0,0,0,1
church's sanctuary,0,1,0,0,0,0,0,1
churchill manitoba,0,0,1,0,0,0,0,1
cities alike,1,1,0,0,0,0,0,2
city called,0,2,0,0,0,0,0,2
city exxonmobil,0,0,0,1,0,0,0,1
city n.c,0,1,0,0,0,0,0,1
city park,1,0,0,0,0,0,0,1
civil society,0,2,0,0,0,0,0,2
civil war,1,0,0,1,0,0,0,2
claire harbage,0,1,0,0,0,1,0,2
classes centers,0,0,0,0,1,0,0,1
classes community,0,0,0,0,1,0,0,1
clean truck,0,0,1,0,0,0,0,1
cleaner energy,1,0,0,0,0,1,0,2
cleaner sources,0,1,0,1,0,0,0,2
clears snow,0,0,0,1,0,0,0,1
climate accounting,0,2,0,0,0,0,0,2
climate benefits,0,2,0,0,0,0,0,2
climate challenge,1,0,0,0,0,1,0,2
climate communication,0,0,0,0,1,0,0,1
climate conscious,0,1,0,1,0,0,0,2
climate context,0,1,0,0,0,0,0,1
climate disaster,0,1,0,0,1,0,0,2
climate effects,0,1,0,1,0,0,0,2
climate focused,0,1,0,1,0,0,0,2
climate fund,0,2,0,0,0,0,0,2
climate goal,1,0,0,1,0,0,0,2
climate hell,0,2,0,0,0,0,0,2
climate henisz,0,0,2,0,0,0,0,2
climate initiatives,0,0,1,0,0,1,0,2
climate issue,0,0,1,0,0,1,0,2
climate losses,0,2,0,0,0,0,0,2
climate migrants,1,0,0,0,0,0,0,1
climate mitigation,0,1,1,0,0,0,0,2
climate office,1,0,0,0,0,0,0,1
climate pledges,0,1,0,0,0,1,0,2
climate positive,0,0,0,2,0,0,0,2
climate progress,0,2,0,0,0,0,0,2
climate projections,0,0,0,0,0,2,0,2
climate questions,0,2,0,0,0,0,0,2
climate researcher,0,0,0,1,0,1,0,2
climate solidarity,0,1,0,0,0,0,0,1
climate starts,0,0,2,0,0,0,0,2
climate storms,0,0,0,1,0,0,0,1
climate targets,0,0,1,0,0,0,1,2
climate technology,0,1,0,0,1,0,0,2
climate tipping,0,1,1,0,0,0,0,2
clinic run,1,0,0,0,0,0,0,1
clinic's fly,1,0,0,0,0,0,0,1
cloak downtown,0,0,0,0,1,0,0,1
closed highway,0,0,0,1,0,0,0,1
clouds cloak,0,0,0,0,1,0,0,1
club's lands,0,0,0,0,0,2,0,2
coal assets,0,0,0,0,1,0,0,1
coal attends,0,0,0,0,1,0,0,1
coal fire,0,0,0,0,1,0,0,1
coal generated,2,0,0,0,0,0,0,2
coal limited,0,0,0,0,1,0,0,1
coal miner,1,0,0,0,0,0,0,1
coal subsidies,0,0,0,0,1,0,0,1
coastal philippine,1,0,0,0,0,0,0,1
coastal regions,0,1,0,0,0,0,0,1
coastal wetlands,0,1,0,0,0,0,0,1
coffee consumption,0,0,0,1,0,0,0,1
coffee pod,0,0,0,1,0,0,0,1
coffee preparation,0,0,0,1,0,0,0,1
coffey told,0,0,0,1,0,0,0,1
coking coal,0,0,0,0,1,0,0,1
cold climate,0,0,0,0,0,0,1,1
cold snap,0,0,0,0,2,0,0,2
cold snowy,0,0,1,1,0,0,0,2
cold spring,0,0,0,0,0,0,1,1
cold war,0,1,0,1,0,0,0,2
colin murphy,0,0,0,0,1,0,0,1
collect temperature,0,0,0,1,0,0,0,1
collect water,0,0,0,1,0,1,0,2
collecting lab,0,0,0,0,1,0,0,1
collection courtesy,0,0,0,1,0,0,0,1
collective action,0,0,0,2,0,0,0,2
collects coal,0,0,0,0,1,0,0,1
colleen goodridge,0,0,0,2,0,0,0,2
collision schnarr,0,0,1,1,0,0,0,2
colorado river's,0,0,0,1,0,0,0,1
columbia canada,0,0,0,0,1,1,0,2
combat climate,0,1,1,0,0,0,0,2
comment period,1,0,0,1,0,0,0,2
commercial activities,0,1,0,0,1,0,0,2
commissioner stands,0,0,1,0,0,0,0,1
commissioner trumka,0,0,0,1,1,0,0,2
committed suicide,0,1,0,0,0,0,0,1
common sense,1,0,0,0,1,0,0,2
commonly found,0,0,0,0,0,0,2,2
communications director,0,0,0,0,0,1,0,1
communities hit,0,0,0,1,0,0,0,1
community affairs,1,0,0,0,0,0,0,1
community concerns,0,0,1,0,1,0,0,2
community development,1,1,0,0,0,0,0,2
community email,0,1,1,0,0,0,0,2
community hit,0,0,0,1,0,0,0,1
community leaders,0,1,0,0,0,1,0,2
community recently,0,0,2,0,0,0,0,2
community services,0,0,0,1,0,0,0,1
companies build,0,0,1,0,1,0,0,2
companies buy,0,2,0,0,0,0,0,2
company ceo,0,0,1,0,0,1,0,2
company declined,0,0,1,0,0,0,0,1
company's cultivated,0,1,0,0,0,0,0,1
computer model,1,0,0,1,0,0,0,2
concerns droz,0,0,0,0,1,0,0,1
concrete block,0,1,0,0,0,0,0,1
concrete blocks,0,1,0,0,0,0,0,1
concrete terms,0,0,2,0,0,0,0,2
concrete wall,0,0,0,1,0,0,0,1
conditions deteriorate,0,1,0,0,0,0,0,1
confederated salish,0,0,0,0,0,1,0,1
conference center,0,1,0,0,0,0,0,1
conference starts,0,2,0,0,0,0,0,2
congress esg,0,0,2,0,0,0,0,2
congress passed,0,2,0,0,0,0,0,2
connects community,0,1,0,0,0,0,0,1
connects windsor,0,0,0,0,0,1,0,1
connor editor,0,0,0,0,0,2,0,2
conocophillips willow,0,0,0,0,0,2,0,2
conrad wilson,0,0,0,0,1,0,0,1
conservation efforts,1,0,1,0,0,0,0,2
conservation plan,0,0,0,0,0,1,0,1
conservation programs,0,0,0,0,0,0,1,1
consistent themes,1,0,0,0,1,0,0,2
constitutional court,0,0,1,1,0,0,0,2
construction scaffolding,0,0,0,1,0,0,0,1
consumers energy,0,0,0,0,1,0,0,1
consumption patterns,0,0,0,0,0,2,0,2
contaminated land,0,0,0,0,1,0,0,1
control trillions,0,0,2,0,0,0,0,2
controlled burns,1,0,1,0,0,0,0,2
controversial oil,0,0,0,0,0,2,0,2
conventional meat,0,1,0,0,0,0,0,1
conveyor belt,0,0,0,1,0,1,0,2
cooked chicken,0,1,0,0,0,0,0,1
cooking equipment,0,0,0,1,1,0,0,2
cooling system,0,0,1,0,0,0,0,1
coordinating minister,0,0,0,0,1,0,0,1
coordinating relief,0,1,0,0,0,0,0,1
cop15 biodiversity,0,0,1,0,0,0,0,1
cop26 climate,0,1,0,0,0,0,0,1
cop27 climate,0,2,0,0,0,0,0,2
coping strategy,0,1,0,0,0,0,0,1
coral larvae,0,1,0,0,0,0,0,1
coralline algae,0,1,0,0,0,0,0,1
cornell university,0,0,0,1,1,0,0,2
corporate policies,0,0,0,0,0,1,1,2
corporation dfc,0,2,0,0,0,0,0,2
corporations including,0,1,1,0,0,0,0,2
corpus christi,0,1,0,0,0,0,0,1
correspondent carrie,0,0,0,1,0,0,0,1
correspondent michael,0,0,2,0,0,0,0,2
costco warehouse,0,0,0,1,0,0,0,1
costello drove,0,0,0,1,0,0,0,1
costumes ride,0,0,0,1,0,0,0,1
council create,0,0,2,0,0,0,0,2
council sit,0,1,0,0,0,0,0,1
counterintuitive effect,0,0,0,1,1,0,0,2
countries adapt,0,2,0,0,0,0,0,2
countries experts,0,1,0,0,0,0,0,1
countries finance,1,0,0,0,0,0,0,1
country public,0,0,0,0,2,0,0,2
country's climate,0,1,0,1,0,0,0,2
country's electricity,0,0,1,0,1,0,0,2
country's lettuce,0,0,0,0,0,1,0,1
country's plans,0,0,0,0,1,0,0,1
country's political,0,0,0,0,1,1,0,2
country's worst,0,0,0,0,0,1,0,1
county community,0,0,0,1,0,0,0,1
county east,0,0,0,0,1,0,1,2
county manager,0,2,0,0,0,0,0,2
county metropolitan,0,0,0,2,0,0,0,2
county officials,0,1,0,0,0,1,0,2
county residents,0,0,0,1,1,0,0,2
county road,0,1,0,0,0,0,0,1
county sheriff,0,0,0,0,0,2,0,2
county south,0,0,0,2,0,0,0,2
county w.va,1,0,0,0,0,0,0,1
couple weeks,0,1,0,0,0,0,0,1
court building,0,0,0,1,0,0,0,1
cover cropping,0,1,0,0,0,0,0,1
cover highway,0,0,0,1,0,0,0,1
cover rocketing,0,0,1,1,0,0,0,2
covers climate,0,1,0,0,0,0,0,1
covers drought,0,0,0,0,1,0,0,1
cow walks,1,0,0,0,0,0,0,1
cpsc suggested,0,0,0,1,0,0,0,1
cracked windows,0,0,2,0,0,0,0,2
created islands,1,0,0,0,0,0,0,1
credit represents,0,2,0,0,0,0,0,2
crestview elementary,0,0,0,0,0,0,1,1
critical lenses,0,0,0,0,0,1,0,1
critical water,0,0,0,0,0,2,0,2
critical wildlife,0,0,0,0,0,1,0,1
crop failures,1,0,1,0,0,0,0,2
crucial season,0,0,0,2,0,0,0,2
crustose coralline,0,1,0,0,0,0,0,1
cubic meter,0,0,0,1,0,0,0,1
culpeper va,0,0,0,0,1,0,0,1
cultured meat,0,1,0,0,0,0,0,1
curator dorothy,0,1,0,0,0,0,0,1
current energy,0,0,0,1,0,0,0,1
current fuel,1,0,0,0,0,0,0,1
current promises,0,2,0,0,0,0,0,2
current range,0,0,0,0,0,1,0,1
current system,0,1,0,1,0,0,0,2
cut carbon,0,1,0,1,0,0,0,2
cut pollution,0,1,0,0,1,0,0,2
cyclone freddy,0,0,0,0,0,1,0,1
dado pakistan,1,0,0,0,0,0,0,1
daily basis,0,0,1,0,0,0,1,2
dallas home,0,0,0,0,1,0,0,1
dallas morning,0,0,1,0,0,0,0,1
damage finance,0,2,0,0,0,0,0,2
damage inflicted,0,1,0,0,0,0,0,1
damage left,0,0,0,0,0,0,1,1
damaged baseball,0,1,0,0,0,0,0,1
damaged houses,0,1,0,0,0,0,0,1
damaged trailer,1,0,0,0,0,0,0,1
damages caused,0,1,0,1,0,0,0,2
damaging buildings,0,0,0,0,0,1,0,1
damaging storms,0,0,1,0,1,0,0,2
dana cronin,0,0,0,1,0,0,0,1
dance routine,0,0,0,0,1,0,0,1
dance teacher,0,0,0,0,1,0,0,1
dangerous flooding,0,0,0,2,0,0,0,2
dangerous levels,0,0,1,0,1,0,0,2
dangerous storms,0,1,0,0,1,0,0,2
dangerously cold,0,0,0,0,1,0,0,1
daniel started,1,0,0,0,0,0,0,1
danielle venton,0,0,0,1,0,0,0,1
danny palmer,0,1,0,0,0,0,0,1
dark hurricane,0,1,0,0,0,0,0,1
dasgupta ceo,0,2,0,0,0,0,0,2
data daily,0,0,0,0,0,1,0,1
data dating,0,0,0,0,1,1,0,2
dattu narayan,0,1,0,0,0,0,0,1
dave mistich,1,0,0,0,0,0,0,1
david senio,0,0,0,2,0,0,0,2
davis charges,0,0,0,2,0,0,0,2
davis lives,0,0,0,2,0,0,0,2
davis talks,0,1,0,0,0,0,0,1
davis warned,0,1,0,0,0,0,0,1
day barua,0,0,0,0,0,1,0,1
day care,0,0,0,0,0,0,1,1
day review,0,0,0,0,0,1,0,1
daytona beach,0,2,0,0,0,0,0,2
de risk,0,2,0,0,0,0,0,2
de souza,0,0,0,0,0,0,1,1
dead trees,0,0,1,0,0,0,0,1
dead whales,0,0,0,0,1,0,0,1
dead whitebark,0,0,0,0,0,1,0,1
debris scattered,0,0,0,0,0,0,1,1
decades sienna,0,0,0,0,0,0,1,1
december pumpkins,0,1,0,0,0,0,0,1
december texas,0,0,2,0,0,0,0,2
decision maker,0,1,0,0,0,0,0,1
deep roots,0,1,1,0,0,0,0,2
deep sea,0,0,0,0,1,0,0,1
deeply alarmed,0,0,0,2,0,0,0,2
defense fund,0,0,0,1,0,0,0,1
defense official,0,0,0,0,1,0,0,1
defined term,0,1,0,0,0,0,0,1
deforestation exacerbates,0,0,0,0,0,1,0,1
deforested land,0,0,0,0,0,0,1,1
degree celsius,0,1,0,1,0,0,0,2
degree fahrenheit,0,0,1,0,0,0,1,2
degree mark,0,0,0,1,0,0,0,1
degree warming,0,0,0,1,0,0,0,1
delegation urged,0,0,0,0,0,2,0,2
delhi india,0,0,0,0,1,1,0,2
deliver climate,0,2,0,0,0,0,0,2
delivered heavy,0,0,0,0,1,0,0,1
delivered snow,0,0,0,1,0,0,0,1
delivering results,0,1,0,0,0,0,0,1
delivery vans,0,0,1,0,0,0,0,1
democratic candidate,1,0,0,0,0,0,0,1
democratic governors,1,0,0,0,0,0,0,1
democratic votes,1,0,0,0,0,0,1,2
demonstrators pretend,0,0,0,1,0,0,0,1
department plan,0,2,0,0,0,0,0,2
deposit return,0,0,0,1,0,0,0,1
deputy director,0,0,0,0,1,1,0,2
deputy minister,0,0,0,0,1,0,0,1
der spiegel,0,0,1,1,0,0,0,2
desalinated water,0,1,0,0,0,0,0,1
desalination plant,0,0,0,1,1,0,0,2
desert city's,0,0,0,0,1,0,0,1
desert crop,1,0,0,0,0,0,0,1
desert west,0,0,0,0,1,0,0,1
design mod,0,1,0,0,0,0,0,1
designing water,0,0,0,1,0,0,0,1
desk joins,0,0,0,2,0,0,0,2
desperate situation,0,0,1,1,0,0,0,2
destroyed buildings,1,0,0,0,0,1,0,2
destroyed business,0,0,0,0,0,0,1,1
destroyed church's,0,1,0,0,0,0,0,1
destroyed gym,0,0,0,0,0,0,1,1
destroyed homes,0,0,1,0,0,0,1,2
destroyed village,1,0,0,0,0,0,0,1
destructive thunderstorms,1,0,0,0,0,0,0,1
determine flight,0,0,0,0,0,1,0,1
detroit michigan,0,0,0,0,0,1,0,1
devan schwartz,0,1,1,0,0,0,0,2
devastating impacts,1,1,0,0,0,0,0,2
devastating storms,0,0,0,1,1,0,0,2
developed world,0,2,0,0,0,0,0,2
developing economies,0,1,0,0,0,1,0,2
development agencies,0,1,0,0,0,0,0,1
development brian,0,1,0,0,0,0,0,1
development facility,0,0,0,0,0,1,0,1
development manager,0,0,0,0,1,0,0,1
development report,0,0,0,0,0,2,0,2
dhabi international,0,0,0,1,0,0,0,1
dhabi united,0,0,0,1,0,0,0,1
die offs,0,0,1,0,0,0,0,1
dieye tells,0,0,0,0,1,0,0,1
digging people,0,0,0,0,0,0,1,1
digital model,1,0,0,0,0,0,0,1
digital thermometers,0,0,0,1,0,0,0,1
dillen president,0,0,0,0,0,2,0,2
dioxide air,0,0,0,0,1,0,0,1
dioxide matters,0,0,0,0,1,0,0,1
dioxide methane,1,1,0,0,0,0,0,2
direct result,0,1,0,0,0,1,0,2
director upmanyu,0,1,0,0,0,0,0,1
dirtiest air,0,0,0,0,2,0,0,2
disaster assistance,0,1,0,0,1,0,0,2
disaster recovery,0,1,0,0,0,0,1,2
disease control,0,1,0,0,0,1,0,2
dishonest climate,0,2,0,0,0,0,0,2
disney world,1,1,0,0,0,0,0,2
displace indigenous,0,0,2,0,0,0,0,2
displaced hundreds,1,0,0,0,0,0,0,1
displacing people,0,0,0,0,1,1,0,2
displays current,1,0,0,0,0,0,0,1
disproportionately affected,0,0,0,0,0,1,0,1
distance flying,0,1,0,0,0,0,0,1
distributed energy,0,0,0,1,0,0,0,1
distribution sites,1,0,0,0,0,1,0,2
district board,1,0,0,0,0,0,0,1
disturb alaska's,0,0,0,0,0,1,0,1
doctoral student,0,0,1,1,0,0,0,2
dog finn,0,1,0,0,0,0,0,1
dollar amount,0,0,0,0,1,0,0,1
dollar amounts,0,0,0,0,1,0,0,1
dollar question,0,1,1,0,0,0,0,2
dollars developing,0,1,1,0,0,0,0,2
domestic coal,0,0,0,0,1,0,0,1
domestic manufacturing,0,0,1,0,0,0,0,1
domestic product,0,1,0,0,0,1,0,2
dominant language,0,0,0,1,0,0,0,1
donald trump's,0,0,0,1,1,0,0,2
donkey cart,1,0,0,0,0,0,0,1
doomsday glacier,0,0,0,0,1,0,0,1
doug mcschooler,0,0,0,0,0,0,1,1
downtown los,0,0,0,0,1,0,0,1
downtown milan,0,0,0,0,0,1,0,1
downtowns colleges,2,0,0,0,0,0,0,2
dozen climate,0,0,1,1,0,0,0,2
dozen countries,0,2,0,0,0,0,0,2
dr michael,0,0,0,0,1,1,0,2
dr william,2,0,0,0,0,0,0,2
drastic change,1,0,0,0,1,0,0,2
drastically improving,0,0,0,1,1,0,0,2
drawn criticism,0,0,0,0,1,1,0,2
drazan democrat,1,0,0,0,0,0,0,1
drier hotter,1,0,1,0,0,0,0,2
drilling fracking,0,0,0,0,1,0,0,1
drinking coffee,0,0,0,1,0,0,0,1
drive climate,0,1,0,1,0,0,0,2
driven extreme,0,1,0,0,0,0,0,1
drivers rev,0,0,1,1,0,0,0,2
drop dramatically,0,1,0,1,0,0,0,2
dropped heavy,0,0,0,0,1,0,0,1
dropped possibly,0,0,0,0,0,0,1,1
dropped revealing,0,0,0,1,0,0,0,1
drought hit,0,0,0,0,2,0,0,2
drought reservoirs,0,0,0,2,0,0,0,2
droughts floods,0,0,1,0,0,1,0,2
dry air,0,0,0,0,0,1,0,1
dry land,0,1,0,0,0,1,0,2
dry periods,0,0,0,2,0,0,0,2
dry summer,0,1,0,0,0,0,1,2
dulce calif,0,0,0,0,1,0,0,1
dung sticks,0,0,0,0,0,1,0,1
dunn left,0,0,1,0,0,0,0,1
dunn lost,0,0,1,0,0,0,0,1
duration storage,0,1,0,0,0,0,0,1
dwight yoakam,0,1,0,0,0,0,0,1
dystopian world,0,0,0,1,0,1,0,2
earth fund,0,2,0,0,0,0,0,2
earth's ecosystems,0,0,2,0,0,0,0,2
earth's surface,0,0,1,0,1,0,0,2
east asia,0,0,0,0,0,2,0,2
east burke,0,0,0,2,0,0,0,2
east central,0,0,0,1,0,1,0,2
east kentucky,0,1,0,0,0,0,0,1
eastern half,1,0,0,0,0,0,0,1
eastern oklahoma,0,0,0,0,0,1,0,1
eastern region,0,0,0,1,0,0,0,1
eastward shift,0,0,0,0,0,2,0,2
eat meat,0,1,0,1,0,0,0,2
eats turf,0,1,0,0,0,0,0,1
ecological disaster,0,0,0,0,2,0,0,2
ecologically intact,0,0,2,0,0,0,0,2
ecologist enric,0,1,0,0,0,0,0,1
economic damage,0,0,0,0,0,1,1,2
economies including,0,2,0,0,0,0,0,2
economist tim,0,0,0,0,0,1,0,1
economy depends,0,0,2,0,0,0,0,2
ecosystem rainforest,0,0,0,0,0,0,1,1
ecosystem services,1,0,1,0,0,0,0,2
ed whestine's,0,0,0,0,0,0,1,1
education specialist,0,0,0,0,1,0,0,1
effect snow,0,0,0,1,1,0,0,2
egypt call,0,1,0,0,0,0,0,1
egypt's syndicate,0,1,0,0,0,0,0,1
egyptian president,0,2,0,0,0,0,0,2
eighth grade,0,0,0,1,0,0,0,1
el cardon,0,0,0,0,0,1,0,1
el niágara,0,0,0,1,0,0,0,1
el nino,0,0,0,0,0,0,1,1
elected official,0,1,0,1,0,0,0,2
electric buses,0,0,0,0,1,0,0,1
electric car,0,0,0,2,0,0,0,2
electric companies,1,0,0,0,1,0,0,2
electric grids,0,1,1,0,0,0,0,2
electric hybrid,0,0,0,0,1,0,0,1
electric motor,0,0,0,0,1,0,0,1
electric power,0,1,0,1,0,0,0,2
electric school,0,1,0,0,0,0,1,2
electric utility,0,1,0,0,0,0,0,1
electricity poles,0,0,0,1,0,0,0,1
electricity sold,2,0,0,0,0,0,0,2
electricity spin,0,0,1,0,0,0,0,1
elementary school,0,0,0,0,0,0,1,1
elevation snow,0,0,0,0,0,1,0,1
elizabeth national,0,0,0,0,0,1,0,1
elizabeth rembert,0,0,1,0,0,0,0,1
elizabeth warren,1,0,0,0,0,1,0,2
elon musk,1,0,0,0,1,0,0,2
emailed statement,0,0,0,0,1,1,0,2
emails seeking,0,0,0,0,1,0,0,1
embajada san,0,0,0,1,0,0,0,1
embracing electric,0,0,1,1,0,0,0,2
emergency alert,0,0,0,1,0,0,0,1
emergency alerts,0,2,0,0,0,0,0,2
emergency crews,0,0,0,1,0,0,1,2
emergency economy,0,0,1,1,0,0,0,2
emergency response,0,1,0,0,1,0,0,2
emily jones,0,0,0,1,0,0,0,1
emirates feb,0,0,0,0,0,1,0,1
emirati minister,0,0,0,1,0,0,0,1
emission reductions,1,1,0,0,0,0,0,2
emission standards,0,0,0,0,0,1,0,1
emissions continue,0,1,1,0,0,0,0,2
emissions details,0,2,0,0,0,0,0,2
emissions faster,0,0,0,1,1,0,0,2
emissions fleets,0,0,1,0,0,0,0,1
emissions immediately,0,1,0,0,0,1,0,2
emissions joseph,2,0,0,0,0,0,0,2
emissions quickly,0,1,0,0,1,0,0,2
emissions reduction,0,1,0,1,0,0,0,2
emissions standards,0,0,1,0,0,1,0,2
emissions targets,1,1,0,0,0,0,0,2
emissions trucks,0,0,1,0,0,0,0,1
emissions vehicles,0,0,0,0,1,0,0,1
emissions worldwide,0,1,0,0,0,0,0,1
emit pollution,0,0,0,0,1,0,0,1
emmanuel macron,0,1,0,1,0,0,0,2
emphasize social,0,0,2,0,0,0,0,2
empire la,0,1,0,0,0,0,0,1
employees employed,0,0,0,2,0,0,0,2
empty blue,1,0,0,0,0,0,0,1
empty lot,0,0,0,0,0,0,1,1
en bicicleta,0,0,0,1,0,0,0,1
enable countries,0,0,1,0,1,0,0,2
energy analyst,0,0,0,0,1,0,1,2
energy association,1,0,0,0,1,0,0,2
energy bills,0,1,0,0,1,0,0,2
energy commission,0,0,0,2,0,0,0,2
energy companies,1,0,0,0,1,0,0,2
energy countries,0,2,0,0,0,0,0,2
energy crisis,0,1,0,0,0,1,0,2
energy economy,0,1,0,0,1,0,0,2
energy efficiency,0,0,0,1,1,0,0,2
energy goals,0,1,0,1,0,0,0,2
energy market,0,0,1,0,1,0,0,2
energy monitor,0,0,0,0,1,1,0,2
energy policies,0,1,0,1,0,0,0,2
energy source,0,0,0,1,1,0,0,2
energy supply,0,0,1,0,1,0,0,2
engine manufacturers,0,0,1,0,0,0,0,1
enormous amounts,0,1,0,0,0,1,0,2
enric ballesteros,0,1,0,0,0,0,0,1
entire community,0,0,0,1,0,0,0,1
entire families,1,0,0,0,0,0,0,1
entire wall,0,0,0,1,0,0,0,1
entire west,0,1,0,0,1,0,0,2
entire world,0,2,0,0,0,0,0,2
environment campaigns,0,0,0,0,1,0,0,1
environment minister,0,1,0,0,0,0,0,1
environment moench,0,0,0,0,1,0,0,1
environmental activist,0,1,0,1,0,0,0,2
environmental cleanup,1,0,0,0,0,0,0,1
environmental consequences,0,0,0,0,1,1,0,2
environmental organization,0,0,0,1,1,0,0,2
environmental responsibility,0,0,2,0,0,0,0,2
environmental threat,0,0,2,0,0,0,0,2
environmentalist green,0,0,1,1,0,0,0,2
environmentally friendly,0,0,0,2,0,0,0,2
envoy john,0,1,0,0,0,1,0,2
epa administrator,0,0,0,1,0,1,0,2
equatorial undercurrent,0,0,1,0,0,0,0,1
eric balken,0,0,0,1,0,0,0,1
erosion threaten,1,0,0,0,0,0,0,1
esg initiative,0,0,2,0,0,0,0,2
esg responding,0,0,2,0,0,0,0,2
esposito phd,1,0,0,0,0,0,0,1
estero island,0,1,0,0,0,0,0,1
european companies,0,0,0,0,0,1,0,1
evaluating risks,0,0,2,0,0,0,0,2
everidge green,0,1,0,0,0,0,0,1
everyone's mind,0,1,0,0,1,0,0,2
exacerbates flooding,0,0,0,0,0,1,0,1
exact path,1,1,0,0,0,0,0,2
examining inverted,0,1,0,0,0,0,0,1
excess amounts,1,0,0,0,0,0,0,1
executive vice,0,1,0,0,0,1,0,2
exhibition conference,0,0,0,1,0,0,0,1
existential threat,0,0,1,0,0,1,0,2
existential threats,0,0,2,0,0,0,0,2
expand domestic,0,0,1,0,0,0,0,1
expected tuesday,0,0,0,1,0,0,0,1
experience change,0,0,0,2,0,0,0,2
experience short,0,0,0,2,0,0,0,2
experiencing climate,1,0,0,0,1,0,0,2
experiments set,0,0,0,0,0,1,0,1
experts agree,1,0,0,0,1,0,0,2
experts warn,1,0,0,0,0,1,0,2
exposed skin,0,0,0,0,2,0,0,2
extra electricity,0,1,0,0,0,0,0,1
extra inventory,0,0,0,2,0,0,0,2
extra time,1,0,0,1,0,0,0,2
extrapolations tells,0,0,0,0,0,0,1,1
extreme rainstorms,0,0,0,2,0,0,0,2
extreme warmth,1,0,0,0,0,0,0,1
exxonmobil trial,0,0,0,1,0,0,0,1
faa tower,0,0,0,0,1,0,0,1
faced heavy,0,0,0,0,1,0,0,1
facing humanity,0,2,0,0,0,0,0,2
facing pressure,0,0,1,0,1,0,0,2
faculty director,0,0,2,0,0,0,0,2
fairbanks alaska,0,0,0,0,0,1,0,1
falkland islands,0,1,0,0,0,0,0,1
fall opportunities,0,0,0,1,0,0,0,1
family farm,0,1,0,0,0,0,0,1
family foundation,1,0,0,1,0,0,0,2
family home,1,0,0,0,1,0,0,2
family planning,0,1,0,0,0,0,0,1
family supported,0,0,0,2,0,0,0,2
family's coal,0,0,0,0,1,0,0,1
family's destroyed,0,1,0,0,0,0,0,1
fargo bank,0,0,0,0,0,1,0,1
farm soil,0,1,0,0,0,0,0,1
farm southwest,0,0,0,0,0,0,1,1
farmer dattu,0,1,0,0,0,0,0,1
farming equipment,0,0,0,1,0,0,0,1
farther east,0,0,0,0,1,0,0,1
fast rate,1,0,0,1,0,0,0,2
fastest population,0,1,0,0,1,0,0,2
fastest warming,0,0,0,2,0,0,0,2
fatal collision,0,0,1,1,0,0,0,2
fatality rate,0,0,0,0,0,1,0,1
father's footsteps,0,1,0,0,0,0,0,1
fatiha khan,0,0,0,1,0,0,0,1
fattah el,0,2,0,0,0,0,0,2
faubourg marigny,0,1,0,0,0,0,0,1
feared missing,1,0,0,0,0,0,0,1
february ricki,0,0,0,0,1,0,0,1
federal agency,0,1,0,0,1,0,0,2
federal aid,0,1,0,1,0,0,0,2
federal assistance,0,1,0,1,0,0,0,2
federal government's,0,0,0,0,0,2,0,2
federal initiative,1,0,0,0,0,0,0,1
federal law,1,0,0,1,0,0,0,2
federal official,0,0,0,1,0,0,0,1
federal regulators,0,0,0,1,0,1,0,2
federal resources,0,0,0,0,0,1,1,2
feed livestock,0,0,0,0,0,1,0,1
feed white,0,0,0,2,0,0,0,2
feel relentless,0,0,0,0,0,1,0,1
feet deep,0,2,0,0,0,0,0,2
feet tall,0,1,0,1,0,0,0,2
felled split,0,0,0,2,0,0,0,2
fence runs,0,1,0,0,0,0,0,1
ferrer untitled,0,0,0,1,0,0,0,1
ferries passengers,1,0,0,0,0,0,0,1
ferry passes,0,0,0,0,1,0,0,1
fertilize crops,1,0,0,0,0,0,0,1
fetal heartbeat,1,0,0,0,0,0,0,1
field suffers,1,0,0,0,0,0,0,1
fill propane,0,0,0,0,1,0,0,1
fills cans,0,0,0,0,0,1,0,1
final day,0,1,0,0,0,0,0,1
final stretch,0,2,0,0,0,0,0,2
finance kerry,0,1,0,0,0,0,0,1
financial pressure,0,0,0,0,1,0,0,1
financial risk,0,2,0,0,0,0,0,2
financial threat,0,0,2,0,0,0,0,2
finding markets,0,0,0,2,0,0,0,2
fiona damaged,0,1,0,0,0,0,0,1
fiona toppled,0,1,0,0,0,0,0,1
fire departments,0,0,0,0,1,1,0,2
fire hydrant,0,0,0,0,1,0,0,1
fire prevention,0,0,1,0,0,0,0,1
fire zone,0,0,0,1,0,0,0,1
firefighter stands,0,0,0,1,0,0,0,1
firm called,0,0,1,1,0,0,0,2
firm paid,0,0,1,0,0,0,0,1
firm sbr,0,0,0,0,1,0,0,1
fish swim,0,0,0,0,1,0,0,1
fisherman secures,1,0,0,0,0,0,0,1
fishing mining,0,0,0,0,1,1,0,2
fishing village,1,0,0,0,0,0,0,1
flare burning,1,0,0,0,0,0,0,1
flat spot,0,0,2,0,0,0,0,2
flathead indian,0,0,0,0,0,1,0,1
flavio volpe,0,0,0,0,0,1,0,1
flight attendants,0,0,1,0,0,0,0,1
flight patterns,0,0,0,0,0,1,0,1
floated underneath,0,0,2,0,0,0,0,2
flood destroyed,1,0,0,0,0,0,0,1
flood maps,1,0,0,0,0,0,0,1
flood watches,0,0,0,0,1,1,0,2
flooded coastlines,0,0,0,0,2,0,0,2
flooded homes,0,1,0,0,1,0,0,2
flooded lake,1,0,0,0,0,0,0,1
flooded neighborhood,0,0,0,0,1,0,0,1
flooded parking,0,0,0,1,0,0,0,1
flooded roadway,0,0,0,1,0,0,0,1
flooded water,0,0,0,1,0,0,0,1
flooding events,0,0,0,0,1,0,0,1
flooding griffin's,1,0,0,0,0,0,0,1
flooding levee,1,0,0,0,0,0,0,1
flooding local,1,0,0,0,0,0,0,1
flooding nearby,0,0,0,0,0,1,0,1
flooding rains,0,0,0,1,0,0,0,1
floodlight hide,0,0,1,0,0,0,0,1
floodlights damaged,0,1,0,0,0,0,0,1
floods breached,1,0,0,0,0,0,0,1
floods luthier,0,1,0,0,0,0,0,1
floods morgan's,0,1,0,0,0,0,0,1
floods washed,1,0,0,0,0,0,0,1
floods wildfires,0,0,0,0,1,1,0,2
floodwaters rose,1,0,0,0,0,0,0,1
florida coast,1,1,0,0,0,0,0,2
florida gov,1,0,0,1,0,0,0,2
florida survived,1,0,0,0,0,0,0,1
florida's sanibel,1,0,0,0,0,0,0,1
florida's southwestern,1,1,0,0,0,0,0,2
fluctuating prices,1,0,0,0,0,0,0,1
fly larva,0,0,0,0,2,0,0,2
fly larvae,0,0,0,0,0,1,0,1
flynn's front,0,0,2,0,0,0,0,2
flynn's house,0,0,2,0,0,0,0,2
folsom california,0,0,0,1,0,0,0,1
food industry,0,2,0,0,0,0,0,2
food institute,0,1,1,0,0,0,0,2
food prices,0,1,1,0,0,0,0,2
food source,1,0,0,0,0,1,0,2
food sources,0,2,0,0,0,0,0,2
food supply,0,1,1,0,0,0,0,2
food swayam,0,1,0,0,0,0,0,1
food web,0,0,0,0,0,1,0,1
foodborne illness,0,1,0,0,0,1,0,2
foods.upside meats,0,1,0,0,0,0,0,1
foot humpback,0,0,0,0,1,0,0,1
forbes left,1,0,0,0,0,0,0,1
force base,0,1,0,0,0,0,0,1
force winds,0,1,0,0,1,0,0,2
forces eating,0,0,0,0,1,0,0,1
forcing native,0,0,2,0,0,0,0,2
forecast hazardous,0,2,0,0,0,0,0,2
foreign relations,0,1,0,1,0,0,0,2
foreseeable future,0,1,1,0,0,0,0,2
forest ecologist,0,0,1,0,0,0,0,1
forest management,1,0,0,0,0,0,1,2
forest products,0,0,0,2,0,0,0,2
forest program,1,0,0,0,0,0,1,2
forest researchers,0,0,0,0,0,1,0,1
forest's floor,0,0,0,0,0,0,1,1
forestry foundation,1,0,0,0,0,0,0,1
forever prisoners,0,0,0,0,1,0,0,1
fortunes matrix,0,0,1,0,0,0,0,1
forum annual,0,0,0,0,0,1,0,1
found shelter,0,0,0,0,0,0,1,1
fracking processing,0,0,0,0,1,0,0,1
francisco chained,0,0,0,0,0,1,0,1
frank fan,0,0,0,0,1,0,0,1
frans timmermans,0,1,0,0,0,1,0,2
fraud waste,0,0,0,0,0,0,1,1
fred davis,0,1,0,0,0,0,0,1
freddy climate,0,0,0,0,0,1,0,1
free electricity,0,0,0,0,1,0,0,1
freelance reporter,1,1,0,0,0,0,0,2
french officials,0,1,0,0,0,0,0,1
french president,0,1,0,1,0,0,0,2
fresh logs,0,0,0,2,0,0,0,2
fresno county,0,0,0,0,0,1,0,1
friday feb,0,0,0,0,1,0,0,1
friday morning,0,0,0,1,0,1,0,2
friday night's,0,0,0,0,0,1,0,1
fried tarantulas,0,0,0,0,0,1,0,1
friends including,0,0,0,0,1,0,0,1
frigid temperatures,0,0,0,0,2,0,0,2
front porch,0,0,2,0,0,0,0,2
front step,1,0,0,0,0,0,0,1
fuel based,0,0,0,1,0,0,1,2
fuel company,0,0,2,0,0,0,0,2
fuel plants,0,0,2,0,0,0,0,2
fuel products,0,0,0,1,0,0,0,1
fuel subsidy,1,1,0,0,0,0,0,2
fueled disasters,0,0,0,0,2,0,0,2
fueled misinformation,0,0,0,0,1,0,0,1
fuels replacing,0,0,1,1,0,0,0,2
fundamental issues,0,0,0,0,1,1,0,2
fundamental rights,0,0,1,1,0,0,0,2
funding climate,0,0,0,0,0,1,0,1
furniture remains,0,0,0,0,0,1,0,1
future free,0,0,1,1,0,0,0,2
future global,0,0,0,0,1,0,0,1
future growth,0,0,0,0,1,0,0,1
gabriel mountain,0,0,0,0,1,0,0,1
gabriel mountains,0,0,0,0,2,0,0,2
gabriella torres,0,0,0,1,0,0,0,1
gaining traction,0,0,0,0,1,0,0,1
galvanizing issue,0,0,0,0,0,2,0,2
gandiol senegal,0,1,0,0,0,0,0,1
garten services,1,0,0,0,0,0,0,1
garzweiler ii,0,0,0,0,1,0,0,1
gas burner,0,0,0,0,1,0,0,1
gas burning,1,0,0,1,0,0,0,2
gas inventory,0,1,0,0,0,0,0,1
gas leasing,0,0,0,0,0,1,0,1
gas lighting,2,0,0,0,0,0,0,2
gas mileage,0,0,0,0,1,0,0,1
gas pump,1,0,0,0,0,0,0,1
gas range,0,0,0,1,1,0,0,2
gas releases,0,0,1,0,0,0,1,2
gas station,1,0,0,0,0,0,0,1
gas system,0,1,0,0,0,0,0,1
gases carbon,1,1,0,0,0,0,0,2
gasoline electric,0,0,0,0,1,0,0,1
gasoline prices,1,0,0,0,0,1,0,2
gateway appliance,0,0,0,2,0,0,0,2
gathering process,0,0,0,1,1,0,0,2
gauge reader,0,0,0,0,0,1,0,1
generate credits,0,2,0,0,0,0,0,2
generate steam,1,0,0,0,0,0,0,1
generated steam,2,0,0,0,0,0,0,2
generations police,0,0,1,1,0,0,0,2
genetic diversity,0,0,2,0,0,0,0,2
geographic endurance,0,1,0,0,0,0,0,1
geographic society,0,1,0,0,0,0,0,1
geological survey,1,1,0,0,0,0,0,2
george crabtree,0,1,0,0,0,0,0,1
george recktenwald,0,2,0,0,0,0,0,2
german chancellor,0,1,1,0,0,0,0,2
germans disapprove,0,0,1,1,0,0,0,2
germany's constitutional,0,0,1,1,0,0,0,2
ghansadih july,0,0,0,0,1,0,0,1
giant crack,0,0,2,0,0,0,0,2
giant sequoia,0,0,0,0,0,1,0,1
gibson left,1,0,0,0,0,0,0,1
giorgia meloni,0,2,0,0,0,0,0,2
girl named,1,0,0,0,0,0,0,1
giving people,0,1,0,0,0,0,0,1
giving scientists,0,0,0,0,1,0,0,1
glacial runoff,0,1,0,0,0,0,0,1
glacier melting,1,0,0,0,0,0,0,1
glacier schmidt,0,0,0,0,1,0,0,1
glaciers including,0,1,0,0,0,0,0,1
glasgow scotland,0,1,0,0,0,0,0,1
glass tubes,0,0,0,0,0,1,0,1
glass walls,0,1,0,0,0,0,0,1
global co2,0,0,0,0,0,1,1,2
global community,0,1,0,0,0,0,0,1
global economy,0,0,1,0,0,1,0,2
global event,0,1,0,0,0,0,0,1
global financial,1,0,0,1,0,0,0,2
global food,0,1,0,0,1,0,0,2
global gdp,0,0,2,0,0,0,0,2
global market,1,0,0,1,0,0,0,2
global migration,0,2,0,0,0,0,0,2
global plan,0,0,1,0,0,0,0,1
global sea,0,2,0,0,0,0,0,2
global supply,1,0,0,0,0,1,0,2
global swf,0,0,0,1,0,0,0,1
glow red,0,0,0,1,1,0,0,2
glynwood boat,0,0,0,0,0,0,1,1
goal global,0,0,0,1,0,1,0,2
god bless,0,0,0,1,0,0,0,1
golf courses,0,1,0,1,0,0,0,2
gonia's dress,1,0,0,0,0,0,0,1
goodridge lumber,0,0,0,2,0,0,0,2
gore speaks,0,1,0,0,0,0,0,1
gov greg,0,1,0,0,1,0,0,2
governance investing,0,0,2,0,0,0,0,2
government action,0,1,0,0,1,0,0,2
government climate,0,0,0,2,0,0,0,2
government investment,0,1,0,0,0,1,0,2
government summit,0,0,0,0,0,1,0,1
government's lack,0,0,1,1,0,0,0,2
governor doug,0,0,0,1,1,0,0,2
governor hobbs,0,0,0,0,1,0,0,1
governor ron,1,1,0,0,0,0,0,2
governors association,1,0,0,0,0,0,0,1
gp st,0,0,0,1,0,0,0,1
gps devices,0,0,0,0,0,1,0,1
grab people's,0,1,0,1,0,0,0,2
grade science,0,0,0,1,0,0,0,1
grass rake,1,0,0,0,0,0,0,1
grass schools,0,0,0,1,0,0,0,1
grassy brown,0,0,0,0,0,1,0,1
grays ferry,1,0,0,0,0,0,0,1
greek dancer,0,1,0,0,0,0,0,1
green climate,0,2,0,0,0,0,0,2
green jr,0,1,0,0,0,0,0,1
green space,1,0,0,0,1,0,0,2
green technologies,0,1,0,1,0,0,0,2
green valley,0,0,0,0,1,0,0,1
greenpeace report,1,0,1,0,0,0,0,2
greenpeace uk,0,0,0,1,0,0,0,1
greenville fire,0,0,0,0,1,0,0,1
greets department,0,0,0,0,0,1,0,1
greg allen,0,1,0,0,0,0,0,1
grid district,1,0,0,0,0,0,0,1
grid issues,0,0,0,0,0,2,0,2
griffin surveys,1,0,0,0,0,0,0,1
griffin's farmland,1,0,0,0,0,0,0,1
grimes searches,0,0,0,0,0,0,1,1
grocery stores,0,1,0,1,0,0,0,2
gross domestic,0,1,0,0,0,1,0,2
ground underneath,0,0,2,0,0,0,0,2
groundbreaking ceremony,0,0,1,0,0,0,0,1
growing backlash,0,0,0,0,1,0,0,1
growing movement,0,1,0,0,0,0,0,1
growth means,0,0,0,0,1,0,0,1
guantanamo bay,0,0,0,0,1,0,0,1
gusty winds,0,1,0,0,1,0,0,2
haaland ultimately,0,0,0,0,0,1,0,1
hailstorm hit,0,1,0,0,0,0,0,1
hamed aleaziz,0,0,1,0,0,0,0,1
hampshire public,0,0,0,2,0,0,0,2
hampshire's capital,0,0,0,2,0,0,0,2
hampshire's winters,0,0,0,2,0,0,0,2
handheld digital,0,0,0,1,0,0,0,1
hands rwanda,0,0,1,0,0,0,0,1
harbage npr,0,1,0,0,0,1,0,2
hard crustose,0,1,0,0,0,0,0,1
harjeet singh,0,1,0,1,0,0,0,2
harper forbes,1,0,0,0,0,0,0,1
harpy eagles,0,0,0,0,0,0,1,1
harsh lives,0,0,0,0,1,0,0,1
harvesting salt,1,0,0,0,0,0,0,1
hatcher washington,1,0,0,0,0,0,0,1
hatfield's property,1,0,0,0,0,0,0,1
hauled water,0,0,0,0,1,0,0,1
hauler carrying,0,0,0,0,0,1,0,1
hayley smith,0,0,0,0,1,0,0,1
hazardous weather,0,2,0,0,0,0,0,2
head table,0,0,1,0,0,0,0,1
health association,0,0,0,1,1,0,0,2
health concern,0,0,0,1,1,0,0,2
health justification,0,0,1,0,0,0,0,1
healthy environment,0,0,0,0,1,0,0,1
healthy reef,0,1,0,0,0,0,0,1
heard similar,0,0,2,0,0,0,0,2
heat levels,0,0,0,1,0,0,0,1
heat makes,2,0,0,0,0,0,0,2
heat measurements,0,0,0,1,0,0,0,1
heating fossil,1,0,0,0,0,0,1,2
heats philadelphia,1,0,0,0,0,0,0,1
heavier rainfall,0,0,0,1,0,0,0,1
heavier storms,0,0,0,1,0,0,0,1
heavy equipment,0,0,2,0,0,0,0,2
heavy machinery,0,0,0,2,0,0,0,2
heavy metals,0,0,0,0,1,0,0,1
heavy precipitation,0,0,0,1,1,0,0,2
heavy snowfall,0,0,0,0,1,0,0,1
heavy winds,0,1,0,0,0,0,0,1
helber ap,1,0,0,0,0,0,0,1
helped lake,0,0,0,0,1,0,0,1
helped raise,0,0,0,0,0,1,0,1
helped seed,1,0,0,0,0,0,0,1
helped spread,0,0,0,0,0,1,0,1
helping coordinate,0,0,1,0,1,0,0,2
helping rescue,1,0,0,0,0,0,0,1
helps maria,1,0,0,0,0,0,0,1
helsinki zoo,0,1,0,0,0,0,0,1
herald reporter,0,0,1,0,0,0,0,1
hey bro,1,0,0,0,0,0,0,1
highly insufficient,0,1,0,0,0,1,0,2
highly sensitive,0,1,0,0,0,0,0,1
highway exit,0,0,1,1,0,0,0,2
hill calif,0,0,0,1,0,0,0,1
himalayan mountains,0,1,0,0,0,1,0,2
hirai olen,0,0,0,0,1,0,0,1
historic amounts,0,0,0,0,2,0,0,2
historic floods,0,1,0,0,0,1,0,2
historic navajo,0,0,0,0,0,1,0,1
historic site,0,0,0,0,1,0,0,1
history books,0,0,0,0,0,1,0,1
hit california,0,0,0,1,0,1,0,2
hit farms,0,0,0,0,2,0,0,2
hit puerto,1,0,0,0,1,0,0,2
hj mai,0,1,0,0,0,1,0,2
hobbs told,0,0,0,0,1,0,0,1
hoehn saric,0,0,0,0,1,0,0,1
hoffman milwaukee,1,0,0,0,0,0,0,1
holding fertile,0,0,1,0,0,0,0,1
holds mangrove,0,1,0,0,0,0,0,1
holiday season,0,0,1,0,0,0,0,1
hollister calif,0,0,0,0,0,1,0,1
home appliance,0,0,0,0,1,0,0,1
home builders,0,1,0,0,0,0,0,1
home carry,0,0,0,0,0,1,0,1
home destroyed,0,0,0,0,0,1,0,1
home plate,0,1,0,0,0,0,0,1
home village,0,0,0,0,0,1,0,1
homeland security,0,1,0,0,0,0,0,1
homeless shelter,0,0,0,1,0,0,0,1
homeowner ben,0,0,2,0,0,0,0,2
homes intensifying,0,0,0,0,1,0,0,1
homes sunday,0,0,0,0,0,1,0,1
horsley scott,0,0,0,0,0,1,0,1
hot days,0,1,0,0,0,0,1,2
hot dry,0,0,0,0,0,1,0,1
hot topic,0,0,2,0,0,0,0,2
hotel freezer,0,1,0,0,0,0,0,1
hotter drier,1,0,0,0,0,1,0,2
hotter rainfall,0,1,0,1,0,0,0,2
hotter temperatures,0,1,0,0,0,0,1,2
hour south,0,0,0,0,1,0,1,2
hour video,0,0,0,1,0,0,0,1
hour wind,0,1,0,0,1,0,0,2
hourly guideline,0,0,0,0,1,0,0,1
house caused,1,0,0,0,0,0,0,1
house nov,0,1,0,0,0,0,0,1
house oversight,0,0,0,1,0,0,0,1
house press,0,1,0,0,0,1,0,2
house submerged,0,0,0,1,0,0,0,1
house tribal,0,0,0,0,0,1,0,1
houston power,0,0,0,0,1,0,0,1
hub newsroom,0,0,0,1,0,0,0,1
huerta soto,0,0,0,0,0,1,0,1
huge amount,0,2,0,0,0,0,0,2
huge amounts,0,1,1,0,0,0,0,2
huge difference,1,1,0,0,0,0,0,2
huge impact,0,0,0,1,0,0,1,2
huge snowstorms,0,0,0,2,0,0,0,2
huge storm,0,0,0,1,1,0,0,2
humacao puerto,0,0,0,1,0,0,0,1
human activity,1,1,0,0,0,0,0,2
human chain,0,0,0,0,0,1,0,1
human development,0,2,0,0,0,0,0,2
human induced,0,1,0,1,0,0,0,2
human life,0,0,0,1,1,0,0,2
human vocal,0,0,0,0,0,1,0,1
humans approximately,0,0,0,0,0,1,0,1
humid air,0,0,0,0,0,1,1,2
humpback whales,0,0,0,0,1,0,0,1
hurricane andrew,1,0,0,0,0,0,0,1
hurricane prone,0,1,0,0,1,0,0,2
hurricane ravaged,0,0,0,1,0,0,0,1
hurricane storm,0,1,0,0,0,0,1,2
hurricane survivors,1,0,0,0,0,0,0,1
hurricane warnings,0,1,0,0,0,0,0,1
hurricanes floods,0,1,0,0,0,0,1,2
hurting people,1,0,0,0,1,0,0,2
husband dan,0,0,0,1,0,0,0,1
husband matt,0,0,0,0,0,0,1,1
husein mohamed,0,1,0,0,0,0,0,1
hybrids remain,0,0,0,0,1,0,0,1
hydrocarbons stand,1,0,0,0,0,0,0,1
ian jahxiel,0,1,0,0,0,0,0,1
ian passed,1,0,0,0,0,0,0,1
ian rises,0,0,0,1,0,0,0,1
ian tore,1,0,0,0,0,0,0,1
ice covered,0,1,0,0,0,1,0,2
ice extend,0,1,0,0,0,0,0,1
ice ocean,1,0,0,0,1,0,0,2
icefin operates,0,0,0,0,1,0,0,1
iconic blue,0,0,0,1,1,0,0,2
ignore climate,0,0,0,0,0,0,1,1
ii el,0,0,0,1,0,0,0,1
ii opencast,0,0,0,0,1,0,0,1
ill belvidere,0,0,0,0,0,0,1,1
illegal palm,0,0,0,0,0,0,1,1
image cracks,0,1,0,0,0,0,0,1
image oil,0,1,0,0,0,0,0,1
immortalized cell,0,1,0,0,0,0,0,1
imperiling reserves,0,0,0,1,0,0,0,1
impose liberal,0,0,2,0,0,0,0,2
impossible burger,0,0,0,0,0,1,0,1
improve predictions,0,0,0,1,0,0,0,1
improving emissions,0,0,0,1,1,0,0,2
inch gap,0,0,2,0,0,0,0,2
include amtrak's,2,0,0,0,0,0,0,2
include information,0,1,0,0,0,0,0,1
include measures,0,0,0,0,0,1,1,2
including carbon,0,0,0,0,1,1,0,2
including fatiha,0,0,0,1,0,0,0,1
including heat,0,0,0,1,0,1,0,2
including indonesia,0,2,0,0,0,0,0,2
including mars,0,1,0,0,0,0,0,1
including president,1,1,0,0,0,0,0,2
including suhani,0,0,0,0,1,0,0,1
income nations,0,2,0,0,0,0,0,2
inconvenient truth,0,0,0,0,0,0,1,1
increase funding,1,1,0,0,0,0,0,2
increase public,0,0,0,1,0,0,1,2
increased rainfall,1,0,0,0,0,0,0,1
increases immediately,0,0,0,1,0,0,0,1
increasing pressure,0,0,0,0,1,1,0,2
increasingly powered,0,0,0,0,0,1,1,2
ind grimes,0,0,0,0,0,0,1,1
independent candidate,1,0,0,0,0,0,0,1
india plans,0,0,0,0,1,0,0,1
indian border,0,0,0,0,0,1,0,1
indian tribe,1,1,0,0,0,0,0,2
indigenous forum,0,0,2,0,0,0,0,2
indigenous language,0,0,2,0,0,0,0,2
individual actions,0,0,0,1,0,0,0,1
individual countries,1,0,0,0,0,1,0,2
indonesia's coordinating,0,0,0,0,1,0,0,1
indonesia's power,0,0,0,0,1,0,0,1
indonesia's president,0,0,0,0,1,0,0,1
indonesia's renewable,0,0,0,0,1,0,0,1
indonesian government,0,0,0,0,1,0,0,1
indoor workers,0,1,0,0,0,0,0,1
industrial zoned,0,0,0,0,1,0,0,1
industry lawmakers,0,0,2,0,0,0,0,2
industry officials,1,0,0,0,0,0,0,1
industry research,0,0,0,1,1,0,0,2
industry trade,1,0,1,0,0,0,0,2
infect humans,0,0,0,0,0,1,0,1
infected people,0,0,0,0,0,1,0,1
infections mountain,0,0,0,0,0,1,0,1
infectious disease,0,0,0,0,1,1,0,2
influencemap found,0,0,1,0,0,0,0,1
information gathering,0,0,0,1,1,0,0,2
infrared gas,0,0,0,1,1,0,0,2
infrastructure planning,0,0,0,2,0,0,0,2
initial phase,0,2,0,0,0,0,0,2
initial storm,1,0,0,0,0,0,0,1
initiative plans,0,1,0,0,0,0,0,1
innerarity california,0,0,0,1,0,1,0,2
insect feed,0,0,0,0,0,1,0,1
instagram post,1,0,0,0,0,0,0,1
install solar,0,0,0,2,0,0,0,2
institute walks,0,0,0,1,0,0,0,1
insurance companies,0,0,0,0,2,0,0,2
intense period,0,1,0,0,1,0,0,2
intensifies rain,0,1,0,0,0,1,0,2
intermittent wind,0,0,2,0,0,0,0,2
internal matrix,0,0,1,0,0,0,0,1
international auto,0,0,0,0,1,0,0,1
international community,0,1,0,0,1,0,0,2
international indigenous,0,0,2,0,0,0,0,2
international monetary,1,1,0,0,0,0,0,2
international petroleum,0,0,0,1,0,0,0,1
interpreter yeah,0,1,0,0,0,0,0,1
inventory launch,0,1,0,0,0,0,0,1
inverted water,0,1,0,0,0,0,0,1
investigate environmental,0,0,2,0,0,0,0,2
investing billions,0,0,1,0,0,1,0,2
investing officer,0,0,2,0,0,0,0,2
investment choices,0,0,2,0,0,0,0,2
investors decide,0,0,2,0,0,0,0,2
investors genuinely,0,0,2,0,0,0,0,2
involves promoting,0,1,0,0,0,0,0,1
irate drivers,0,0,1,0,0,0,0,1
irreversible possibly,0,0,2,0,0,0,0,2
irs spokesperson,0,0,0,0,0,1,1,2
isaac rodríguez,0,1,0,0,0,0,0,1
ischia italy,0,1,0,0,0,0,0,1
ischia sunday,0,1,0,0,0,0,0,1
island colombia,1,0,0,0,0,0,0,1
island developing,0,1,0,0,0,0,0,1
island fort,1,0,0,0,0,0,0,1
island nation,0,0,0,1,0,0,0,1
island's electric,0,1,0,0,0,0,0,1
islands brought,1,0,0,0,0,0,0,1
islands exercises,0,1,0,0,0,0,0,1
issues head,0,0,0,0,2,0,0,2
issues including,0,0,1,0,0,1,0,2
jaber ceo,0,0,0,0,0,1,0,1
jaber speaks,0,0,0,1,0,0,0,1
jahan helped,0,0,0,0,0,1,0,1
jair bolsonaro,0,1,0,0,0,0,1,2
jake bittle,0,0,0,0,1,0,0,1
jal n.m,1,0,0,0,0,0,0,1
james kirkham,1,0,0,0,0,0,0,1
jameson lane,0,0,0,1,0,0,0,1
jane joyner,0,0,0,0,0,0,1,1
janet erik,0,0,2,0,0,0,0,2
janine felson,0,1,0,0,0,0,0,1
january morning,0,0,0,2,0,0,0,2
january record,0,0,0,1,0,0,0,1
jay price,0,1,0,0,0,0,0,1
jaycee ahlefeld,0,0,0,0,0,0,1,1
jean pierre,0,1,0,0,0,1,0,2
jebreili ap,0,0,0,1,0,1,0,2
jeff masters,0,1,0,1,0,0,0,2
jefferson county,0,0,0,2,0,0,0,2
jennifer seifert,0,1,0,0,0,0,0,1
jeremiah burrell,0,0,0,0,0,0,1,1
jervois global,1,0,0,0,0,0,0,1
jet travel,0,0,1,0,0,0,0,1
jharia born,0,0,0,0,1,0,0,1
jharia walaa,0,0,0,0,1,0,0,1
job growth,1,0,0,0,0,1,0,2
job losses,0,0,0,0,0,1,0,1
jobe abraham,0,0,2,0,0,0,0,2
joe perkins,0,0,1,0,0,0,0,1
joe songer,0,0,1,0,0,0,0,1
joel rose,0,1,0,0,0,0,0,1
jofre brazil,0,0,0,0,0,0,1,1
john antczak,0,0,0,0,1,0,0,1
john droz,0,0,0,0,1,0,0,1
john haywood,0,1,0,0,0,0,0,1
john locher,0,0,1,0,1,0,0,2
john otis,0,1,0,0,0,0,0,1
john ryan,0,0,0,0,1,0,0,1
john tyndall,0,0,0,0,0,1,0,1
john wessels,1,0,0,0,0,0,0,1
johnsen admits,0,0,1,1,0,0,0,2
johnson research,0,0,0,0,1,0,0,1
joint center,0,1,0,0,0,0,0,1
joint investigation,1,0,1,0,0,0,0,2
josh newell,0,0,1,0,0,1,0,2
journal sentinel,1,0,0,0,0,0,0,1
joy hassol,0,0,0,0,1,0,0,1
julia hit,1,0,0,0,0,0,0,1
july's catastrophic,0,1,0,0,0,0,0,1
jump rope,0,0,0,1,0,0,0,1
jurisdiction treaty,0,0,0,0,0,1,0,1
justice correspondent,0,0,0,1,0,0,0,1
kaloki hide,0,1,0,0,0,0,0,1
kaloki left,0,1,0,0,0,0,0,1
kaloki lives,1,1,0,0,0,0,0,2
kampong cham,0,0,0,0,0,1,0,1
kamran jebreili,0,0,0,1,0,1,0,2
karen mcveigh,0,0,0,1,0,0,0,1
karin sander,0,1,0,0,0,0,0,1
karine jean,0,1,0,0,0,1,0,2
karla nemeth,0,0,0,1,0,1,0,2
karnauskas hopes,0,0,1,0,0,0,0,1
kashti laden,1,0,0,0,0,0,0,1
kate morgan,0,1,0,0,0,0,0,1
katia riddle,0,1,0,0,0,0,0,1
katie leonard,0,0,0,1,0,0,0,1
katie watkins,0,0,0,0,0,0,1,1
keith phillips,0,1,0,0,0,0,0,1
kelna begum,0,0,0,0,0,1,0,1
ken james,0,0,0,0,0,1,0,1
kenneth james,0,0,0,2,0,0,0,2
kentucky rising,0,1,0,0,0,0,0,1
kenyan farmers,1,0,0,0,0,0,0,1
kevin kircher,0,0,0,0,0,1,1,2
kevin stark,0,1,0,0,0,0,0,1
key component,0,0,1,0,1,0,0,2
key regulatory,0,2,0,0,0,0,0,2
khan's release,0,0,0,0,1,0,0,1
kid fell,0,0,2,0,0,0,0,2
killed multiple,0,0,0,0,0,0,1,1
killer tsunami,1,0,0,0,0,0,0,1
kilometers west,1,0,0,0,0,0,1,2
king tide,0,1,0,0,0,0,0,1
kingdom trek,0,1,0,0,0,0,0,1
kisangani democratic,0,0,0,0,0,0,1,1
klettwitz germany,0,0,1,0,0,0,0,1
knee deep,0,0,0,1,0,1,0,2
kootenai tribes,0,0,0,0,0,1,0,1
kotzebue alaska,0,0,1,0,0,0,0,1
kris patrick,0,1,0,0,0,0,0,1
ky days,0,1,0,0,0,0,0,1
kyle arnold,0,0,1,0,0,0,0,1
kyle gassiott,0,0,0,1,0,0,0,1
la libertad,1,0,0,0,0,0,0,1
la times.hayley,0,0,0,0,1,0,0,1
lab samples,0,0,0,0,1,0,0,1
laden mudslide,1,0,0,0,0,0,0,1
lafoe typically,0,0,0,2,0,0,0,2
lake effect,0,0,0,1,1,0,0,2
lake level,0,1,0,0,0,0,0,1
lake levels,0,0,0,0,1,0,0,1
lake oroville,0,0,0,0,0,1,0,1
lake retba,1,0,0,0,0,0,0,1
lake tahoe,0,0,0,1,1,0,0,2
lake's receding,0,0,0,0,1,0,0,1
lakeport calif,1,0,0,0,0,0,0,1
land management,0,0,0,0,1,1,0,2
land marginal,0,0,0,0,1,0,0,1
land o'lakes,0,0,0,1,0,0,0,1
lands protection,0,0,0,0,0,2,0,2
lands wildlife,0,0,0,0,0,2,0,2
landslide mapping,0,0,0,1,0,0,0,1
langley air,0,1,0,0,0,0,0,1
language yugtun,0,0,2,0,0,0,0,2
laporta ap,0,1,0,0,0,0,0,1
larger picture,0,1,0,0,0,0,0,1
larger questions,0,0,0,1,1,0,0,2
largest economy,0,1,1,0,0,0,0,2
largest global,0,1,0,0,1,0,0,2
largest investment,0,0,0,1,0,0,1,2
largest oil,0,1,0,0,1,0,0,2
largest rainforest,0,0,0,0,0,0,1,1
largest remaining,0,0,0,0,1,0,1,2
largest sources,0,2,0,0,0,0,0,2
largest u.s,0,1,0,1,0,0,0,2
larose la,0,1,0,0,0,0,0,1
lasting photos,0,0,0,0,0,1,0,1
late saturday,0,0,0,0,1,0,0,1
late tuesday,0,0,0,0,1,0,0,1
laura sullivan,1,0,1,0,0,0,0,2
lava ridge,0,0,0,0,1,0,0,1
law felled,0,0,0,2,0,0,0,2
law firm,0,0,0,0,1,0,0,1
law student,0,0,1,1,0,0,0,2
lawrence berkeley,0,1,0,0,1,0,0,2
laypeople read,0,0,0,0,0,1,0,1
lead climate,0,1,0,1,0,0,0,2
lead harsh,0,0,0,0,1,0,0,1
leaders partnership,0,1,0,0,0,0,0,1
leaders summit,0,1,0,0,0,0,0,1
leafy greens,0,0,0,0,0,1,0,1
learning calculated,0,0,0,1,0,0,0,1
lease houser's,0,0,0,0,1,0,0,1
ledge light,0,0,0,0,1,0,0,1
lee county,1,0,0,0,0,0,0,1
left background,1,0,0,0,0,0,0,1
left makes,1,0,0,0,0,0,0,1
left montgomery,0,0,1,0,0,0,0,1
left prakrit,1,0,0,0,0,0,0,1
left republican,1,0,0,0,0,0,0,1
left ruts,0,0,0,2,0,0,0,2
leftover pumpkins,0,1,0,0,0,0,0,1
legal consequences,0,0,1,1,0,0,0,2
legal framework,0,0,0,0,0,2,0,2
legally binding,0,0,0,1,1,0,0,2
lesley mcclurg,0,0,0,1,0,0,0,1
lessons learned,0,1,0,1,0,0,0,2
levee district,1,0,0,0,0,0,0,1
level gauge,0,0,0,0,0,1,0,1
level segment,0,0,1,0,0,0,0,1
levels plummeted,0,0,0,0,0,1,0,1
lhakpa sonam,0,1,0,0,0,0,0,1
libertad el,1,0,0,0,0,0,0,1
libertarian free,0,0,1,1,0,0,0,2
liberty canyon,0,0,1,0,0,0,0,1
lido beach,0,0,0,0,1,0,0,1
lie toppled,0,0,0,1,0,0,0,1
life support,0,0,1,0,1,0,0,2
light dusting,0,0,0,0,2,0,0,2
light hired,0,0,1,0,0,0,0,1
lightposts knocking,0,1,0,0,0,0,0,1
lignite mine,0,0,0,0,1,0,0,1
limited resources,1,0,0,0,0,1,0,2
limiting warming,0,0,0,1,0,1,0,2
lin architect,0,1,0,0,0,0,0,1
lin curator,0,1,0,0,0,0,0,1
lin's portrait,0,1,0,0,0,0,0,1
lina johnsen,0,0,1,1,0,0,0,2
lines lie,0,0,0,1,0,0,0,1
link fence,0,1,0,1,0,0,0,2
linked sites,0,0,1,0,0,0,0,1
liquefied natural,0,0,1,1,0,0,0,2
lisa dilling,0,0,2,0,0,0,0,2
lisa murkowski,0,0,0,0,0,2,0,2
lithium bearing,0,1,0,0,0,0,0,1
lithium ion,0,1,0,0,0,0,0,1
lithium mining,0,1,0,0,0,0,0,1
live travel,1,0,0,0,0,0,0,1
lived experience,1,0,0,0,1,0,0,2
livestock manure,1,0,0,0,0,0,0,1
living crisis,0,1,0,0,0,0,0,1
living goodridge,0,0,0,2,0,0,0,2
living space,0,0,0,1,0,1,0,2
local ballots,0,1,0,0,0,0,0,1
local coal,0,0,0,0,1,0,0,1
local debates,0,0,0,0,1,0,0,1
local economies,1,0,0,0,0,0,1,2
local farms,0,1,0,0,0,0,0,1
local government,1,0,0,1,0,0,0,2
local highways,1,0,0,0,0,0,0,1
local indigenous,0,0,0,0,0,1,1,2
local land,0,0,0,0,1,0,0,1
local level,0,0,0,1,1,0,0,2
local policies,0,0,0,0,1,0,0,1
local production,1,1,0,0,0,0,0,2
local resident,0,0,0,1,0,1,0,2
local school,0,0,0,0,1,0,0,1
locher ap,0,0,1,0,1,0,0,2
log heat,0,0,0,1,0,0,0,1
logan johnson,0,1,0,0,0,0,0,1
logging responsibly,0,0,0,2,0,0,0,2
logging trails,0,0,0,2,0,0,0,2
london england,0,1,0,0,0,0,0,1
london's piccadilly,0,1,0,0,0,0,0,1
loop systems,2,0,0,0,0,0,0,2
loosely defined,0,1,0,0,0,0,0,1
lori davis,0,1,0,0,0,0,0,1
lost power,1,1,0,0,0,0,0,2
lot multiple,0,0,0,0,0,0,1,1
louisville msd,0,0,0,1,0,0,0,1
love branch,1,0,0,0,0,0,0,1
low elevation,0,0,0,0,0,1,0,1
low tech,0,0,0,0,1,1,0,2
lower climate,0,0,0,0,0,1,0,1
lower elevations,0,0,0,0,1,0,0,1
lower mississippi,0,1,0,0,0,0,0,1
lower oil,0,0,0,0,0,2,0,2
lower pollution,0,0,0,1,0,0,0,1
lowest temperature,0,0,0,0,2,0,0,2
ls power,0,0,0,0,1,0,0,1
lucy grindon,0,0,0,0,1,0,0,1
luhut pandjaitan,0,0,0,0,1,0,0,1
luis obispo,0,0,0,2,0,0,0,2
lumber business,0,0,0,2,0,0,0,2
lung association,0,1,0,1,0,0,0,2
luther king,0,1,0,1,0,0,0,2
luthier kris,0,1,0,0,0,0,0,1
lying communities,0,1,0,1,0,0,0,2
machine called,0,0,0,2,0,0,0,2
madison aument,0,0,0,0,0,1,0,1
main driver,1,0,0,0,0,1,0,2
main road,0,1,0,0,0,1,0,2
main trunk,0,0,0,0,1,0,0,1
main water,1,1,0,0,0,0,0,2
maine public,1,0,0,0,1,0,0,2
mainland spain,0,1,0,0,0,0,0,1
majid khan,0,0,0,0,1,0,0,1
major challenge,1,0,0,1,0,0,0,2
major contributor,0,1,0,0,0,0,1,2
major emissions,0,2,0,0,0,0,0,2
major flood,1,0,0,0,1,0,0,2
major floods,1,0,0,0,0,0,0,1
major focus,0,1,0,0,0,0,0,1
major global,0,1,0,0,0,0,0,1
major greenhouse,0,2,0,0,0,0,0,2
major intersection,0,1,0,0,0,0,0,1
major issue,0,0,0,1,1,0,0,2
major oil,0,0,0,2,0,0,0,2
major u.n,0,0,0,0,0,2,0,2
makeshift clinic,1,0,0,0,0,0,0,1
makeshift clinic's,1,0,0,0,0,0,0,1
malawi repair,0,0,0,0,0,1,0,1
mallika seshadri,0,2,0,0,0,0,0,2
mamadou niang's,0,1,0,0,0,0,0,1
management rules,1,0,0,0,0,0,0,1
manager george,0,2,0,0,0,0,0,2
managers claim,0,0,2,0,0,0,0,2
managing forests,0,0,0,2,0,0,0,2
mandatory evacuation,0,1,0,0,0,0,0,1
mangrove fruits,0,1,0,0,0,0,0,1
mankani checks,1,0,0,0,0,0,0,1
mankani told,1,0,0,0,0,0,0,1
manual labor,0,2,0,0,0,0,0,2
mapping team,0,0,0,1,0,0,0,1
marathwada india,0,1,0,0,0,0,0,1
marble canyon,0,0,0,0,0,1,0,1
march april,0,0,0,0,0,1,1,2
march reservoirs,0,0,0,0,0,1,0,1
marginalized communities,0,0,0,0,0,2,0,2
maria reconstruction,0,1,0,0,0,0,0,1
maria zoltac,1,0,0,0,0,0,0,1
mariah rosensweig,0,1,0,0,0,0,0,1
marine corps,0,1,0,0,0,0,0,1
marine ecologist,0,1,0,0,0,0,0,1
marine ecosystems,0,0,1,0,1,0,0,2
marine mammals,0,0,0,0,1,0,0,1
mark hoffman,1,0,0,0,0,0,0,1
market alliance,0,0,1,0,0,0,0,1
markus schreiber,0,0,1,0,1,0,0,2
martin luther,0,1,0,1,0,0,0,2
mary stampone,0,0,0,2,0,0,0,2
mass produced,0,0,0,0,1,0,0,1
massive channel,1,0,0,0,0,0,0,1
massive flooding,0,0,0,1,0,1,0,2
massive reservoirs,0,0,0,1,0,1,0,2
massive tornado,0,1,0,0,0,0,0,1
master planned,0,0,0,0,1,0,0,1
maternal mortality,1,1,0,0,0,0,0,2
mathew sets,0,0,2,0,0,0,0,2
matrix employee,0,0,1,0,0,0,0,1
matrix employees,0,0,1,0,0,0,0,1
matrix executives,0,0,1,0,0,0,0,1
matrix linked,0,0,1,0,0,0,0,1
matrix llc,0,0,1,0,0,0,0,1
matrix records,0,0,1,0,0,0,0,1
matt casale,0,0,0,0,1,0,0,1
matters related,1,1,0,0,0,0,0,2
matters worse,1,0,0,1,0,0,0,2
matthew cappucci,0,0,0,0,0,0,1,1
max boykoff,0,0,0,1,0,0,1,2
mayor mike,1,0,0,0,0,0,0,1
mccoy edited,0,0,1,1,0,0,0,2
mccurtain county,0,1,0,0,0,0,0,1
mcmurdo station,0,0,0,0,1,0,0,1
mcneil ap,0,1,0,0,1,0,0,2
mcschooler ap,0,0,0,0,0,0,1,1
means lafoe,0,0,0,2,0,0,0,2
means local,0,0,0,0,1,0,0,1
measure temperatures,0,0,0,1,0,0,0,1
measure water,1,1,0,0,0,0,0,2
measures aimed,0,0,0,0,1,0,0,1
measuring heat,0,0,0,1,0,0,0,1
measuring tape,0,1,0,0,0,0,0,1
meat grown,0,1,0,0,0,0,0,1
meat grows,0,2,0,0,0,0,0,2
meat products,0,1,0,0,0,0,0,1
meat's andrew,0,1,0,0,0,0,0,1
mechanical engineering,0,0,0,1,0,0,1,2
mechanized arm,0,0,0,2,0,0,0,2
media scholars,0,0,0,1,0,0,0,1
media's katie,0,0,0,1,0,0,1,2
melilla tells,0,1,0,0,0,0,0,1
melissa aronczyk,0,0,0,1,1,0,0,2
melt rapidly,1,1,0,0,0,0,0,2
memorial stands,0,1,0,0,0,0,0,1
mentioned earlier,0,0,0,1,1,0,0,2
mentira americana,0,0,0,1,0,0,0,1
merced california,0,0,0,1,0,0,0,1
messages seeking,0,0,0,0,1,0,0,1
messy middle,0,0,0,0,0,0,1,1
metal cables,0,0,0,1,0,0,0,1
meteorological organization,1,1,0,0,0,0,0,2
meteorology professor,0,0,0,1,0,1,0,2
methane flare,0,1,0,0,0,0,0,1
methane pollution,0,2,0,0,0,0,0,2
metric tons,0,0,1,0,0,1,0,2
metropolitan sewer,0,0,0,2,0,0,0,2
metzger edited,0,0,0,0,0,2,0,2
mexico city,0,0,0,0,0,1,0,1
michael regan,0,0,0,1,0,1,0,2
michel flickr,1,0,0,0,0,0,0,1
mid august,0,2,0,0,0,0,0,2
mid century,0,0,0,2,0,0,0,2
mid latitudes,0,0,0,0,1,1,0,2
mid october,0,2,0,0,0,0,0,2
middle interview,0,0,2,0,0,0,0,2
midterm elections,0,2,0,0,0,0,0,2
midwife checks,1,0,0,0,0,0,0,1
midwife neha,1,0,0,0,0,0,0,1
midwives who've,1,0,0,0,0,0,0,1
migrating birds,0,0,0,0,2,0,0,2
migratory birds,0,0,0,0,0,2,0,2
miguel macias,0,2,0,0,0,0,0,2
miguel marin,0,1,0,0,0,0,0,1
mike gibson,1,0,0,0,0,0,0,1
miles west,0,2,0,0,0,0,0,2
military bases,0,2,0,0,0,0,0,2
millennium caroline,0,1,0,0,0,0,0,1
million americans,1,0,0,0,1,0,0,2
million annually,0,1,0,1,0,0,0,2
million coming,0,0,2,0,0,0,0,2
million dollars,1,0,0,0,1,0,0,2
million species,0,0,2,0,0,0,0,2
million spending,0,0,0,0,1,0,0,1
million times,0,1,0,1,0,0,0,2
million tons,1,1,0,0,0,0,0,2
million u.s,1,0,0,0,0,1,0,2
million unique,0,0,1,0,0,1,0,2
millions weathering,0,0,0,0,1,0,0,1
mills pond,0,1,0,0,0,0,0,1
mills watches,0,0,0,0,1,0,0,1
milwaukee journal,1,0,0,0,0,0,0,1
mince words,0,1,0,0,0,1,0,2
mine planned,0,1,0,0,0,0,0,1
mingma thamang,0,1,0,0,0,0,0,1
mining production,0,0,0,0,1,0,0,1
minister bilawal,0,1,0,0,0,0,0,1
minister chris,0,0,0,0,1,0,0,1
minister philip,0,1,0,0,0,0,0,1
minister robert,0,0,1,1,0,0,0,2
misleading investors,0,0,0,1,0,0,0,1
miss destroyed,0,0,0,0,0,1,0,1
missed school,0,0,0,0,1,0,0,1
missed workdays,0,0,0,0,1,0,0,1
mission ore,0,0,0,0,0,1,0,1
mississippi historic,1,1,0,0,0,0,0,2
missouri sits,1,0,0,0,0,0,0,1
misty grimes,0,0,0,0,0,0,1,1
mobile phone,0,0,0,0,0,1,0,1
moderate warming,0,0,0,0,0,1,0,1
modern natural,2,0,0,0,0,0,0,2
mohemad ahmad,0,1,0,0,0,0,0,1
monday afternoon,0,0,0,1,0,0,0,1
monetary fund,1,1,0,0,0,0,0,2
montana rising,0,0,0,0,0,1,0,1
monte rio,0,0,0,1,0,0,0,1
montgomery ala,0,0,1,0,0,0,0,1
month erika,0,1,0,0,0,0,0,1
month lula,0,1,0,0,0,0,0,1
months ago,1,0,0,1,0,0,0,2
morgan's role,0,1,0,0,0,0,0,1
morning news,0,0,1,0,0,0,0,1
morning scavenging,0,0,0,0,1,0,0,1
morning temperature,0,0,0,0,1,0,0,1
moro gulf,1,0,0,0,0,0,0,1
morocco's southeastern,1,0,0,0,0,0,0,1
moscow cut,0,0,1,1,0,0,0,2
moscow kan,0,0,0,0,0,1,0,1
moss poses,0,1,0,0,0,0,0,1
mother's home,1,0,0,0,0,0,0,1
motor's canadian,0,0,0,0,0,1,0,1
mount minandar,1,0,0,0,0,0,0,1
mountain bike,0,0,0,1,0,0,0,1
mountain passes,0,0,0,0,1,1,0,2
mountain town,0,1,0,0,0,1,0,2
mountaintop removal,1,1,0,0,0,0,0,2
mounting climate,0,2,0,0,0,0,0,2
mounting pressure,1,1,0,0,0,0,0,2
move ahead,0,1,0,0,0,1,0,2
move eastward,0,0,0,0,0,1,0,1
move heat,0,0,0,0,0,1,1,2
move letzte,0,0,1,0,0,0,0,1
move residents,0,0,2,0,0,0,0,2
movement demands,0,1,0,0,0,0,0,1
moves debris,0,0,0,1,0,0,0,1
moving west,1,1,0,0,0,0,0,2
mph winds,0,1,0,0,1,0,0,2
mud caked,0,1,0,0,0,0,0,1
muddy water,1,1,0,0,0,0,0,2
mudslide set,1,0,0,0,0,0,0,1
multi hazard,0,2,0,0,0,0,0,2
multiple deaths,0,0,0,0,0,0,1,1
multiple times,0,1,1,0,0,0,0,2
multnomah county,0,0,0,0,1,0,0,1
mundo poshuracán,0,0,0,1,0,0,0,1
murray carpenter,0,0,0,0,1,0,0,1
music doug,0,1,0,0,0,0,0,1
mwenja's reserve,1,0,0,0,0,0,0,1
n.m oct,1,0,0,0,0,0,0,1
n'dar senegal,0,1,0,0,0,0,0,1
nadia lopez,0,0,0,1,0,0,0,1
nairobi kenya,1,1,0,0,0,0,0,2
nairobi offload,1,0,0,0,0,0,0,1
named ruksana,1,0,0,0,0,0,0,1
narayan shewal,0,1,0,0,0,0,0,1
nasa database,0,0,0,1,0,0,0,1
nasal structure,0,0,0,0,0,1,0,1
nation's largest,0,2,0,0,0,0,0,2
national borders,1,1,0,0,0,0,0,2
national budgets,0,2,0,0,0,0,0,2
national day,0,0,0,0,0,1,0,1
national forest,0,0,0,0,0,1,0,1
national government,0,2,0,0,0,0,0,2
national recreation,0,0,0,1,0,0,0,1
national security,0,0,0,0,0,2,0,2
national severe,0,0,0,0,0,1,0,1
nations adapt,0,1,0,0,0,0,0,1
nations initiative,0,1,0,0,0,0,0,1
nations report,0,1,0,0,0,1,0,2
nations world,0,0,1,0,0,1,0,2
nationwide effort,0,0,0,0,0,1,0,1
nationwide.for npr,0,0,2,0,0,0,0,2
native plants,0,2,0,0,0,0,0,2
native species,0,0,1,0,1,0,0,2
natural ecosystems,0,0,1,0,0,0,0,1
natural pond,0,0,0,0,0,1,0,1
natural subsidence,0,1,0,0,0,0,0,1
natural temporary,0,0,0,1,0,0,0,1
nature climate,0,0,1,0,1,0,0,2
nature loss,0,0,1,0,0,0,0,1
navajo bridge,0,0,0,0,0,1,0,1
ndar fishing,1,0,0,0,0,0,0,1
nearby homes,0,0,0,0,0,1,0,1
nearby troublesome,0,1,0,0,0,0,0,1
nearest paved,0,0,0,0,0,1,0,1
nearest road,0,1,0,0,0,1,0,2
neighborhood children,0,1,0,0,0,0,0,1
neighborhood lajas,0,1,0,0,0,0,0,1
neighborhood slack,0,0,0,1,0,0,0,1
neighboring countries,0,1,0,0,0,1,0,2
network international,0,1,0,1,0,0,0,2
neutral economy,0,0,1,1,0,0,0,2
newborn baby,1,0,0,0,0,0,0,1
newly created,1,0,0,0,0,0,0,1
newly formed,1,1,0,0,0,0,0,2
newly planted,0,1,0,0,0,0,0,1
newly restored,0,1,0,0,0,0,0,1
news article,0,0,0,0,1,0,0,1
news headlines,0,0,0,1,0,0,1,2
news host,0,0,0,1,0,1,0,2
news media,1,0,1,0,0,0,0,2
news roundup,0,0,0,0,0,2,0,2
news stories,0,0,1,0,0,1,0,2
niágara en,0,0,0,1,0,0,0,1
niang's father,0,1,0,0,0,0,0,1
nicholson npr,0,0,1,1,0,0,0,2
nicholson reports,0,0,0,2,0,0,0,2
nick pasculli,0,0,0,0,0,1,0,1
nicole hit,0,1,0,0,0,0,0,1
nicole wednesday,0,1,0,0,0,0,0,1
niederaussem germany,0,1,0,0,0,0,0,1
niger algeria,0,1,0,0,0,0,0,1
night's tornado,0,0,0,0,0,1,0,1
ninth ward,1,1,0,0,0,0,0,2
nitrogen oxides,0,0,0,0,1,0,0,1
noaa officials,0,0,0,2,0,0,0,2
noaa's national,0,1,0,0,0,1,0,2
nobel peace,0,0,0,0,2,0,0,2
nokia brick,0,0,0,0,0,1,0,1
nonprofit institute,0,0,0,1,0,1,0,2
nordenskiold glacier,1,0,0,0,0,0,0,1
normal snowpack,0,0,0,1,1,0,0,2
normangeline vázquez,0,1,0,0,0,0,0,1
north country,0,0,0,0,2,0,0,2
north pole,0,0,0,0,2,0,0,2
north rhine,0,0,0,0,1,0,0,1
north south,0,1,0,0,1,0,0,2
northeastern texas,0,1,0,0,0,0,0,1
northeastern thailand,0,1,0,0,0,0,0,1
northeastern u.s,0,0,0,0,2,0,0,2
northeastern vermont,0,0,0,2,0,0,0,2
northern arizona,0,1,0,0,0,1,0,2
northern brazil,0,0,0,0,0,0,1,1
northern norwegian,1,0,0,0,0,0,0,1
northern plains,0,0,0,0,0,1,0,1
northern vermont,0,0,0,2,0,0,0,2
northwest missouri,1,0,0,0,0,0,0,1
northwest national,1,0,0,0,1,0,0,2
northwestern bahamas,0,1,0,0,0,0,0,1
norwegian archipelago,1,0,0,0,0,0,0,1
notepad marine,0,1,0,0,0,0,0,1
november haaland,0,0,0,0,0,1,0,1
npr justice,0,0,0,1,0,0,0,1
npr's joel,0,1,0,0,0,0,0,1
npr's lauren,0,1,0,1,0,0,0,2
npr's request,1,0,0,0,1,0,0,2
npr's rob,0,0,0,0,0,1,0,1
npr's ruth,0,1,0,0,0,0,0,1
npr's sacha,0,0,0,0,1,0,0,1
npr's scott,0,0,0,0,0,1,0,1
nurse katie,0,0,0,1,0,0,0,1
nutritional supplements,1,0,0,0,0,0,0,1
nws office,0,0,0,0,2,0,0,2
nws warned,0,0,0,1,1,0,0,2
nws weather,0,0,0,1,1,0,0,2
ny jan,0,0,0,0,1,0,0,1
o'clock ok.and,0,0,2,0,0,0,0,2
oakland shipping,0,0,0,0,0,1,0,1
oasis town,1,0,0,0,0,0,0,1
obama era,0,0,0,0,0,1,0,1
observational record,0,0,0,0,0,1,0,1
obtain additional,0,2,0,0,0,0,0,2
occurred earlier,1,0,0,0,0,0,0,1
ocean warming,1,1,0,0,0,0,0,2
oceans warm,0,1,0,0,0,0,0,1
october spoke,0,1,0,0,0,0,0,1
offensive weapons,0,0,0,1,0,0,0,1
office buildings,1,0,0,0,1,0,0,2
office wrote,0,0,0,0,1,1,0,2
officers carry,0,0,0,0,1,0,0,1
officers guard,0,0,1,0,0,0,0,1
officers move,0,0,1,0,0,0,0,1
official coal,0,0,0,0,1,0,0,1
official rainfall,0,0,0,2,0,0,0,2
official set,0,0,0,1,0,0,0,1
officials dismantled,0,1,0,0,0,0,0,1
officials estimate,1,1,0,0,0,0,0,2
officials worried,0,0,0,0,1,1,0,2
offload livestock,1,0,0,0,0,0,0,1
ohio river,0,0,0,1,0,0,0,1
oil executive,0,0,0,1,0,1,0,2
oil field,0,1,0,0,0,1,0,2
oil infrastructure,0,0,0,0,0,1,0,1
oil palms,0,0,0,0,0,0,1,1
oil protesters,0,1,0,0,0,0,0,1
oil pumpjack,1,0,0,0,0,0,0,1
oil refineries,0,1,0,0,1,0,0,2
oil refinery,0,0,0,0,2,0,0,2
oil trees,0,0,0,0,0,0,1,1
olaf scholz,0,1,0,1,0,0,0,2
ollon switzerland,0,0,0,1,0,0,0,1
ongoing climate,0,0,0,1,1,0,0,2
opencast lignite,0,0,0,0,1,0,0,1
opinion piece,0,0,0,0,0,2,0,2
oregon governor's,1,0,0,0,0,0,0,1
oregon tree,0,0,1,0,0,0,0,1
oregon's forests,0,0,1,0,0,0,0,1
oregon's woodlands,0,0,1,0,0,0,0,1
organic matter,1,1,0,0,0,0,0,2
organisms living,0,1,0,0,0,0,0,1
organization hourly,0,0,0,0,1,0,0,1
ousmane diop,0,1,0,0,0,0,0,1
outdated rainfall,0,0,0,1,0,0,0,1
outdoor air,0,0,0,0,0,0,1,1
outdoor environment,0,0,0,1,0,0,0,1
outdoor watering,0,0,0,0,1,1,0,2
outgoing president,0,1,0,0,0,0,0,1
outsized impact,0,1,0,0,0,1,0,2
overdue measures,0,0,1,1,0,0,0,2
overflowing rivers,0,0,0,2,0,0,0,2
overwhelmingly positive,0,0,1,0,0,0,0,1
overwhelmingly responsible,0,1,0,0,0,0,0,1
owens river,0,0,0,0,2,0,0,2
owned oil,0,0,0,2,0,0,0,2
owner colleen,0,0,0,2,0,0,0,2
oyster reefs,1,0,0,0,0,0,1,2
oysters grow,0,0,0,0,0,0,1,1
oza checked,0,0,0,0,0,2,0,2
pacificas approaches,0,0,0,0,0,1,0,1
package geared,0,0,0,0,1,0,0,1
paddy hirsch,0,0,0,1,0,0,0,1
page ariz,0,1,0,0,0,0,0,1
pahari jharia,0,0,0,0,1,0,0,1
paint stripes,0,0,0,2,0,0,0,2
pajaro calif,0,0,0,0,0,1,0,1
pajaro river,0,0,0,0,0,1,1,2
pakistan's foreign,0,1,0,0,0,0,0,1
pakistan's unprecedented,1,0,0,0,0,0,0,1
pakistani fishing,1,0,0,0,0,0,0,1
palm field,1,0,0,0,0,0,0,1
palm trees,1,0,0,1,0,0,0,2
pandemic border,0,1,0,0,0,0,0,1
panels belong,0,0,0,0,1,0,0,1
paris based,0,1,0,0,1,0,0,2
park system,1,0,1,0,0,0,0,2
parking garage,0,1,0,0,1,0,0,2
parking lots,1,0,0,1,0,0,0,2
parrotfish scrapes,0,1,0,0,0,0,0,1
partial solution,0,0,0,1,1,0,0,2
participants walk,0,0,0,0,0,1,0,1
particulate emissions,0,0,0,0,1,0,0,1
partisan influencers,0,0,0,1,0,0,0,1
party policies,0,0,1,1,0,0,0,2
paso texas,1,1,0,0,0,0,0,2
passenger cars,0,0,0,0,0,2,0,2
passenger ferry,0,0,0,0,1,0,0,1
passengers traverses,1,0,0,0,0,0,0,1
passes spring,0,0,0,0,1,0,0,1
patricia romero,0,0,0,0,0,2,0,2
patrick searches,0,1,0,0,0,0,0,1
patsy costello,0,0,0,1,0,0,0,1
pattie gonia's,1,0,0,0,0,0,0,1
patty loveless,0,1,0,0,0,0,0,1
paul williams,0,0,0,0,1,0,0,1
paula moura,0,0,0,0,0,1,0,1
paved road,0,0,0,0,0,1,0,1
pawleys island,1,0,0,0,0,0,0,1
pay rent,1,0,0,0,1,0,0,2
peace prize,0,0,0,0,2,0,0,2
pedestrian crossing,0,0,1,1,0,0,0,2
pelona mountains,0,0,0,0,1,0,0,1
penguins found,1,0,0,0,0,0,0,1
pennsylvania based,0,0,0,0,2,0,0,2
pension funds,0,1,1,0,0,0,0,2
people attend,0,0,0,0,1,0,0,1
people brave,0,1,0,0,0,0,0,1
people dead,1,0,0,0,1,0,0,2
people dislike,0,0,0,0,0,1,1,2
people experience,0,0,0,0,1,1,0,2
people experiencing,0,0,0,0,2,0,0,2
people feel,1,0,0,1,0,0,0,2
people including,1,0,0,0,0,0,1,2
people stay,0,0,0,0,1,0,0,1
people understand,0,1,0,0,1,0,0,2
people wade,0,1,0,0,0,0,0,1
people wait,0,0,0,0,1,0,0,1
people waiting,0,0,0,1,0,0,0,1
people worldwide,0,1,0,0,0,1,0,2
people yeah,0,0,2,0,0,0,0,2
percentage medium,0,0,1,0,0,0,0,1
permafrost thaws,0,1,0,0,0,0,0,1
permafrost underneath,0,0,2,0,0,0,0,2
permanent solution,0,1,0,0,1,0,0,2
person died,0,1,0,0,1,0,0,2
person drives,0,0,0,0,1,0,0,1
petroleum exhibition,0,0,0,1,0,0,0,1
petteri taalas,1,1,0,0,0,0,0,2
phd center,1,0,0,0,0,0,0,1
philadelphia buildings,1,0,0,0,0,0,0,1
philadelphia kitchen,0,0,0,0,1,0,0,1
philadelphia reports,2,0,0,0,0,0,0,2
philippine village,1,0,0,0,0,0,0,1
phoenix las,0,0,0,1,0,0,0,1
phonic lips,0,0,0,0,0,1,0,1
photo electricity,0,0,0,1,0,0,0,1
photo gene,0,0,0,1,0,0,0,1
piccadilly circus,0,1,0,0,0,0,0,1
piece dawn,0,0,0,1,0,0,0,1
piedmont lithium's,0,1,0,0,0,0,0,1
piedmont's plans,0,1,0,0,0,0,0,1
pigs connects,0,1,0,0,0,0,0,1
pile burning,0,0,0,0,0,1,0,1
piled snow,0,0,0,0,1,0,0,1
pine beetle,0,0,0,0,0,1,0,1
pine island,2,0,0,0,0,0,0,2
pine trees,0,0,0,0,0,1,0,1
pink rock,0,1,0,0,0,0,0,1
pipeline system,0,0,0,0,0,1,0,1
pituffik greenland,1,0,0,0,0,0,0,1
planet's future,0,0,1,0,0,1,0,2
planned community,0,0,0,0,1,0,0,1
planning manager,0,0,0,2,0,0,0,2
plant illustrates,2,0,0,0,0,0,0,2
plant matter,0,0,0,0,0,1,0,1
plant oil,0,0,0,0,0,0,1,1
plant originally,1,0,0,0,0,0,0,1
plant seeds,0,1,0,0,0,1,0,2
plant switched,2,0,0,0,0,0,0,2
plant trees,0,0,0,1,1,0,0,2
planted mangroves,0,1,0,0,0,0,0,1
planting single,0,1,0,0,0,0,0,1
plastic covers,0,0,1,0,0,0,0,1
plastic packaging,0,1,0,1,0,0,0,2
plastic production,1,0,1,0,0,0,0,2
plastic products,0,0,0,1,0,0,0,1
plastic sits,1,0,0,0,0,0,0,1
playground mohamed,0,0,0,1,0,0,0,1
playground science,0,0,0,1,0,0,0,1
playing catch,0,1,0,1,0,0,0,2
playing field,0,0,0,0,0,1,1,2
plays scientist,0,0,0,0,0,0,1,1
pleasant hill,0,0,0,1,0,0,0,1
plenary hall,0,1,0,0,0,0,0,1
plow clears,0,0,0,1,0,0,0,1
plumas county,0,0,0,1,0,0,0,1
plummer pictured,0,1,0,0,0,0,0,1
polar vortex,0,0,0,0,2,0,0,2
police unstick,0,0,1,0,0,0,0,1
policies increases,0,0,0,1,0,0,0,1
policy goals,0,2,0,0,0,0,0,2
policy initiative,0,2,0,0,0,0,0,2
policy institute,0,0,1,0,0,1,0,2
policy makers,0,0,0,1,1,0,0,2
policy passed,0,1,0,0,0,0,0,1
political attacks,0,0,2,0,0,0,0,2
political majority,0,1,0,0,0,0,0,1
political parties,0,2,0,0,0,0,0,2
political party,1,1,0,0,0,0,0,2
political prisoners,0,1,0,0,0,0,0,1
political reporter's,0,0,1,0,0,0,0,1
poll conducted,0,0,1,1,0,0,0,2
pollution permits,0,0,0,0,1,0,0,1
pollution scenario,0,0,0,1,0,0,0,1
pond marks,1,0,0,0,0,0,0,1
pond park,0,1,0,0,0,0,0,1
poor air,0,0,0,0,1,0,1,2
poor children,0,0,0,0,1,0,0,1
population fund,1,1,0,0,0,0,0,2
populous country,0,1,0,0,0,0,0,1
portland maine,0,0,0,0,1,0,0,1
portland ore,0,0,0,0,1,0,0,1
portland public,0,1,0,0,0,0,0,1
porto jofre,0,0,0,0,0,0,1,1
poshuracán puerto,0,0,0,1,0,0,0,1
positive coverage,0,0,1,0,0,0,0,1
positive effect,0,0,0,2,0,0,0,2
possibly irreversible,0,0,2,0,0,0,0,2
post hurricane,0,0,0,1,0,0,0,1
post maria,0,1,0,0,0,0,0,1
post pattie,1,0,0,0,0,0,0,1
postdoctoral researcher,1,0,0,0,0,1,0,2
potential energy,0,1,0,0,0,0,0,1
potential health,0,0,0,1,1,0,0,2
potential impact,1,0,0,1,0,0,0,2
potential loophole,0,0,0,0,1,0,0,1
pounds southern,0,0,0,0,1,0,0,1
power begins,0,0,1,0,0,0,0,1
power close,0,0,2,0,0,0,0,2
power infrastructure,0,0,0,2,0,0,0,2
power line,0,0,0,0,2,0,0,2
power players,0,0,0,0,1,1,0,2
power restored,0,0,1,0,0,0,0,1
power sectors,0,2,0,0,0,0,0,2
power substation,0,0,1,0,0,0,0,1
powered vehicles,0,0,0,1,0,1,0,2
powerful atmospheric,0,0,0,1,0,0,0,1
powerful storms,2,0,0,0,0,0,0,2
practice baseball,0,1,0,0,0,0,0,1
prakrit jain,1,0,0,0,0,0,0,1
pre market,0,1,0,0,0,0,0,1
precarious angle,0,0,2,0,0,0,0,2
precious resource,0,0,0,2,0,0,0,2
precipitation falling,0,0,0,2,0,0,0,2
precipitation recycling,0,0,0,0,0,0,1,1
predict sea,1,0,0,0,0,0,0,1
predominantly black,1,0,0,0,0,1,0,2
preliminary analysis,0,1,0,0,0,0,0,1
prescribed pile,0,0,0,0,0,1,0,1
president barack,0,1,0,0,0,0,0,1
president emmanuel,0,1,0,1,0,0,0,2
president george,0,0,0,0,1,0,0,1
president jair,0,1,0,0,0,0,1,2
president president,1,0,0,0,1,0,0,2
president's climate,0,1,0,0,0,1,0,2
president's pledge,0,1,0,0,0,0,0,1
presidential campaign,1,0,0,0,1,0,0,2
press secretary,0,1,0,0,0,1,0,2
pressing concern,0,0,0,0,2,0,0,2
pretty easy,0,0,0,0,0,1,1,2
pretty extraordinary,1,0,0,0,0,0,0,1
prevent outbreaks,0,0,0,0,0,1,0,1
previous studies,0,1,1,0,0,0,0,2
previously threatened,0,0,0,0,0,1,0,1
price spikes,0,0,0,0,1,0,0,1
primary goal,0,2,0,0,0,0,0,2
pristine islands,0,0,1,0,0,0,0,1
prius hybrids,0,0,0,0,1,0,0,1
private collection,0,0,0,1,0,0,0,1
private industry,0,1,0,0,0,0,0,1
private sources,0,2,0,0,0,0,0,2
privately owned,1,0,1,0,0,0,0,2
prize money,0,1,0,0,0,0,0,1
produce methane,0,2,0,0,0,0,0,2
produced gasoline,0,0,0,0,1,0,0,1
producer margaret,1,0,0,0,0,0,0,1
producing meat,0,1,0,0,0,0,0,1
productive days,0,0,0,2,0,0,0,2
products industry,0,0,0,2,0,0,0,2
professional greek,0,1,0,0,0,0,0,1
profits money,0,0,2,0,0,0,0,2
profound impact,1,0,0,0,1,0,0,2
programs offered,0,0,0,0,1,0,0,1
project manuel,0,0,0,0,0,2,0,2
prolonged drought,0,0,0,1,0,1,0,2
promoting candidates,0,1,0,0,0,0,0,1
promoting clean,0,2,0,0,0,0,0,2
prone northern,0,0,0,0,0,1,0,1
propaganda private,0,0,0,1,0,0,0,1
propane tanks,0,0,0,0,1,0,0,1
property friday,0,0,0,0,1,0,0,1
property values,0,0,0,0,2,0,0,2
proposal poses,0,0,0,0,0,2,0,2
proposed mine,0,1,0,0,0,0,0,1
proposed rule,0,1,0,0,0,0,0,1
proposed social,0,0,0,0,1,0,0,1
protect human,0,0,0,0,1,1,0,2
protect people,0,0,0,0,1,1,0,2
protected leuser,0,0,0,0,0,0,1,1
protecting indigenous,0,0,0,0,0,0,1,1
protection agency's,0,0,1,0,0,0,1,2
protection minister,0,0,1,1,0,0,0,2
protection program,0,0,0,0,0,2,0,2
protest delayed,0,0,1,1,0,0,0,2
protest site,0,1,0,0,0,0,0,1
protesters block,0,1,0,0,0,0,0,1
protesters disrupting,0,0,1,1,0,0,0,2
province indonesia,0,0,0,0,0,0,1,1
public art,0,1,0,0,0,0,0,1
public awareness,0,0,0,0,0,0,2,2
public broadcaster,0,0,1,0,0,0,0,1
public comments,0,0,0,1,1,0,0,2
public demonstrations,0,1,0,0,0,0,0,1
public input,0,0,0,1,0,0,0,1
public investment,1,1,0,0,0,0,0,2
public lands,0,0,0,0,0,2,0,2
public money,0,2,0,0,0,0,0,2
public private,0,0,1,1,0,0,0,2
public records,0,0,2,0,0,0,0,2
public transport,1,1,0,0,0,0,0,2
public transportation,1,0,0,1,0,0,0,2
publicly promoting,0,0,1,0,0,0,0,1
pump displays,1,0,0,0,0,0,0,1
pump installer,0,0,0,0,0,1,1,2
pump nadel,0,0,0,0,0,0,1,1
pump stations,0,1,0,0,0,0,0,1
pumping oil,0,0,0,1,1,0,0,2
purchase heavy,0,0,2,0,0,0,0,2
purdue university,0,0,0,0,0,1,1,2
pushing salt,0,1,0,0,0,0,0,1
quality issues,0,0,0,0,1,0,0,1
queen elizabeth,0,0,0,0,0,1,0,1
questions facing,0,2,0,0,0,0,0,2
questions investors,0,0,2,0,0,0,0,2
questions remain,0,0,1,0,0,0,0,1
rachel cohen,0,0,0,0,1,0,0,1
radhika celebrates,0,0,0,0,1,0,0,1
radio station,0,1,0,1,0,0,0,2
radio's kyle,0,0,0,1,0,0,0,1
rain caused,0,1,0,0,0,0,0,1
rain events,0,0,0,1,1,0,0,2
rain falls,0,0,0,2,0,0,0,2
rain friday,0,0,0,0,1,0,0,1
rain moved,0,0,0,1,0,0,0,1
rain swollen,0,0,0,0,1,0,0,1
rainfall totals,0,0,0,1,1,0,0,2
raise awareness,0,0,0,2,0,0,0,2
raised concerns,1,1,0,0,0,0,0,2
raised upwards,0,1,0,0,0,0,0,1
rallying cry,0,1,0,0,0,1,0,2
ralston told,0,0,0,0,1,0,0,1
ralston's organization,0,0,0,0,1,0,0,1
ramirez anil,0,0,0,0,0,2,0,2
rand corporation,2,0,0,0,0,0,0,2
range burner,0,0,0,0,1,0,0,1
rangers cut,0,0,0,0,0,0,1,1
rapid population,0,0,0,0,2,0,0,2
rapidly changing,0,0,0,0,1,0,0,1
rate hearing,0,0,1,0,0,0,0,1
rate hikes,0,1,0,0,0,1,0,2
ravaged wooden,0,0,0,1,0,0,0,1
reach net,1,1,0,0,0,0,0,2
reached minus,0,0,0,0,1,0,0,1
reaching lower,0,0,0,0,1,0,0,1
reads thankful,0,1,0,0,0,0,0,1
reads water,0,0,0,0,0,1,0,1
real financial,0,0,2,0,0,0,0,2
real threat,0,0,0,0,1,1,0,2
real world,0,0,2,0,0,0,0,2
rebecca martell,0,0,0,0,1,0,0,1
rebecca rosman,0,0,0,0,1,0,0,1
rebuilt home,0,1,0,0,0,0,0,1
receding south,0,0,0,0,1,0,0,1
receive drinking,0,0,0,0,0,1,0,1
received funding,0,0,2,0,0,0,0,2
received money,1,0,0,0,1,0,0,2
received roughly,0,0,0,0,1,0,1,2
recent article,0,0,0,1,0,0,0,1
recent chilly,0,0,0,0,1,0,0,1
recent decades,2,0,0,0,0,0,0,2
recent evening,0,1,0,0,0,0,0,1
recent months,1,0,1,0,0,0,0,2
recent poll,0,0,1,1,0,0,0,2
recent rain,0,0,0,1,0,0,0,1
recent repairs,0,1,0,0,0,0,0,1
recent research,0,2,0,0,0,0,0,2
recent spate,0,0,0,0,1,0,0,1
recent weather,0,0,0,1,1,0,0,2
recently cooked,0,1,0,0,0,0,0,1
recently flooded,0,0,0,0,1,0,0,1
recently graduated,0,1,0,0,0,0,0,1
recently richard,0,0,0,1,0,0,0,1
record breaking,0,0,0,0,2,0,0,2
record flooding,1,0,0,1,0,0,0,2
record heat,0,0,0,1,0,0,0,1
record low,0,0,0,0,2,0,0,2
record lows,0,1,0,0,1,0,0,2
recorded history,1,0,0,1,0,0,0,2
recovery efforts,0,1,0,1,0,0,0,2
recreational facilities,0,1,0,0,0,0,0,1
recycling program,1,0,0,1,0,0,0,2
recycling rate,1,0,0,0,0,0,0,1
red sea,0,2,0,0,0,0,0,2
red skies,0,0,1,0,0,0,0,1
red water,1,0,0,0,0,0,0,1
reduce methane,0,1,0,0,0,0,0,1
reducing pollution,0,1,0,1,0,0,0,2
reef fish,0,1,0,0,0,0,0,1
reef systems,0,1,0,0,0,0,0,1
reforestation project,0,1,0,0,0,0,0,1
regenerative practices,0,1,0,0,0,0,0,1
region.martí karnauskas,0,0,1,0,0,0,0,1
region's cultural,0,1,0,0,0,0,0,1
regional utilities,0,0,1,0,0,0,0,1
registered agent,0,0,0,0,1,0,0,1
regulatory approval,0,2,0,0,0,0,0,2
regulatory hurdle,0,2,0,0,0,0,0,2
related deaths,0,0,1,0,1,0,0,2
related hazards,0,2,0,0,0,0,0,2
related relocation,0,0,2,0,0,0,0,2
relative impact,0,1,0,1,0,0,0,2
release water,0,0,0,1,0,1,0,2
released data,0,0,2,0,0,0,0,2
released wednesday,0,0,0,0,0,1,0,1
reliable source,0,2,0,0,0,0,0,2
relief efforts,0,1,0,0,0,0,0,1
relief operations,0,1,0,0,0,0,0,1
religious leader,1,1,0,0,0,0,0,2
religious leaders,0,1,0,0,0,0,0,1
relocation camps,1,0,0,0,0,0,0,1
relocation nationwide.for,0,0,2,0,0,0,0,2
remains intact,0,0,0,0,0,1,0,1
remains unclear,0,2,0,0,0,0,0,2
renewable diesel,0,0,0,0,1,0,0,1
rental apartments,0,0,0,0,1,0,0,1
repaired allowing,0,1,0,0,0,0,0,1
replace russian,0,0,1,1,0,0,0,2
replacing russian,0,0,1,1,0,0,0,2
report notes,0,0,1,0,0,1,0,2
report published,1,1,0,0,0,0,0,2
reporter's editor,0,0,1,0,0,0,0,1
reporting trip,1,1,0,0,0,0,0,2
represented africa,0,1,0,0,0,0,0,1
republican candidate,1,0,0,0,0,0,0,1
republican sen,0,0,0,0,0,2,0,2
require bold,0,0,2,0,0,0,0,2
rescue people,2,0,0,0,0,0,0,2
rescue plan,0,0,0,1,1,0,0,2
rescuers carry,1,0,0,0,0,0,0,1
rescuers stand,0,1,0,0,0,0,0,1
research center,0,0,0,1,1,0,0,2
research director,0,0,0,0,1,1,0,2
research institute,0,0,1,0,0,1,0,2
research oceanographer,1,0,0,0,0,1,0,2
research site,0,1,0,0,0,0,0,1
researching gas,0,0,0,1,1,0,0,2
reservation divide,0,0,0,0,0,1,0,1
reservation montana,0,0,0,0,0,1,0,1
reservations including,0,0,0,0,0,1,0,1
reserve water,1,0,0,0,0,0,0,1
reservoir imperiling,0,0,0,1,0,0,0,1
reservoirs lake,0,0,0,1,0,1,0,2
reservoirs levels,0,0,0,0,0,1,0,1
residential roads,0,0,0,1,0,0,0,1
residential rooftops,0,0,0,0,1,0,0,1
residents seal,0,0,0,0,0,1,0,1
residents walk,1,0,0,0,0,0,0,1
resilience chefornak,0,0,2,0,0,0,0,2
resilience plans,0,2,0,0,0,0,0,2
response mode,0,1,0,1,0,0,0,2
response system,1,1,0,0,0,0,0,2
responsibility alongside,0,0,2,0,0,0,0,2
responsibly managing,0,0,0,2,0,0,0,2
restricting renewable,0,0,0,0,1,0,0,1
return scheme,0,0,0,1,0,0,0,1
reviewed paper,0,0,0,1,1,0,0,2
revised plan,0,0,0,0,0,1,0,1
rhine westphalia,0,0,0,0,1,0,0,1
rhode island,0,0,0,0,2,0,0,2
rican art,0,0,0,1,0,0,0,1
rich nations,0,1,0,0,0,0,0,1
rich source,0,0,0,0,0,1,0,1
richard connor,0,0,0,0,0,2,0,2
rick scott,1,0,1,0,0,0,0,2
ricki mills,0,0,0,0,1,0,0,1
ricky skaggs,0,1,0,0,0,0,0,1
rico rebuild,1,0,0,0,0,0,0,1
right.in participating,0,2,0,0,0,0,0,2
rights movement,0,0,0,2,0,0,0,2
rights watch,0,2,0,0,0,0,0,2
rising cost,1,0,0,0,0,0,0,1
rising faster,1,1,0,0,0,0,0,2
rising flood,0,1,0,1,0,0,0,2
rising floodwaters,0,0,0,0,0,1,0,1
rising water,1,1,0,0,0,0,0,2
risk monitor,0,2,0,0,0,0,0,2
risks people,0,1,0,0,1,0,0,2
river events,0,0,0,1,0,0,0,1
river fire,1,0,0,0,0,0,0,1
river overflowed,0,0,0,1,0,0,0,1
river quil,1,0,0,0,0,0,0,1
river storms,0,0,0,1,0,0,0,1
river yeah,0,0,2,0,0,0,0,2
riverbanks erode,0,0,2,0,0,0,0,2
road police,0,0,1,0,0,0,0,1
rob schmitz,0,0,0,0,0,1,0,1
robert green,1,1,0,0,0,0,0,2
robert habeck,0,0,1,1,0,0,0,2
robert hur,0,0,0,1,0,0,0,1
robert rodriguez,0,0,1,0,0,1,0,2
rocketing energy,0,0,1,1,0,0,0,2
rocks jan,0,0,0,1,0,0,0,1
rocky mountains,0,0,0,1,1,0,0,2
rodríguez brothers,0,1,0,0,0,0,0,1
rodríguez run,0,1,0,0,0,0,0,1
role shifted,0,1,0,0,0,0,0,1
rott npr,0,0,0,1,0,1,0,2
roundup email,0,0,0,0,0,2,0,2
rowan county,0,0,0,0,1,0,0,1
ruksana explains,1,0,0,0,0,0,0,1
ruksana holds,1,0,0,0,0,0,0,1
run abu,0,0,0,1,0,0,0,1
running effort,0,0,2,0,0,0,0,2
running low,0,0,0,2,0,0,0,2
running water,0,0,0,0,0,2,0,2
rural town,0,2,0,0,0,0,0,2
rush hour,0,0,1,1,0,0,0,2
rushes downstream,0,0,0,0,0,1,0,1
russian gas,0,0,1,1,0,0,0,2
russian natural,0,0,1,1,0,0,0,2
rust infections,0,0,0,0,0,1,0,1
rutgers university,0,0,0,1,1,0,0,2
ruth sherlock,0,1,0,0,0,0,0,1
rutted logging,0,0,0,2,0,0,0,2
rv park,1,0,0,0,1,0,0,2
sacha pfeiffer,0,0,0,0,1,0,0,1
sacred spaces,0,0,0,1,0,0,0,1
safe drinking,0,0,0,0,0,2,0,2
safer future,1,0,1,0,0,0,0,2
safer ground,0,0,2,0,0,0,0,2
safer homes,0,0,2,0,0,0,0,2
safety nod,0,2,0,0,0,0,0,2
safoora holds,1,0,0,0,0,0,0,1
sahana pahari,0,0,0,0,1,0,0,1
sahara desert,0,0,1,0,0,1,0,2
saharan africa,0,2,0,0,0,0,0,2
salinas calif,0,0,0,1,0,0,0,1
salinas valley,0,0,0,0,0,1,0,1
saline lake,0,0,0,0,2,0,0,2
salton sea,1,0,0,0,0,0,0,1
salvatore laporta,0,1,0,0,0,0,0,1
sam brasch,0,1,0,0,0,0,0,1
sam mcneil,0,1,0,0,1,0,0,2
san ardo,0,0,0,0,0,1,0,1
san carlos,1,0,0,0,0,0,0,1
san juan,0,0,0,1,0,0,0,1
san luis,0,0,0,2,0,0,0,2
san mateo,0,0,0,0,1,0,0,1
san ysidro,0,0,0,1,0,0,0,1
sandy hit,2,0,0,0,0,0,0,2
sanibel island,1,0,0,0,0,0,0,1
sarah kate,0,1,0,0,0,0,0,1
sargasso sea,0,0,0,0,0,1,0,1
saric wrote,0,0,0,0,1,0,0,1
satellite data,0,0,1,0,0,0,1,2
satellite images,0,0,0,1,1,0,0,2
satirical instagram,1,0,0,0,0,0,0,1
saturday ahlefeld's,0,0,0,0,0,0,1,1
saturday feb,0,0,0,0,1,0,0,1
saturday storms,0,0,0,0,0,0,1,1
saves water,0,0,0,0,0,2,0,2
saving lives,0,0,0,0,1,1,0,2
sawed credit,0,0,0,0,0,1,0,1
sawmill operators,0,0,0,2,0,0,0,2
sawmill workers,0,0,0,2,0,0,0,2
sawmill's store,0,0,0,2,0,0,0,2
sayed khalifa,0,1,0,0,0,0,0,1
scale farmers,0,0,0,0,0,0,1,1
scaling fish,0,0,0,0,0,1,0,1
scan forests,0,0,1,0,0,0,0,1
schnarr insists,0,0,1,1,0,0,0,2
school building,0,0,0,1,0,0,0,1
school buses,0,2,0,0,0,0,0,2
school days,0,0,0,0,1,0,0,1
school education,0,0,1,0,0,1,0,2
school initiative,0,0,0,0,1,0,0,1
school yard,0,0,0,1,0,0,0,1
schreiber ap,0,0,1,0,1,0,0,2
schuylkill river,2,0,0,0,0,0,0,2
sci fi,0,2,0,0,0,0,0,2
science headlines,0,0,0,0,0,2,0,2
science news,0,0,0,0,1,0,0,1
science students,0,0,0,1,0,0,0,1
scientific skills,0,0,0,1,0,0,0,1
scientist rebecca,0,0,0,0,0,0,1,1
scientists hope,0,1,0,0,0,1,0,2
scientists predict,0,1,0,0,1,0,0,2
scientists warning,0,0,0,0,0,1,0,1
scifi foods,0,1,0,0,0,0,0,1
scott burns,0,0,0,0,0,0,1,1
scott horsley,0,0,0,0,0,1,0,1
screen windows,1,0,0,0,0,0,0,1
sea planning,0,0,0,0,0,1,0,1
sea rise,0,0,0,0,1,0,0,1
sea smoke,0,0,0,0,1,0,0,1
sea turtle,0,1,0,0,0,0,0,1
sea water,0,1,0,1,0,0,0,2
seas threaten,0,0,0,0,1,0,0,1
season typically,0,1,0,0,0,1,0,2
seasonal water,0,0,0,0,0,2,0,2
secretary karine,0,1,0,0,0,1,0,2
sector makes,0,0,1,0,0,0,0,1
security including,0,2,0,0,0,0,0,2
selma ala,0,0,0,1,0,0,0,1
sen lisa,0,0,0,0,0,2,0,2
sen rick,1,0,1,0,0,0,0,2
send data,0,0,0,0,0,1,0,1
sends data,0,0,0,0,0,1,0,1
senegal prompting,0,0,0,0,1,0,0,1
senegalese people,0,1,0,0,0,0,0,1
senio argues,0,0,0,2,0,0,0,2
senior fellow,0,0,0,0,0,1,1,2
sensitive wooded,0,0,0,2,0,0,0,2
sentinel hide,1,0,0,0,0,0,0,1
september wetter,0,0,1,0,0,0,0,1
september's hurricane,0,1,0,0,0,0,0,1
sequester carbon,0,1,0,0,0,0,0,1
sequoia national,0,0,0,0,0,1,0,1
sequoia trees,0,0,0,0,0,1,0,1
series extrapolations,0,0,0,0,0,0,1,1
service balloons,0,0,0,0,1,0,0,1
service's office,0,1,0,0,1,0,0,2
set amount,0,2,0,0,0,0,0,2
set targets,0,1,0,0,0,0,1,2
seth wenig,0,0,0,0,1,0,0,1
sets standards,0,1,0,0,0,1,0,2
settled ap,0,0,0,1,0,0,0,1
seventh grade,0,2,0,0,0,0,0,2
seventy percent,0,1,0,0,1,0,0,2
severe conditions,0,0,0,0,1,1,0,2
severe drought,0,0,0,1,0,1,0,2
severe droughts,0,1,0,0,0,1,0,2
severe thunderstorms,0,0,0,0,0,1,0,1
sewer district,0,0,0,2,0,0,0,2
share music,0,1,0,0,0,0,0,1
shawn schadle,0,0,0,0,0,0,1,1
shehbaz sharif,0,1,0,0,0,0,0,1
shelter inside,0,0,0,0,0,0,1,1
shenandoah valley,0,0,0,0,1,0,0,1
shipping terminal,0,0,0,0,0,1,0,1
short answer,0,0,0,1,0,0,0,1
short lived,0,0,0,0,2,0,0,2
short supply,0,0,0,0,0,2,0,2
shower curtain,0,0,0,0,0,0,1,1
shrimp boats,1,0,0,0,0,0,0,1
shrunk lake,0,0,0,1,0,0,0,1
sibley street,0,0,0,1,0,0,0,1
siegler reports,2,0,0,0,0,0,0,2
sierra club,0,0,0,0,2,0,0,2
sierra pelona,0,0,0,0,1,0,0,1
sign touting,0,0,0,0,0,0,1,1
significantly altered,0,0,2,0,0,0,0,2
signs promoting,0,1,0,0,0,0,0,1
silver lining,0,0,0,1,0,1,0,2
simi hills,0,0,1,0,0,0,0,1
similar comments,0,0,2,0,0,0,0,2
simply overwhelming,0,0,0,2,0,0,0,2
singer foundation,0,0,0,0,1,0,0,1
single blades,0,0,0,1,0,0,0,1
single day,0,0,0,0,2,0,0,2
single largest,0,0,0,1,1,0,0,2
sister earn,0,0,0,0,1,0,0,1
sister susan,1,0,0,0,0,0,0,1
sits stranded,0,0,0,1,0,0,0,1
sits trapped,0,0,0,1,0,0,0,1
situation yeah,0,0,2,0,0,0,0,2
sized hail,1,0,0,1,0,0,0,2
ski slopes,0,0,0,1,0,0,0,1
skiers cruise,0,0,0,1,0,0,0,1
skinned people,0,0,0,0,1,0,0,1
skip stiles,0,1,0,0,0,0,0,1
skyrocketing energy,0,2,0,0,0,0,0,2
sliding backwards,0,0,2,0,0,0,0,2
slightly worse,0,1,0,0,0,1,0,2
slope president,0,0,0,0,0,1,0,1
slow moving,1,0,0,0,0,1,0,2
slow pace,0,1,1,0,0,0,0,2
smith covers,0,0,0,0,1,0,0,1
smoke rises,0,0,0,0,1,0,0,1
snow accumulates,0,0,0,0,1,0,0,1
snow cover,0,0,0,1,0,0,0,1
snow mountain,0,0,0,1,0,0,0,1
snow reaching,0,0,0,0,1,0,0,1
snow removal,0,0,0,2,0,0,0,2
snowden walks,0,1,0,0,0,0,0,1
snowfall totals,0,0,0,1,1,0,0,2
snowmass ski,0,0,0,1,0,0,0,1
snowplow drivers,0,0,0,2,0,0,0,2
snowy morning,0,0,1,1,0,0,0,2
snowy roadway,0,0,0,0,1,0,0,1
social capital,0,0,0,0,0,1,0,1
social impact,0,0,1,0,0,0,0,1
soda bottles,1,0,0,0,0,0,0,1
soil winter,0,0,0,2,0,0,0,2
solar capacity,0,0,0,0,1,0,0,1
solar companies,0,0,0,0,1,0,0,1
solar executives,0,0,0,0,1,0,0,1
solar project,1,0,0,0,0,0,0,1
solar restrictions,0,0,0,0,1,0,0,1
son attended,0,0,0,0,0,0,1,1
sonam sherpa,0,1,0,0,0,0,0,1
sons jahxiel,0,1,0,0,0,0,0,1
sopa images,0,1,0,0,0,0,0,1
south carolina's,1,1,0,0,0,0,0,2
south georgia,0,1,0,0,0,0,0,1
south pit,0,1,0,0,0,0,0,1
south portland,0,0,0,0,1,0,0,1
south shoreline,0,0,0,0,1,0,0,1
south station,0,0,0,0,1,0,0,1
southbridge investments,0,1,0,0,0,0,0,1
southeastern oasis,1,0,0,0,0,0,0,1
southern company,0,0,2,0,0,0,0,2
southern district,1,0,0,0,0,0,0,1
southern malawi,0,0,0,0,0,1,0,1
southwestern gulf,0,2,0,0,0,0,0,2
souza afp,0,0,0,0,0,0,1,1
sowed seeds,0,0,0,0,1,0,0,1
spain october,0,1,0,0,0,0,0,1
spain shares,0,1,0,0,0,0,0,1
spanish mainland,0,1,0,0,0,0,0,1
speaking bambara,0,1,0,0,0,0,0,1
speaking yugtun,0,0,1,0,0,0,0,1
special envoy,0,1,1,0,0,0,0,2
special nasal,0,0,0,0,0,1,0,1
specialists scan,0,0,1,0,0,0,0,1
species act,2,0,0,0,0,0,0,2
species protections,1,0,0,0,0,0,0,1
specific countries,0,2,0,0,0,0,0,2
speech ruto,1,0,0,0,0,0,0,1
spencer cox,0,0,0,0,2,0,0,2
spend upwards,0,0,0,0,2,0,0,2
spending package,0,0,0,0,1,0,0,1
spent decades,0,2,0,0,0,0,0,2
spent months,0,1,0,0,1,0,0,2
spiegel magazine,0,0,1,1,0,0,0,2
spotted oct,0,1,0,0,0,0,0,1
spring n.y,0,0,0,0,0,0,1,1
st sylvestre,0,0,0,1,0,0,0,1
stable crops,1,0,0,0,0,0,0,1
stainless steel,0,2,0,0,0,0,0,2
stalling climate,0,0,1,1,0,0,0,2
standing water,0,0,0,1,1,0,0,2
starbucks coffee,0,0,0,1,0,0,0,1
start means,0,0,2,0,0,0,0,2
started coaching,0,1,0,0,0,0,0,1
starts tomorrow,0,2,0,0,0,0,0,2
state's droughts,0,0,0,0,0,1,0,1
state's gulf,0,1,0,0,0,0,0,1
state's infrastructure,0,0,0,0,0,1,0,1
state's north,0,0,0,1,0,1,0,2
state's power,1,0,0,1,0,0,0,2
state's water,0,0,0,0,1,1,0,2
statehood propaganda,0,0,0,1,0,0,0,1
station kcrw,0,0,1,0,0,1,0,2
station ktep,0,1,0,0,0,0,0,1
station kunc,1,1,0,0,0,0,0,2
station set,0,0,0,0,1,0,0,1
station whyy,2,0,0,0,0,0,0,2
stay dry,0,0,0,1,0,1,0,2
stay warm,0,0,0,0,1,0,0,1
steadily dropped,0,0,0,1,0,0,0,1
steam ancona,2,0,0,0,0,0,0,2
steam escapes,2,0,0,0,0,0,0,2
steam rises,0,1,0,0,0,0,0,1
steam systems,1,0,0,0,0,0,0,1
steel tanks,0,2,0,0,0,0,0,2
step forward,0,1,0,1,0,0,0,2
stephanie laughlin,0,0,0,2,0,0,0,2
steve gibson,1,0,0,0,0,0,0,1
steve helber,1,0,0,0,0,0,0,1
steven khon,0,1,0,0,0,0,0,1
sticks dry,0,0,0,0,0,1,0,1
stop building,0,2,0,0,0,0,0,2
stop investing,0,0,0,0,0,1,0,1
stopping traffic,0,0,1,1,0,0,0,2
storage research,0,1,0,0,0,0,0,1
storm approaches,0,1,0,1,0,0,0,2
storm damage,1,0,0,1,0,0,0,2
storm delivered,0,0,0,0,1,0,0,1
storm expected,1,0,0,0,1,0,0,2
storm force,1,1,0,0,0,0,0,2
storm fueled,0,0,1,0,1,0,0,2
storm knocked,0,0,0,1,0,0,0,1
storm left,0,0,0,0,1,0,0,1
storm passed,0,0,0,0,0,0,1,1
storm piled,0,0,0,0,1,0,0,1
storm pounds,0,0,0,0,1,0,0,1
storm rolled,0,0,0,1,0,0,0,1
storm systems,0,0,0,0,0,0,1,1
storm's deadliness,0,0,0,0,1,0,0,1
storms caused,0,0,0,0,0,1,0,1
storms coming,1,0,0,0,0,0,1,2
storms continue,0,0,0,1,0,0,0,1
storms floods,0,1,1,0,0,0,0,2
storms hit,0,0,0,1,0,1,0,2
storms laboratory,0,0,0,0,0,1,0,1
storms resulting,0,0,0,1,0,0,0,1
stormwater management,1,0,0,0,1,0,0,2
stormwater system,0,0,0,1,1,0,0,2
stormy weather,1,0,0,0,0,0,0,1
stoves due,0,0,0,1,0,0,0,1
stoves emit,0,0,0,0,1,0,0,1
strategic petroleum,1,0,0,0,0,1,0,2
strategic projects,0,0,0,0,1,0,0,1
street level,0,0,0,1,0,0,0,1
street thinking,0,0,0,1,0,0,0,1
stricter environmental,0,0,2,0,0,0,0,2
stricter scrutiny,0,0,0,1,0,0,0,1
stricter standards,0,0,1,0,0,1,0,2
strong jobs,0,0,0,0,0,1,0,1
strong political,0,1,0,0,0,0,1,2
strong safeguards,0,1,0,0,0,0,0,1
strong words,0,0,2,0,0,0,0,2
students lead,0,0,0,0,1,0,0,1
students log,0,0,0,1,0,0,0,1
studies extreme,0,1,0,1,0,0,0,2
studies published,0,0,0,0,1,0,0,1
study climate,0,0,0,2,0,0,0,2
study estimates,0,0,0,1,1,0,0,2
study looked,0,0,0,1,0,0,1,2
study math,0,1,0,0,0,0,0,1
study projects,0,0,0,0,0,1,0,1
study's authors,1,0,0,0,0,0,1,2
stumps scar,0,0,0,0,0,0,1,1
subsequent emails,0,0,0,0,1,0,0,1
subsidized fertilizer,1,0,0,0,0,0,0,1
subtropical storm,0,1,0,0,0,0,0,1
suck carbon,0,0,0,0,0,2,0,2
suggested regulating,0,0,0,1,0,0,0,1
suggested regulators,0,0,0,1,0,0,0,1
suggests support,0,0,0,1,0,0,0,1
sullivan npr,1,0,1,0,0,0,0,2
sultan ahmed,0,0,0,1,0,0,0,1
sumatran orangutan,0,0,1,0,0,0,0,1
summer monsoon,1,0,0,0,0,0,0,1
summer scientists,0,1,0,0,0,0,0,1
summer thunderstorms,1,0,0,0,0,0,0,1
summer u.s,0,1,0,0,1,0,0,2
summit nov,0,0,0,1,0,0,0,1
sun bleached,0,0,0,0,0,1,0,1
sun rises,0,1,0,0,0,0,0,1
sunamganj bangladesh,0,0,0,0,0,1,0,1
sunday nov,0,1,0,0,0,0,0,1
sunday victims,1,0,0,0,0,0,0,1
sunken speedboat,0,0,0,1,0,0,0,1
sunny january,0,0,0,2,0,0,0,2
super super,0,0,1,0,1,0,0,2
super worried,0,0,0,0,2,0,0,2
superstorm sandy,2,0,0,0,0,0,0,2
supply disruptions,2,0,0,0,0,0,0,2
supply system,0,0,0,0,1,0,0,1
support climate,0,1,0,1,0,0,0,2
sur ollon,0,0,0,1,0,0,0,1
surface level,0,0,0,0,0,1,0,1
surface water,0,0,0,0,1,1,0,2
surfaces slack,0,0,0,1,0,0,0,1
surveillance balloon,0,0,0,0,1,0,0,1
survey released,0,0,1,0,0,0,0,1
survive seasonal,0,0,0,0,0,1,0,1
survivors stranded,1,0,0,0,0,0,0,1
susan joy,0,0,0,0,1,0,0,1
susan mayne,0,1,0,0,0,0,0,1
susan sharon,1,0,0,0,0,0,0,1
susan zoltac,1,0,0,0,0,0,0,1
sustain life,0,0,0,0,2,0,0,2
sustainability club,0,1,0,0,0,0,0,1
sustainable clothing,1,0,0,0,0,0,0,1
sustainable finance,0,1,0,0,0,1,0,2
sustainable investing,0,0,2,0,0,0,0,2
sustainable landscaping,1,0,0,0,0,0,0,1
swollen los,0,0,0,0,1,0,0,1
sylhet district,0,0,0,0,0,1,0,1
system change,0,0,0,1,1,0,0,2
system told,1,0,1,0,0,0,0,2
systems remained,2,0,0,0,0,0,0,2
tailpipe emissions,0,0,0,0,0,1,0,1
taking overdue,0,0,1,1,0,0,0,2
tamias speciosus,0,0,1,0,0,0,0,1
tape measure,0,0,0,2,0,0,0,2
tax breaks,0,0,0,0,0,1,0,1
tax season,0,0,0,0,0,0,1,1
tea party,0,0,1,1,0,0,0,2
teach poor,0,0,0,0,1,0,0,1
teacher sarah,0,0,0,1,0,0,0,1
teaching lesson,1,0,0,0,0,0,0,1
technical center,0,0,0,0,0,1,0,1
technical support,0,2,0,0,0,0,0,2
telling people,0,2,0,0,0,0,0,2
tells people,0,0,0,0,1,0,0,1
temperature increase,0,0,0,2,0,0,0,2
temperature rise,0,1,0,0,0,0,0,1
temperatures continue,0,1,0,1,0,0,0,2
temperatures reached,0,0,0,0,1,0,0,1
temperatures rise,1,0,0,0,0,1,0,2
temperatures surged,0,0,0,2,0,0,0,2
temporary shelter,0,2,0,0,0,0,0,2
terimaine davis,0,1,0,0,0,0,0,1
term health,0,0,0,2,0,0,0,2
term investments,0,0,2,0,0,0,0,2
term measure,1,0,0,1,0,0,0,2
terms voters,0,0,2,0,0,0,0,2
texas held,0,0,2,0,0,0,0,2
texas institute,0,0,0,0,0,2,0,2
texas lawmakers,0,0,0,0,1,0,0,1
texas lm,0,1,0,0,0,0,0,1
texas methane,0,1,0,0,0,0,0,1
texas oklahoma,0,1,0,0,0,1,0,2
texas oysters,0,0,0,0,0,0,1,1
texas winter,0,0,0,0,1,0,0,1
text message,0,0,0,0,0,1,0,1
text messages,0,0,0,0,0,1,0,1
theatre collapsed,0,0,0,0,0,0,1,1
themed dress,1,0,0,0,0,0,0,1
theodor schnarr,0,0,1,1,0,0,0,2
theory alleges,0,0,0,0,0,1,0,1
therese coffey,0,0,0,1,0,1,0,2
thick ice,0,1,1,0,0,0,0,2
thin layer,1,0,1,0,0,0,0,2
thirsty crops,1,0,0,0,1,0,0,2
thomas displays,1,0,0,0,0,0,0,1
thomas sits,1,0,0,0,0,0,0,1
thousand dollars,0,0,0,2,0,0,0,2
thousand people,0,1,0,0,1,0,0,2
threaten guet,0,0,0,0,1,0,0,1
threatens corporate,0,1,0,0,0,0,0,1
threw black,0,0,1,0,0,0,0,1
thrive home,0,1,0,0,0,0,0,1
thunderstorms produce,0,0,0,0,0,1,0,1
thursday found,0,0,1,0,0,0,0,1
thursday morning,0,1,0,1,0,0,0,2
tidal wave,1,0,0,0,0,0,0,1
tide period,1,0,0,0,0,0,0,1
tim harford,0,0,0,0,0,1,0,1
timberland solar,0,0,0,0,1,0,0,1
time researchers,0,0,1,0,0,1,0,2
times larger,1,0,0,0,1,0,0,2
tiny dinosaurs,0,0,0,0,0,1,0,1
today's jobs,0,0,0,0,0,1,0,1
told npr's,0,1,1,0,0,0,0,2
tomato shortages,0,0,0,0,0,1,0,1
tomato soup,0,1,0,0,0,0,0,1
top aide,0,0,1,0,1,0,0,2
top climate,0,1,0,0,0,1,0,2
top official,0,0,0,1,0,0,0,1
tornado damage,0,0,0,0,1,1,0,2
tornado damaged,0,0,0,0,0,1,0,1
tornado devastated,0,0,0,0,0,0,1,1
tornado frequency,0,0,0,0,0,1,0,1
tornado killed,0,0,0,0,0,2,0,2
tornado scientist,0,0,0,0,0,2,0,2
tornado season,0,0,0,0,0,1,1,2
tornadoes hit,0,0,0,1,0,0,1,2
tornadoes killed,0,0,0,0,0,0,1,1
toronto represented,0,1,0,0,0,0,0,1
torrential rain,0,0,0,2,0,0,0,2
torres ferrer,0,0,0,1,0,0,0,1
tough business,0,0,0,2,0,0,0,2
tough questions,0,0,1,0,0,0,0,1
town council,0,1,0,0,0,0,0,1
town officials,0,1,0,0,0,0,0,1
town's recreation,0,1,0,0,0,0,0,1
toyota introduced,0,0,0,0,1,0,0,1
toyota unveils,0,0,0,0,1,0,0,1
trace greenhouse,0,1,0,0,0,0,0,1
trade policy,0,0,0,0,0,1,0,1
traditional council,0,0,2,0,0,0,0,2
traditional knowledge,0,0,1,0,1,0,0,2
traditional meat,0,1,0,0,0,0,0,1
traditional pakistani,1,0,0,0,0,0,0,1
traditional practices,0,1,0,0,0,0,0,1
trailer park,1,0,0,0,0,0,0,1
train station,2,0,0,0,0,0,0,2
trans alaska,0,0,0,0,0,1,0,1
transit agencies,0,0,0,0,1,0,0,1
transition accelerator,0,2,0,0,0,0,0,2
transition partnership,0,0,0,0,1,0,0,1
transmission lines,0,0,0,2,0,0,0,2
transmit marburg,0,0,0,0,0,1,0,1
trapping gases,1,0,0,1,0,0,0,2
travel blog,1,0,0,0,0,0,0,1
treatment plants,0,0,0,1,0,0,0,1
tree deaths,0,0,1,0,0,0,0,1
tree limbs,1,0,0,0,1,0,0,2
tree mortality,0,0,1,0,0,0,0,1
tree stumps,0,0,0,0,0,0,1,1
trees stand,0,0,0,0,0,1,0,1
tribal climate,0,0,2,0,0,0,0,2
tribal council,0,0,2,0,0,0,0,2
tribal nations,0,0,0,0,0,1,0,1
tribe's water,0,0,0,0,0,1,0,1
triggered mudslides,0,0,0,1,0,1,0,2
troop sarah,0,2,0,0,0,0,0,2
tropical forests,0,0,1,0,0,0,0,1
tropical rainforests,0,0,0,0,0,0,1,1
troublesome creek,0,1,0,0,0,0,0,1
troy public,0,0,0,1,0,0,0,1
truck makers,0,0,1,0,0,0,0,1
trucking industry,0,0,1,0,0,1,0,2
trucks line,0,0,0,0,0,1,0,1
trumka jr,0,0,0,1,1,0,0,2
trump era,0,0,1,0,0,0,0,1
tsunami mistakenly,1,0,0,0,0,0,0,1
tu mentira,0,0,0,1,0,0,0,1
tucker carlson,0,0,0,0,0,1,0,1
tuesday ahead,0,1,0,0,0,0,0,1
tuesday dec,0,0,0,1,0,0,0,1
tuesday night,0,0,1,0,1,0,0,2
tufts university,1,1,0,0,0,0,0,2
turbines producing,0,0,1,0,0,0,0,1
turetsky explains,0,1,0,0,0,0,0,1
turf algae,0,1,0,0,0,0,0,1
turtle swims,0,1,0,0,0,0,0,1
u.n biodiversity,0,0,1,0,1,0,0,2
u.n coverage,0,2,0,0,0,0,0,2
u.n negotiations,0,0,0,1,0,0,0,1
u.n water,0,0,0,0,0,2,0,2
u.s analyzed,0,0,0,1,0,0,0,1
u.s bureau,1,0,0,0,0,1,0,2
u.s china,1,0,0,0,1,0,0,2
u.s consumer,0,0,0,2,0,0,0,2
u.s geological,1,1,0,0,0,0,0,2
u.s greenhouse,0,0,1,0,0,0,0,1
u.s highway,0,0,0,1,0,0,0,1
u.s history,0,0,0,0,1,0,0,1
u.s military,0,0,0,0,2,0,0,2
u.s national,1,0,1,0,0,0,0,2
u.s officials,0,0,0,0,1,0,0,1
u.s plastic,0,0,1,0,0,0,0,1
u.s program,0,1,0,0,0,0,0,1
u.s sen,1,1,0,0,0,0,0,2
u.s summer,1,0,0,0,0,0,0,1
u.s vice,0,1,0,0,0,0,0,1
u.s.s portland,0,0,0,0,1,0,0,1
uae leader,0,0,0,1,0,1,0,2
uc davis,0,0,0,0,1,0,0,1
uc santa,0,0,0,1,0,0,0,1
unborn babies,1,0,0,0,0,0,0,1
underground coal,0,0,0,0,1,0,0,1
undermining public,0,0,0,0,1,0,0,1
understand climate,0,0,0,1,1,0,0,2
understand english,0,0,2,0,0,0,0,2
unemployment rate,0,0,0,0,0,1,0,1
uninsulated homes,0,0,0,0,1,0,0,1
universal images,0,0,2,0,0,0,0,2
university measured,0,0,0,1,0,0,0,1
university student,0,1,1,0,0,0,0,2
university told,0,0,0,0,0,2,0,2
unprecedented amount,0,0,0,0,0,1,1,2
unprecedented flooding,1,1,0,0,0,0,0,2
unprecedented summer,1,0,0,0,0,0,0,1
untitled valora,0,0,0,1,0,0,0,1
unusual weather,0,0,0,1,0,0,0,1
unusually warm,0,0,1,1,0,0,0,2
updated rainfall,0,0,0,2,0,0,0,2
upmanyu patil,0,1,0,0,0,0,0,1
upside foods.upside,0,1,0,0,0,0,0,1
urban neighborhood,0,0,0,1,0,0,0,1
urgent action,1,1,0,0,0,0,0,2
urgent climate,1,0,0,0,1,0,0,2
utah waterlines,0,0,0,0,0,1,0,1
utilities alabama,0,0,1,0,0,0,0,1
vacant buildings,0,0,2,0,0,0,0,2
valeti prepares,0,1,0,0,0,0,0,1
valeti recalls,0,1,0,0,0,0,0,1
valeti upside,0,1,0,0,0,0,0,1
valley calif,0,0,0,0,1,0,0,1
valley suburbs,0,0,0,0,1,0,0,1
valley town,0,0,0,1,0,0,0,1
valleys formed,1,0,0,0,0,0,0,1
valora tu,0,0,0,1,0,0,0,1
vegetation cover,0,0,0,1,0,0,0,1
vehicle dec,0,0,0,1,0,0,0,1
vehicle emissions,0,0,1,0,0,1,0,2
vehicle sits,0,0,0,1,0,0,0,1
vehicles starting,0,0,0,0,0,2,0,2
vendors carry,0,0,0,0,0,1,0,1
venture capitalist,0,1,0,0,0,1,0,2
verified vicinity's,2,0,0,0,0,0,0,2
vermont cutting,0,0,0,2,0,0,0,2
vermont public,0,0,0,2,0,0,0,2
vero beach,0,2,0,0,0,0,0,2
vessels littered,1,0,0,0,0,0,0,1
vicinity's dicroce,2,0,0,0,0,0,0,2
video speech,0,1,0,0,0,0,0,1
vietnam memorial,0,1,0,0,0,0,0,1
view farming,0,0,0,1,0,0,0,1
village floods,0,0,0,0,0,1,0,1
villars sur,0,0,0,1,0,0,0,1
vincent van,0,1,0,0,0,0,0,1
virginia hatcher,1,0,0,0,0,0,0,1
virginia's shenandoah,0,0,0,0,1,0,0,1
visitors enter,0,0,0,1,0,0,0,1
visual artist,0,1,0,1,0,0,0,2
vital signs,1,0,0,0,0,0,0,1
vocal leadership,0,0,2,0,0,0,0,2
vocalizations including,0,0,0,0,0,1,0,1
volunteer carries,0,0,1,0,0,0,0,1
vt relies,0,0,0,2,0,0,0,2
vulnerability multiplier,1,0,0,0,0,0,0,1
vulnerable populations,0,1,0,1,0,0,0,2
walton family,1,0,0,1,0,0,0,2
war fight,0,0,0,1,0,0,0,1
warm winter,0,0,0,2,0,0,0,2
warmer davis,0,0,0,2,0,0,0,2
warmer ocean,0,2,0,0,0,0,0,2
warming carbon,0,1,1,0,0,0,0,2
warming goal,0,0,0,1,0,0,0,1
warming season,0,0,0,2,0,0,0,2
warming temperatures,0,0,0,1,0,0,0,1
warming winters,0,0,0,2,0,0,0,2
warning sign,0,1,1,0,0,0,0,2
warren snowden,0,1,0,0,0,0,0,1
wastewater treatment,0,0,0,1,0,0,0,1
water collected,0,0,0,0,0,1,0,1
water conference,0,0,0,0,0,2,0,2
water conservation,1,0,0,0,0,1,0,2
water deliveries,0,0,0,0,2,0,0,2
water department,0,1,0,0,0,0,0,1
water desk,1,0,0,0,0,0,0,1
water development,0,0,0,0,0,2,0,2
water district,1,0,0,1,0,0,0,2
water heater,0,0,0,2,0,0,0,2
water january,0,0,0,0,1,0,0,1
water law,0,0,0,1,1,0,0,2
water partnerships,0,0,0,0,0,1,0,1
water pours,0,0,0,0,0,1,0,1
water projects,0,0,0,2,0,0,0,2
water reservoirs,1,1,0,0,0,0,0,2
water reuse,0,0,0,0,1,1,0,2
water rights,0,0,0,0,0,2,0,2
water security,0,0,1,1,0,0,0,2
water shortages,0,0,0,0,0,2,0,2
water stress,0,0,0,0,0,1,0,1
water system,0,0,0,1,0,0,0,1
water table,0,1,0,0,0,0,0,1
water texas,0,0,0,0,1,0,0,1
water thinking,1,0,1,0,0,0,0,2
water users,0,0,0,0,0,2,0,2
waters inundate,0,0,0,1,0,0,0,1
wave producer,1,0,0,0,0,1,0,2
wave team,0,0,0,0,0,2,0,2
waves droughts,0,0,0,1,0,1,0,2
wbur hide,0,0,0,0,0,1,0,1
wealthy nations,0,2,0,0,0,0,0,2
weather balloon,0,0,0,0,1,0,0,1
weather energy,0,0,0,0,0,1,0,1
weather forecasters,0,1,0,0,1,0,0,2
weather issue,0,0,1,0,0,0,0,1
weather observer,0,0,0,0,1,0,0,1
weather officials,0,0,0,1,0,0,0,1
weather radar,0,1,0,0,0,0,0,1
weather station,0,0,0,1,1,0,0,2
weather systems,0,0,0,1,0,0,1,2
weathering conditions,0,0,0,0,1,0,0,1
wednesday feb,0,0,0,0,1,0,0,1
wednesday nov,0,1,0,0,0,0,0,1
wednesday officials,0,1,0,0,0,0,0,1
week california,0,0,0,0,1,1,0,2
week damaging,0,0,0,0,0,1,0,1
weekend causing,0,0,0,1,0,0,1,2
weeks sales,0,0,0,2,0,0,0,2
wellman iowa,0,0,0,0,0,0,1,1
wessels afp,1,0,0,0,0,0,0,1
west antarctic,0,1,0,0,0,0,0,1
west era,0,0,2,0,0,0,0,2
west faced,0,0,0,0,1,0,0,1
west northwest,1,1,0,0,0,0,0,2
west palm,0,1,0,0,0,0,0,1
west virginia,1,0,0,0,0,0,0,1
western alaska,0,0,2,0,0,0,0,2
western border,1,0,1,0,0,0,0,2
western chad,0,0,1,0,0,0,0,1
western edge,0,0,1,1,0,0,0,2
western indian,0,1,0,0,0,0,0,1
western united,1,0,0,1,0,0,0,2
westphalia germany,0,0,0,0,1,0,0,1
wet ground,0,0,0,2,0,0,0,2
wettest day,0,0,0,1,1,0,0,2
wharton business,0,0,2,0,0,0,0,2
whestine's farm,0,0,0,0,0,0,1,1
white house's,0,1,0,0,1,0,0,2
white wine,0,1,0,1,0,0,0,2
whitesides road,0,1,0,0,0,0,0,1
who've set,1,0,0,0,0,0,0,1
wicked cold,0,0,0,0,1,0,0,1
wide swath,0,0,0,0,1,0,1,2
wider community,0,0,0,1,0,0,0,1
widespread death,0,0,2,0,0,0,0,2
widespread destruction,0,0,0,1,0,0,0,1
wild oysters,0,0,0,0,0,0,1,1
wild west,0,0,2,0,0,0,0,2
wildfire devastated,0,0,0,0,1,0,0,1
wildfires burning,1,0,0,0,0,0,0,1
wildlife communities,0,0,0,0,0,2,0,2
wildlife fund,0,0,1,1,0,0,0,2
wildlife habitat,0,0,0,0,0,1,0,1
willem marx,0,0,1,0,0,0,0,1
william honsal,0,0,0,0,0,1,0,1
willow creek,0,0,0,1,0,0,0,1
win solutions,0,0,0,0,1,0,0,1
wind farms,0,0,0,1,1,0,0,2
wind gusts,0,1,0,0,1,0,0,2
wind shear,0,0,0,0,0,1,0,1
wind speeds,0,0,0,1,0,1,0,2
windows blown,0,1,0,0,0,0,1,2
windsor california,0,0,0,1,0,0,0,1
windsor canada,0,0,0,0,0,1,0,1
wine butter,0,1,0,0,0,0,0,1
wing political,1,0,0,0,1,0,0,2
wing spread,0,1,0,0,0,0,0,1
winter recently,0,0,0,0,1,0,0,1
winter season,0,0,0,2,0,0,0,2
winter storm's,0,0,0,0,1,0,0,1
winters limit,0,0,0,2,0,0,0,2
witold henisz,0,0,2,0,0,0,0,2
wmo spokesperson,0,1,0,0,0,0,0,1
woke policies,0,0,2,0,0,0,0,2
women waiting,1,0,0,0,0,0,0,1
woo woo,0,0,0,0,0,1,0,1
wooden electric,0,0,0,1,0,0,0,1
worker checks,0,0,0,0,0,1,0,1
workers feed,0,0,0,2,0,0,0,2
world government,0,0,0,0,0,1,0,1
world including,1,0,0,0,1,0,0,2
world meteorological,1,1,0,0,0,0,0,2
world water,0,0,0,0,0,2,0,2
world wildlife,0,0,1,1,0,0,0,2
world's coral,0,2,0,0,0,0,0,2
world's ecosystems,0,0,1,0,0,0,1,2
world's elites,0,0,0,0,0,1,0,1
world's finest,0,0,0,0,0,1,0,1
world's oceans,0,1,1,0,0,0,0,2
worst climate,0,1,0,0,0,1,0,2
worst damage,0,0,0,0,1,0,0,1
worst effects,0,0,0,0,2,0,0,2
worst flooding,0,0,0,0,0,1,0,1
worst impacts,0,1,1,0,0,0,0,2
worst power,0,0,0,0,1,0,0,1
wow wow,0,1,0,0,0,0,0,1
wreaking havoc,0,1,0,0,0,1,0,2
wrecked shrimp,1,0,0,0,0,0,0,1
wrong direction,2,0,0,0,0,0,0,2
xcel energy,0,1,0,0,0,0,0,1
xi jinping,0,2,0,0,0,0,0,2
xochimilco mexico,0,0,0,0,0,1,0,1
yannick monschauer,0,0,0,0,0,1,1,2
yard left,0,0,0,0,0,0,1,1
yeah chefornak,0,0,2,0,0,0,0,2
year's eve,0,0,0,1,1,0,0,2
year's farm,0,0,0,1,0,0,1,2
year's federal,0,0,0,0,0,1,1,2
year's gathering,0,2,0,0,0,0,0,2
yelling inaudible,0,1,0,0,0,0,0,1
york schools,0,0,0,1,0,0,0,1
york tuesday,0,0,0,1,0,0,0,1
york university,0,0,0,1,1,0,0,2
youthful energy,0,1,0,0,0,0,0,1
ysidro creek,0,0,0,1,0,0,0,1
zoltac left,1,0,0,0,0,0,0,1
zombie forests,0,0,0,0,0,1,0,1
zoned land,0,0,0,0,1,0,0,1
zoo international,0,1,0,0,0,0,0,1
1.5c warming,0,0,0,1,0,0,0,1
120ft wide,0,0,0,0,0,1,0,1
13th century,0,0,0,0,0,1,0,1
15th meeting,0,0,1,0,0,0,0,1
1700s national,0,0,0,0,1,0,0,1
17th street,0,1,0,0,0,0,0,1
1970s era,0,0,0,1,0,0,0,1
1980s helping,1,0,0,0,0,0,0,1
1980s indoor,0,0,0,0,1,0,0,1
1990s greenhouse,0,1,0,0,0,0,0,1
1st grader,0,0,0,0,1,0,0,1
2090s cornell,0,0,0,1,0,0,0,1
20s maya,0,1,0,0,0,0,0,1
21st century,0,0,0,0,0,1,0,1
30th street,1,0,0,0,0,0,0,1
3d seismic,1,0,0,0,0,0,0,1
4chan message,0,0,0,0,0,1,0,1
4chan posts,0,0,0,0,0,1,0,1
4g coverage,0,0,0,0,0,1,0,1
aaa spokeswoman,1,0,0,0,0,0,0,1
aamir qureshi,0,1,0,0,0,0,0,1
abaco bimini,0,1,0,0,0,0,0,1
abaco island,0,1,0,0,0,0,0,1
abaco's march,0,1,0,0,0,0,0,1
abacos berry,0,1,0,0,0,0,0,1
abandoned beach,0,1,0,0,0,0,0,1
abandoned houser's,0,0,0,0,1,0,0,1
abandoned structures,0,0,0,0,1,0,0,1
abbott's signature,0,0,0,0,1,0,0,1
abdel fattah,0,1,0,0,0,0,0,1
abdo joined,0,1,0,0,0,0,0,1
abdominal pain,0,0,0,0,0,1,0,1
abdul fattah,0,1,0,0,0,0,0,1
abigail maciver,0,0,1,0,0,0,0,1
abnormally hot,0,1,0,0,0,0,0,1
aboard air,1,0,0,0,0,0,0,1
about.this takes,0,1,0,0,0,0,0,1
aboveground swimming,1,0,0,0,0,0,0,1
abraham muthogo,1,0,0,0,0,0,0,1
abrams tank,0,0,0,1,0,0,0,1
abroad fode,0,1,0,0,0,0,0,1
abroad joe,0,0,0,1,0,0,0,1
abruptly plunges,1,0,0,0,0,0,0,1
absence zelenskyy,0,1,0,0,0,0,0,1
absolute chaos,0,1,0,0,0,0,0,1
absolute connection,0,0,0,1,0,0,0,1
absolute emission,0,1,0,0,0,0,0,1
absolute terror,0,0,0,0,0,0,1,1
absolutely ari,0,1,0,0,0,0,0,1
absolutely saudi,0,0,0,1,0,0,0,1
absolve exxonmobil,0,0,0,1,0,0,0,1
absorb bits,0,0,0,0,0,0,1,1
absorb flooding,1,0,0,0,0,0,0,1
absorb tides,0,0,0,0,1,0,0,1
absorbing city,0,0,0,1,0,0,0,1
absorbing opposition,0,0,0,0,0,1,0,1
absurd moses,0,1,0,0,0,0,0,1
abundant resource,0,0,1,0,0,0,0,1
abuse o'donnell,0,0,0,0,0,0,1,1
abuse susie,0,0,0,0,1,0,0,1
abuses attacks,0,0,1,0,0,0,0,1
academia foote,0,0,0,0,0,1,0,1
academic subjects,0,1,0,0,0,0,0,1
accelerate climate,0,1,0,0,0,0,0,1
accelerate scientists,0,1,0,0,0,0,0,1
accelerated climate,0,0,1,0,0,0,0,1
accelerated food,0,0,1,0,0,0,0,1
accelerated rate,0,1,0,0,0,0,0,1
accelerating effects,0,0,0,1,0,0,0,1
accelerating erosion,0,1,0,0,0,0,0,1
accelerating nature,0,0,1,0,0,0,0,1
accept pumpkins,0,1,0,0,0,0,0,1
accept submissions,0,0,0,0,1,0,0,1
accepting public,0,0,0,0,1,0,0,1
access grazing,0,1,0,0,0,0,0,1
access issues,0,0,0,0,0,1,0,1
accessible online,0,1,0,0,0,0,0,1
accessories drag,1,0,0,0,0,0,0,1
accessories grace,1,0,0,0,0,0,0,1
accomplish regulations,1,0,0,0,0,0,0,1
account schorsch,0,0,1,0,0,0,0,1
account told,0,0,0,0,0,1,0,1
accountability communication,0,0,0,0,1,0,0,1
accountability continue,0,0,0,0,1,0,0,1
accountability piece,0,1,0,0,0,0,0,1
accountable people,0,1,0,0,0,0,0,1
accounting practices,0,1,0,0,0,0,0,1
accounts reflect,0,0,1,0,0,0,0,1
accumulates annually,0,0,0,1,0,0,0,1
accumulating crises,0,0,1,0,0,0,0,1
accurate alternative,0,1,0,0,0,0,0,1
accurate term,0,0,0,0,1,0,0,1
accurately deane,1,0,0,0,0,0,0,1
accurately predicted,0,0,0,1,0,0,0,1
accusations arrived,0,0,0,0,0,1,0,1
accused perkins,0,0,1,0,0,0,0,1
accusing democratic,0,1,0,0,0,0,0,1
accusing pitts,0,0,1,0,0,0,0,1
accusing republicans,0,1,0,0,0,0,0,1
acharya grew,0,1,0,0,0,0,0,1
acharya makes,0,1,0,0,0,0,0,1
achieve carbon,0,1,0,0,0,0,0,1
achieve electrification,1,0,0,0,0,0,0,1
achieve jane,0,0,0,0,1,0,0,1
achieve lower,1,0,0,0,0,0,0,1
achieving agreement,0,0,1,0,0,0,0,1
acknowledged biden,1,0,0,0,0,0,0,1
acknowledges prescribing,0,1,0,0,0,0,0,1
acknowledging this.al,0,0,0,1,0,0,0,1
acre agricultural,0,1,0,0,0,0,0,1
acre chunk,0,0,0,0,0,1,0,1
acre operation,0,1,0,0,0,0,0,1
acre plot,0,0,0,0,0,0,1,1
acre region,0,0,0,0,0,1,0,1
acres contained,0,0,1,0,0,0,0,1
acres flooded,0,0,0,0,0,1,0,1
acres montecito,0,0,0,1,0,0,0,1
act ahead,0,0,0,1,0,0,0,1
act ana,0,1,0,0,0,0,0,1
act california,0,0,0,0,0,1,0,1
act esa,1,0,0,0,0,0,0,1
act passed,0,0,0,0,1,0,0,1
act rules,0,0,1,0,0,0,0,1
act signed,0,0,1,0,0,0,0,1
act u.s,0,0,0,0,0,1,0,1
act's affected,0,0,0,0,0,1,0,1
acted unethically,0,0,1,0,0,0,0,1
acting director,0,1,0,0,0,0,0,1
action accounted,1,0,0,0,0,0,0,1
action carly,0,0,0,0,1,0,0,1
action completes,0,0,0,0,0,1,0,1
action estimates,0,1,0,0,0,0,0,1
action guilt,1,0,0,0,0,0,0,1
action including,0,0,0,1,0,0,0,1
action mccabe,0,0,0,0,0,1,0,1
action music,0,1,0,0,0,0,0,1
action npr's,0,0,0,0,0,0,1,1
action pattie,1,0,0,0,0,0,0,1
action plans,1,0,0,0,0,0,0,1
action terry,0,0,1,0,0,0,0,1
action unesco,0,1,0,0,0,0,0,1
action world,0,1,0,0,0,0,0,1
action.in participating,0,0,0,1,0,0,0,1
actionable agenda,0,1,0,0,0,0,0,1
actions destruction,0,0,1,0,0,0,0,1
active approach,0,1,0,0,0,0,0,1
active development,1,0,0,0,0,0,0,1
active materials,0,0,0,0,0,1,0,1
active oil,0,1,0,0,0,0,0,1
actively engaged,0,1,0,0,0,0,0,1
activism project,0,1,0,0,0,0,0,1
activist adah,0,1,0,0,0,0,0,1
activist karen,0,0,0,0,1,0,0,1
activist lin's,0,1,0,0,0,0,0,1
activist shareholders,0,0,0,0,0,0,1,1
activists andasan,0,0,0,0,0,1,0,1
activists belong,0,0,1,0,0,0,0,1
activists chained,0,0,0,0,0,1,0,1
activists declined,0,0,0,0,0,1,0,1
activists frustrations,0,0,1,0,0,0,0,1
activists invited,0,0,0,0,0,1,0,1
activists launched,0,0,0,1,0,0,0,1
activists occupying,0,0,1,0,0,0,0,1
activists worry,0,0,0,1,0,0,0,1
activities aim,0,0,0,0,0,1,0,1
activities align,0,1,0,0,0,0,0,1
activities ensure,0,1,0,0,0,0,0,1
activity bharat,0,0,0,0,1,0,0,1
activity peaking,0,0,0,0,0,1,0,1
actor jeremy,0,0,0,1,0,0,0,1
actor posted,0,0,0,1,0,0,0,1
actual decline,0,0,1,0,0,0,0,1
actual environmental,0,1,0,0,0,0,0,1
actual flooding,1,0,0,0,0,0,0,1
actual increase,0,0,0,0,0,1,0,1
actual items,0,1,0,0,0,0,0,1
actual losses,0,0,0,0,1,0,0,1
actual photos,0,1,0,0,0,0,0,1
actual pot,0,1,0,0,0,0,0,1
actual quantifiable,0,1,0,0,0,0,0,1
actual regulations,0,0,0,0,1,0,0,1
actual results,0,1,0,0,0,0,0,1
actual sales,0,0,0,0,1,0,0,1
acute food,1,0,0,0,0,0,0,1
acute hunger,1,0,0,0,0,0,0,1
adam raney,0,1,0,0,0,0,0,1
adam sobel,0,0,0,0,1,0,0,1
adam stoltman,0,1,0,0,0,0,0,1
adapt change,0,1,0,0,0,0,0,1
adaptation champions,0,1,0,0,0,0,0,1
adaptation duarte,0,1,0,0,0,0,0,1
adaptation efforts,0,1,0,0,0,0,0,1
adaptation gca,0,1,0,0,0,0,0,1
adaptation investments,0,1,0,0,0,0,0,1
adaptation plan,0,0,0,0,1,0,0,1
adaptation programs,0,1,0,0,0,0,0,1
adaptation section,0,1,0,0,0,0,0,1
adaptations steel,0,1,0,0,0,0,0,1
add carbon,0,0,0,0,0,1,0,1
add costs,0,0,1,0,0,0,0,1
add electric,0,0,1,0,0,0,0,1
add emissions,0,0,1,0,0,0,0,1
add extra,0,0,0,0,0,1,0,1
add lots,0,0,0,0,1,0,0,1
added audiences,0,0,1,0,0,0,0,1
added brooks,0,0,0,0,0,1,0,1
added complication,1,0,0,0,0,0,0,1
added federal,0,0,0,0,0,1,0,1
added feedback,0,1,0,0,0,0,0,1
added fortunately,1,0,0,0,0,0,0,1
added resilience,0,0,0,1,0,0,0,1
added solar,0,1,0,0,0,0,0,1
added taalas,1,0,0,0,0,0,0,1
addiction tomorrow,0,1,0,0,0,0,0,1
adding billions,0,1,0,0,0,0,0,1
adding climate,0,0,0,1,0,0,0,1
adding emissions,0,0,0,0,1,0,0,1
additional bottleneck,0,0,0,1,0,0,0,1
additional challenges,0,0,0,1,0,0,0,1
additional comment,0,1,0,0,0,0,0,1
additional editing,0,0,1,0,0,0,0,1
additional generation,0,0,0,1,0,0,0,1
additional machinery,0,1,0,0,0,0,0,1
additional natural,1,0,0,0,0,0,0,1
additional outreach,0,0,0,0,1,0,0,1
additional rain,0,0,0,1,0,0,0,1
additional regulation,0,0,1,0,0,0,0,1
additional reporting,1,0,0,0,0,0,0,1
additional risks,0,1,0,0,0,0,0,1
additional seed,0,1,0,0,0,0,0,1
additional steps,0,0,0,0,0,1,0,1
additional symptoms,0,0,0,0,0,1,0,1
additionally matrix's,0,0,1,0,0,0,0,1
additionally outreach,0,0,0,1,0,0,0,1
additionally scientists,0,0,0,1,0,0,0,1
address community,0,0,1,0,0,0,0,1
address cooking,0,0,0,0,1,0,0,1
address deforestation,0,0,0,0,1,0,0,1
address emissions,0,0,0,0,0,1,0,1
address environmental,0,0,0,0,0,0,1,1
address growing,0,1,0,0,0,0,0,1
address including,0,0,0,0,1,0,0,1
address loss,0,1,0,0,0,0,0,1
address pollution,0,0,0,0,0,1,0,1
address specific,0,0,0,0,1,0,0,1
addressed jim,0,0,0,0,1,0,0,1
addresses fuel,1,0,0,0,0,0,0,1
addressing deforestation,0,0,0,0,0,0,1,1
addressing drivers,0,0,1,0,0,0,0,1
addressing environmental,0,0,0,1,0,0,0,1
addressing issues,0,1,0,0,0,0,0,1
addressing loss,0,1,0,0,0,0,0,1
adds pak,0,0,0,0,1,0,0,1
adds poverty,0,0,0,0,1,0,0,1
adek berry,0,0,0,0,1,0,0,1
adel hagekhalil,0,0,0,1,0,0,0,1
adelie penguins,0,1,0,0,0,0,0,1
adequate sanitation,0,0,0,0,0,1,0,1
adequate ventilation,0,0,0,0,1,0,0,1
adequate water,0,1,0,0,0,0,0,1
adhanom ghebreyesus,0,0,0,0,0,1,0,1
adhiguna analyst,0,0,0,0,1,0,0,1
aditya irawan,0,0,0,0,1,0,0,1
adjacent basketball,0,1,0,0,0,0,0,1
adjust adapt,0,0,0,1,0,0,0,1
adjust prices,1,0,0,0,0,0,0,1
adl's aniano,0,0,0,0,0,1,0,1
administration announced,0,0,0,0,0,1,0,1
administration believes,0,0,0,0,0,1,0,1
administration climate,0,0,0,1,0,0,0,1
administration committed,0,0,0,0,0,1,0,1
administration director,0,0,1,0,0,0,0,1
administration eunice,0,0,0,0,0,1,0,1
administration expects,0,0,0,0,1,0,0,1
administration findings,1,0,0,0,0,0,0,1
administration immigration,0,0,1,0,0,0,0,1
administration initially,0,0,0,0,0,1,0,1
administration looked,0,0,0,0,1,0,0,1
administration moved,0,0,0,0,0,1,0,1
administration officials,0,1,0,0,0,0,0,1
administration permits,0,0,0,0,0,1,0,1
administration pledged,0,0,0,1,0,0,0,1
administration received,0,0,0,0,0,1,0,1
administration rejection,0,0,0,0,0,1,0,1
administration rick,0,0,0,1,0,0,0,1
administration shifted,0,0,0,1,0,0,0,1
administration stuck,0,0,0,0,0,1,0,1
administration supports,0,1,0,0,0,0,0,1
administration's approval,0,0,0,0,0,1,0,1
administration's commitment,1,0,0,0,0,0,0,1
administration's negotiating,0,1,0,0,0,0,0,1
administration's pledges,0,0,0,1,0,0,0,1
administration's priorities,0,0,0,0,0,1,0,1
administrator climate,0,0,0,1,0,0,0,1
administrator regan,0,0,0,1,0,0,0,1
adopt california's,0,0,0,0,0,1,0,1
adopt gas,0,0,0,1,0,0,0,1
adopt irrigation,0,0,0,0,0,1,0,1
adopt policies,0,0,0,1,0,0,0,1
adopters friedrich,0,1,0,0,0,0,0,1
adopting goals,0,1,0,0,0,0,0,1
adopting renewable,0,0,0,0,0,1,0,1
adopting stricter,0,0,0,0,0,1,0,1
adopting versions,0,0,1,0,0,0,0,1
adrian pirani,0,1,0,0,0,0,0,1
adrian sainz,0,0,0,0,0,0,1,1
adult male,0,0,1,0,0,0,0,1
advance dickerson,0,0,0,0,1,0,0,1
advance farming,0,0,0,1,0,0,0,1
advance international,0,1,0,0,0,0,0,1
advance pete,0,0,0,0,0,1,0,1
advance u.s,0,1,0,0,0,0,0,1
advanced clean,0,0,1,0,0,0,0,1
advanced recycling,1,0,0,0,0,0,0,1
advanced technology,0,0,0,0,0,1,0,1
advancing abigail,0,0,0,0,0,1,0,1
advancing innovative,0,1,0,0,0,0,0,1
advancing speaking,0,1,0,0,0,0,0,1
advice absolutely,0,0,0,0,1,0,0,1
advice nagel,0,1,0,0,0,0,0,1
advise conference,0,1,0,0,0,0,0,1
advise people,0,0,0,0,1,0,0,1
adviser steve,0,0,0,0,0,1,0,1
advising organizations,0,0,0,0,1,0,0,1
advisor brett,0,0,0,0,1,0,0,1
advisory panel,0,0,0,1,0,0,0,1
advocates government,0,0,1,0,0,0,0,1
advocates hope,0,0,1,0,0,0,0,1
advocates who've,0,0,0,0,0,1,0,1
aerial surveys,0,0,1,0,0,0,0,1
afb bacterium,0,0,0,1,0,0,0,1
afb pathogen,0,0,0,1,0,0,0,1
affairs defra,0,0,0,1,0,0,0,1
affairs monica,0,0,0,0,1,0,0,1
affect billions,0,1,0,0,0,0,0,1
affect blinken's,0,0,0,0,1,0,0,1
affect health,0,0,0,0,1,0,0,1
affect indoor,0,0,0,1,0,0,0,1
affect peoples,0,1,0,0,0,0,0,1
affect public,0,0,1,0,0,0,0,1
affected communities,0,1,0,0,0,0,0,1
affecting hurricanes,0,1,0,0,0,0,0,1
affecting negotiations,0,1,0,0,0,0,0,1
affecting people,0,0,1,0,0,0,0,1
affecting people's,0,0,0,0,0,1,0,1
affecting residents,0,0,0,0,0,1,0,1
affects hurricanes,0,1,0,0,0,0,0,1
affiliates congress,1,0,0,0,0,0,0,1
afford rehman,0,1,0,0,0,0,0,1
affordable housing,0,0,0,0,1,0,0,1
affordable solutions,0,0,0,0,0,1,0,1
afghan lawyer,0,1,0,0,0,0,0,1
africa communities,0,0,0,1,0,0,0,1
africa experts,0,1,0,0,0,0,0,1
africa flee,1,0,0,0,0,0,0,1
africa kerry,0,1,0,0,0,0,0,1
africa kyiv,0,0,0,1,0,0,0,1
africa meets,0,1,0,0,0,0,0,1
africa south,0,1,0,0,0,0,0,1
africa's largest,0,0,1,0,0,0,0,1
africa's southbridge,0,1,0,0,0,0,0,1
african american,0,0,0,0,1,0,0,1
african countries,1,0,0,0,0,0,0,1
african ice,0,1,0,0,0,0,0,1
african mountains,0,1,0,0,0,0,0,1
african soil,1,0,0,0,0,0,0,1
african south,0,0,1,0,0,0,0,1
afrose jahan,0,0,0,0,0,1,0,1
afternoon hurricane,0,1,0,0,0,0,0,1
afternoon news,0,1,0,0,0,0,0,1
afternoon stitt,0,1,0,0,0,0,0,1
afternoon sun,0,1,0,0,0,0,0,1
afternoon wind,0,0,0,1,0,0,0,1
afterward crews,0,0,0,1,0,0,0,1
ag exports,0,0,0,1,0,0,0,1
ag giant,0,0,0,1,0,0,0,1
aga president,0,0,0,0,1,0,0,1
aga's senior,0,0,0,0,1,0,0,1
aga's ted,0,0,0,0,1,0,0,1
agassiz baroum,0,0,1,0,0,0,0,1
age gender,0,0,0,0,1,0,0,1
age population,0,1,0,0,0,0,0,1
aged women,0,0,0,0,0,1,0,1
agencies involved,1,0,0,0,0,0,0,1
agencies piedmont,0,1,0,0,0,0,0,1
agencies survey,1,0,0,0,0,0,0,1
agencies tonkonogy,0,1,0,0,0,0,0,1
agency appreciates,0,0,0,0,0,0,1,1
agency charged,0,0,0,0,1,0,0,1
agency chooses,0,0,0,1,0,0,0,1
agency dispensing,0,0,0,0,0,0,1,1
agency expects,0,0,0,0,0,1,0,1
agency fema,1,0,0,0,0,0,0,1
agency field,1,0,0,0,0,0,0,1
agency florida's,1,0,0,0,0,0,0,1
agency governing,1,0,0,0,0,0,0,1
agency habeck,0,0,1,0,0,0,0,1
agency jaycee,0,0,0,0,0,0,1,1
agency launched,1,0,0,0,0,0,0,1
agency level,0,0,0,1,0,0,0,1
agency oxfam,1,0,0,0,0,0,0,1
agency recently,0,0,0,0,1,0,0,1
agency remained,1,0,0,0,0,0,0,1
agency reported,1,0,0,0,0,0,0,1
agency started,0,0,1,0,0,0,0,1
agency struggled,0,0,0,0,1,0,0,1
agency walaa,0,0,0,0,1,0,0,1
agency's ceo,0,1,0,0,0,0,0,1
agency's history,0,0,0,0,0,0,1,1
agency's internal,0,0,0,0,0,0,1,1
agency's recent,0,0,0,0,0,0,1,1
agency's requirements,0,0,1,0,0,0,0,1
agenda activists,0,0,0,1,0,0,0,1
agenda bit,0,1,0,0,0,0,0,1
agents who've,0,0,0,1,0,0,0,1
ages roughly,0,1,0,0,0,0,0,1
aggressive cracking,0,0,0,0,1,0,0,1
aggressive scientists,0,0,1,0,0,0,0,1
aggressive target,0,1,0,0,0,0,0,1
aggressively enforce,1,0,0,0,0,0,0,1
aging neighbors,0,1,0,0,0,0,0,1
aging populations,0,1,0,0,0,0,0,1
aging sewer,0,0,0,1,0,0,0,1
aging water,0,0,0,1,0,0,0,1
ago climate,1,0,0,0,0,0,0,1
ago droz,0,0,0,0,1,0,0,1
ago experts,0,0,0,0,1,0,0,1
ago federal,0,0,0,1,0,0,0,1
ago growing,0,1,0,0,0,0,0,1
ago ice,0,1,0,0,0,0,0,1
ago john,0,0,0,0,0,1,0,1
ago kentucky,1,0,0,0,0,0,0,1
ago melting,0,1,0,0,0,0,0,1
ago money,0,1,0,0,0,0,0,1
ago pinaki,0,0,0,0,1,0,0,1
ago prices,1,0,0,0,0,0,0,1
ago reflects,0,1,0,0,0,0,0,1
ago slack,0,0,0,1,0,0,0,1
ago toyota,0,0,0,0,1,0,0,1
ago van,0,0,1,0,0,0,0,1
ago water,1,0,0,0,0,0,0,1
ago wmo,1,0,0,0,0,0,0,1
ago wow.he's,0,1,0,0,0,0,0,1
ago yeah,0,0,0,1,0,0,0,1
agree change,1,0,0,0,0,0,0,1
agreement america,0,1,0,0,0,0,0,1
agreement goals,0,0,0,0,0,1,0,1
agreement heading,0,1,0,0,0,0,0,1
agreement promises,0,0,0,0,0,1,0,1
agreement requires,0,0,0,0,0,1,0,1
agreement seeks,0,0,0,0,1,0,0,1
agricultural acres,0,0,0,0,0,1,0,1
agricultural cycle,0,0,0,0,0,1,0,1
agricultural departments,0,1,0,0,0,0,0,1
agricultural economy,1,0,0,0,0,0,0,1
agricultural fields,0,0,0,0,0,1,0,1
agricultural footprint,0,1,0,0,0,0,0,1
agricultural loss,0,1,0,0,0,0,0,1
agricultural methods,0,0,0,0,0,0,1,1
agricultural output,0,0,0,0,0,1,0,1
agricultural research,0,0,0,1,0,0,0,1
agricultural runoff,0,0,0,0,0,1,0,1
agricultural waste,0,1,0,0,0,0,0,1
agricultural workers,0,0,0,0,0,1,0,1
agriculture appropriations,0,0,0,1,0,0,0,1
agriculture bronte,0,1,0,0,0,0,0,1
agriculture coalition,0,0,0,0,0,0,1,1
agriculture commitment,0,1,0,0,0,0,0,1
agriculture depend,0,1,0,0,0,0,0,1
agriculture encompasses,0,1,0,0,0,0,0,1
agriculture fisheries,0,0,1,0,0,0,0,1
agriculture hydropower,0,0,0,0,0,0,1,1
agriculture industries,0,0,0,0,1,0,0,1
agriculture initiatives,0,1,0,0,0,0,0,1
agriculture kerry,0,1,0,0,0,0,0,1
agriculture march,0,1,0,0,0,0,0,1
agriculture market,0,1,0,0,0,0,0,1
agriculture natural,1,0,0,0,0,0,0,1
agriculture organization,0,0,0,0,0,1,0,1
agriculture panels,0,0,0,0,0,0,1,1
agriculture programs,0,1,0,0,0,0,0,1
agriculture recently,1,0,0,0,0,0,0,1
agriculture relies,0,0,0,0,0,1,0,1
agriculture scientists,0,1,0,0,0,0,0,1
agriculture sheikh,0,1,0,0,0,0,0,1
agriculture water,0,1,0,0,0,0,0,1
agriculture's ability,0,0,0,1,0,0,0,1
agriculture's stark,0,0,0,1,0,0,0,1
agustín carbó,0,0,0,1,0,0,0,1
aha moment,0,1,0,0,0,0,0,1
ahead ryan,0,0,0,0,1,0,0,1
ahmad gharabli,0,1,0,0,0,0,0,1
ahmad left,0,1,0,0,0,0,0,1
ahmed khan,0,0,0,0,0,1,0,1
ai calculated,0,0,0,1,0,0,0,1
ai figures,0,0,0,1,0,0,0,1
aid agency,1,0,0,0,0,0,0,1
aid efforts,0,1,0,0,0,0,0,1
aid projects,0,1,0,0,0,0,0,1
aid workers,0,1,0,0,0,0,0,1
aid.martí npr's,0,0,0,0,0,1,0,1
ailing parents,0,0,0,0,1,0,0,1
ailsa chang,0,0,0,0,1,0,0,1
aiqun yu,0,0,0,0,0,1,0,1
air balloon,0,0,0,0,1,0,0,1
air boats,1,0,0,0,0,0,0,1
air coming,0,0,0,0,0,1,0,1
air days,0,0,0,0,1,0,0,1
air emissions,0,0,0,0,1,0,0,1
air escaped,0,0,0,1,0,0,0,1
air exacerbated,0,0,0,0,0,1,0,1
air friendlier,0,0,0,0,1,0,0,1
air holds,0,0,0,1,0,0,0,1
air inversions,0,0,0,0,1,0,0,1
air lots,1,0,0,0,0,0,0,1
air moving,0,0,0,0,0,1,0,1
air observers,0,0,1,0,0,0,0,1
air pollutant,0,0,0,1,0,0,0,1
air prisons,0,0,0,0,0,1,0,1
air pump,0,0,0,0,0,1,0,1
air regulator,0,1,0,0,0,0,0,1
air rises,0,0,0,0,0,0,1,1
air traffic,0,0,1,0,0,0,0,1
airboat zipped,1,0,0,0,0,0,0,1
airfield pump,0,1,0,0,0,0,0,1
airlift response,0,0,0,0,0,1,0,1
airlines finally,0,0,1,0,0,0,0,1
airlines offer,0,0,0,0,1,0,0,1
airplane emissions,0,0,1,0,0,0,0,1
airplane hangar,0,0,0,0,1,0,0,1
airplane ticket,0,0,0,0,1,0,0,1
airport makes,0,0,1,0,0,0,0,1
airport measured,0,0,0,0,1,0,0,1
airport runways,0,0,1,0,0,0,0,1
airport supports,0,0,1,0,0,0,0,1
airport's hands,0,0,1,0,0,0,0,1
airports balloons,0,0,0,0,1,0,0,1
airports caleigh,0,0,1,0,0,0,0,1
airports miami,0,0,0,0,1,0,0,1
airports sitting,0,0,1,0,0,0,0,1
aisle colorful,1,0,0,0,0,0,0,1
akkad's imagined,0,0,0,1,0,0,0,1
akter regular,0,0,0,0,0,1,0,1
akter's text,0,0,0,0,0,1,0,1
al jabar,0,0,0,0,0,1,0,1
al nahyan,0,0,0,1,0,0,0,1
al polite,0,1,0,0,0,0,0,1
al qaida,0,0,0,0,1,0,0,1
al qaim,1,0,0,0,0,0,0,1
al waheidi,0,0,1,0,0,0,0,1
ala yesterday,0,0,0,1,0,0,0,1
alabama adam,0,1,0,0,0,0,0,1
alabama destroyed,0,0,0,0,0,1,0,1
alabama fought,0,0,1,0,0,0,0,1
alabama news,0,0,1,0,0,0,0,1
alabama regulators,0,0,1,0,0,0,0,1
alabama residents,0,0,1,0,0,0,0,1
alabama teachers,0,0,1,0,0,0,0,1
alabama western,0,0,0,0,0,1,0,1
alabama's capital,0,0,1,0,0,0,0,1
alabama's residents,0,0,1,0,0,0,0,1
alabamians bitched,0,0,1,0,0,0,0,1
alam kqed,0,0,0,0,0,1,0,1
alamos n.m,1,0,0,0,0,0,0,1
alan anderson,0,0,0,0,1,0,0,1
alan harris,0,1,0,0,0,0,0,1
alarm bell,1,0,0,0,0,0,0,1
alarm sounded,0,0,0,1,0,0,0,1
alarming conflict,0,0,0,1,0,0,0,1
alaska anna,0,0,0,0,0,1,0,1
alaska bank,0,0,0,0,0,1,0,1
alaska called,0,0,0,0,0,1,0,1
alaska lawmakers,0,0,0,0,0,1,0,1
alaska living,0,0,0,0,0,1,0,1
alaska producing,0,0,0,0,0,1,0,1
alaska's bipartisan,0,0,0,0,0,1,0,1
alaska's congressional,0,0,0,0,0,1,0,1
alaska's cook,0,0,0,0,0,1,0,1
alaska's national,0,0,0,0,0,1,0,1
alaskan congressional,0,0,0,0,0,1,0,1
alaskan landscapes,0,0,0,0,0,1,0,1
alaskan leaders,0,0,0,0,0,1,0,1
alaskan village,0,0,0,1,0,0,0,1
alden meyer,0,0,0,1,0,0,0,1
aldo buttazzoni,0,0,0,0,0,1,0,1
aleaziz immigration,0,0,1,0,0,0,0,1
alec giffen,1,0,0,0,0,0,0,1
aleikum peace,0,0,0,0,0,1,0,1
alejandro mayorkas,0,1,0,0,0,0,0,1
alerces national,0,1,0,0,0,0,0,1
alert u.n,0,1,0,0,0,0,0,1
aleutian islands,0,0,0,1,0,0,0,1
alex brandon,0,1,0,0,0,0,0,1
alex drewenskus,0,0,0,0,0,1,0,1
alex haraus,0,0,0,0,0,1,0,1
alex howdy,1,0,0,0,0,0,0,1
alexander hoehn,0,0,0,0,1,0,0,1
alexander suwanee,0,0,0,0,1,0,0,1
alfalfa farmers,0,0,0,0,1,0,0,1
algae companions,0,1,0,0,0,0,0,1
algeria morocco,0,1,0,0,0,0,0,1
algeria niger,0,1,0,0,0,0,0,1
ali abakar,0,0,1,0,0,0,0,1
ali asghar,1,0,0,0,0,0,0,1
alice harrison,0,0,0,1,0,0,0,1
alien guys,0,0,0,0,1,0,0,1
alien landing,0,0,0,0,0,0,1,1
aligning indigenous,0,0,1,0,0,0,0,1
alisa petrosova,0,0,1,0,0,0,0,1
aliso canyon,1,0,0,0,0,0,0,1
alison bridger,0,0,0,1,0,0,0,1
alive milam,0,0,0,0,0,0,1,1
alive national,1,0,0,0,0,0,0,1
alive.for npr,1,0,0,0,0,0,0,1
allegedly downplaying,0,0,0,1,0,0,0,1
alleges matrix,0,0,1,0,0,0,0,1
allen npr,0,1,0,0,0,0,0,1
allen reports,0,1,0,0,0,0,0,1
alliance yellowhammer,0,0,1,0,0,0,0,1
allied activities,0,1,0,0,0,0,0,1
allison lynn,0,0,1,0,0,0,0,1
allison rinker,0,0,0,0,1,0,0,1
allison ross,0,0,1,0,0,0,0,1
allocated issues,0,0,0,0,0,1,0,1
allowances basically,0,0,0,0,1,0,0,1
allowed farmers,1,0,0,0,0,0,0,1
allowed inside,0,1,0,0,0,0,0,1
allowing companies,0,1,0,0,0,0,0,1
allowing people,1,0,0,0,0,0,0,1
alok sharma,0,0,0,1,0,0,0,1
alongside mankani,1,0,0,0,0,0,0,1
alongside power,0,0,0,0,1,0,0,1
alongside threatening,0,0,1,0,0,0,0,1
alpha handed,1,0,0,0,0,0,0,1
alpha metallurgical,1,0,0,0,0,0,0,1
alpha mines,1,0,0,0,0,0,0,1
alpha offloaded,1,0,0,0,0,0,0,1
alpha's properties,1,0,0,0,0,0,0,1
alphabets arabic,0,1,0,0,0,0,0,1
alphonso dennis,0,0,0,1,0,0,0,1
alpine base,0,0,0,0,1,0,0,1
alpine meadows,0,0,0,0,1,0,0,1
alpine research,0,1,0,0,0,0,0,1
altaf qadri,0,0,0,0,0,1,0,1
altamaha sound,0,1,0,0,0,0,0,1
alternate facility,0,1,0,0,0,0,0,1
alternative food,0,1,0,0,0,0,0,1
alternative minkara,0,0,0,0,1,0,0,1
alternative npr's,0,1,0,0,0,0,0,1
alternative supplies,0,1,0,0,0,0,0,1
alternatives tom,0,0,0,0,1,0,0,1
alters world,0,0,0,1,0,0,0,1
althea wolf,0,0,0,0,0,1,0,1
altitude himalayan,0,1,0,0,0,0,0,1
altitude snow,0,0,0,1,0,0,0,1
altitude species,0,0,1,0,0,0,0,1
alto city,0,0,0,0,1,0,0,1
alto community,0,0,0,0,1,0,0,1
altogether laurie,1,0,0,0,0,0,0,1
aluminum pods,0,0,0,1,0,0,0,1
aluminum smelters,0,0,0,1,0,0,0,1
álvarez chanca,0,0,0,0,0,1,0,1
amadou disembarked,1,0,0,0,0,0,0,1
amar bhattacharya,0,1,0,0,0,0,0,1
amassing top,0,0,0,0,0,1,0,1
amazing biodiversity,0,0,1,0,0,0,0,1
amazing friend,0,1,0,0,0,0,0,1
amazing job,0,1,0,0,0,0,0,1
amazon city,0,1,0,0,0,0,0,1
amazon congo,0,0,0,0,0,0,1,1
amazon region,0,0,0,0,0,0,1,1
amazon river,0,1,0,0,0,0,0,1
amazon voted,0,1,0,0,0,0,0,1
ambient water,0,1,0,0,0,0,0,1
ambitious action,0,1,0,0,0,0,0,1
ambitious emission,0,1,0,0,0,0,0,1
ambitious national,0,0,0,0,1,0,0,1
ambitious project,0,0,0,1,0,0,0,1
ambitious projects,0,0,0,1,0,0,0,1
ambitious rapid,0,1,0,0,0,0,0,1
ambitious reporting,1,0,0,0,0,0,0,1
ambitious result,0,0,0,1,0,0,0,1
ambitious tailpipe,0,0,0,0,0,1,0,1
ambitious target,0,0,0,0,1,0,0,1
ambitious technology,0,0,0,0,1,0,0,1
ambitious test,0,0,0,0,1,0,0,1
ambitious vehicle,0,0,0,0,0,1,0,1
amble slowly,0,0,0,1,0,0,0,1
ameno told,0,1,0,0,0,0,0,1
america analyst,0,0,1,0,0,0,0,1
america europe,0,1,0,0,0,0,0,1
america joanne,0,0,0,1,0,0,0,1
america kirk,0,0,0,0,1,0,0,1
america responsible,0,0,0,0,1,0,0,1
america retreated,0,1,0,0,0,0,0,1
america's fastest,0,0,0,0,1,0,0,1
america's giving,0,0,0,1,0,0,0,1
america's grain,0,1,0,0,0,0,0,1
america's greenhouse,0,0,0,0,1,0,0,1
america's nile,1,0,0,0,0,0,0,1
america's power,0,0,0,0,1,0,0,1
america's recorded,0,0,0,1,0,0,0,1
america's skies,0,0,0,0,1,0,0,1
america's vice,0,0,0,1,0,0,0,1
american allies,0,1,0,0,0,0,0,1
american association,0,0,0,0,0,1,0,1
american chemistry,1,0,0,0,0,0,0,1
american citizenship,0,0,0,1,0,0,0,1
american civil,0,0,0,1,0,0,0,1
american council,0,0,0,0,0,0,1,1
american countries,0,0,0,0,0,1,0,1
american exceptionalism,0,0,0,1,0,0,0,1
american farmland,0,0,0,1,0,0,0,1
american free,0,0,0,0,0,1,0,1
american friends,0,0,0,0,0,1,0,1
american gas,0,0,0,0,1,0,0,1
american legislative,0,0,0,0,1,0,0,1
american medical,0,0,0,0,1,0,0,1
american meteorological,0,0,0,0,0,1,0,1
american neighborhood,0,0,0,0,1,0,0,1
american petroleum,0,1,0,0,0,0,0,1
american rescue,0,0,0,1,0,0,0,1
american tire,1,0,0,0,0,0,0,1
american tourist,0,0,0,0,1,0,0,1
american trucking,0,0,0,0,0,1,0,1
american war,0,0,0,1,0,0,0,1
americans drive,1,0,0,0,0,0,0,1
americans favorite,0,1,0,0,0,0,0,1
americans view,0,0,0,1,0,0,0,1
amid extreme,0,0,0,0,1,0,0,1
amid limited,1,0,0,0,0,0,0,1
amid mounting,1,0,0,0,0,0,0,1
amid rising,0,0,0,1,0,0,0,1
amid stormy,1,0,0,0,0,0,0,1
amid uncertainty,0,0,0,0,0,1,0,1
amidst cranes,0,1,0,0,0,0,0,1
amidst puddles,0,1,0,0,0,0,0,1
amina khan,0,0,0,1,0,0,0,1
amino acids,0,1,0,0,0,0,0,1
ammonia nh3,0,1,0,0,0,0,0,1
ammonium phosphate,1,0,0,0,0,0,0,1
amneh minkara,0,0,0,0,1,0,0,1
amor mottley,0,1,0,0,0,0,0,1
amount emitted,0,0,0,1,0,0,0,1
amount relative,0,1,0,0,0,0,0,1
amperex technology,0,1,0,0,0,0,0,1
amstutz whitney,0,0,0,1,0,0,0,1
amtrak shares,1,0,0,0,0,0,0,1
amtrak's 30th,1,0,0,0,0,0,0,1
ana aguilar,1,0,0,0,0,0,0,1
ana perez,0,1,0,0,0,0,0,1
anadolu agency,0,0,0,0,0,1,0,1
analog sms,0,0,0,0,0,1,0,1
analysis comparing,0,0,0,1,0,0,0,1
analysis eric,1,0,0,0,0,0,0,1
analysis explains,0,1,0,0,0,0,0,1
analysis found,0,1,0,0,0,0,0,1
analysis mayor,0,0,0,0,1,0,0,1
analysis noaa,0,0,0,1,0,0,0,1
analysis planning,0,0,0,1,0,0,0,1
analysis predictions,0,0,0,0,0,1,0,1
analyst julien,0,0,1,0,0,0,0,1
analyst kalina,0,0,1,0,0,0,0,1
analysts hope,0,0,0,0,1,0,0,1
analytics bill,0,0,0,1,0,0,0,1
analyzed exxon's,0,0,0,1,0,0,0,1
analyzed findings,0,0,1,0,0,0,0,1
analyzed movie,0,0,1,0,0,0,0,1
analyzed satellite,0,0,1,0,0,0,0,1
analyzing 3d,1,0,0,0,0,0,0,1
ancestors grew,1,0,0,0,0,0,0,1
anchorage sen,0,0,0,0,0,1,0,1
anchored buoys,0,0,0,0,0,1,0,1
ancient greeks,0,0,0,0,0,1,0,1
ancona operations,1,0,0,0,0,0,0,1
anda executive,0,0,0,0,0,1,0,1
andersen executive,0,1,0,0,0,0,0,1
andersen head,0,1,0,0,0,0,0,1
andrea gutierrez,0,0,1,0,0,0,0,1
andrea pook,0,0,0,1,0,0,0,1
andrea wojnar,0,1,0,0,0,0,0,1
andrew derocher,0,0,1,0,0,0,0,1
andrew deutz,0,0,1,0,0,0,0,1
andrew pepsico's,0,1,0,0,0,0,0,1
andrew regalado,0,0,0,0,0,1,0,1
andrew shields,1,0,0,0,0,0,0,1
andros island,0,1,0,0,0,0,0,1
andy barron,0,1,0,0,0,0,0,1
andy beshear's,0,1,0,0,0,0,0,1
anecdotes affect,0,0,1,0,0,0,0,1
anemones hanging,0,0,0,0,1,0,0,1
anemones swimming,0,0,0,0,1,0,0,1
angela weiss,0,0,0,1,0,0,0,1
angeles caused,0,0,0,0,1,0,0,1
angeles county's,0,0,0,0,1,0,0,1
angeles diverted,0,0,0,0,1,0,0,1
angeles fire,0,0,0,0,1,0,0,1
angeles met,0,0,0,0,0,1,0,1
angeles multiday,0,0,0,0,1,0,0,1
angeles oakland,0,0,0,0,0,1,0,1
angeles recorded,0,0,0,0,1,0,0,1
angeles residents,0,0,0,0,0,1,0,1
angeles times,0,0,0,1,0,0,0,1
angeles water,0,0,0,1,0,0,0,1
angelo dicaro,0,0,0,0,0,1,0,1
anger running,0,0,0,1,0,0,0,1
angry public,0,0,0,0,1,0,0,1
animal cell,0,1,0,0,0,0,0,1
animal component,0,1,0,0,0,0,0,1
animal explains,0,1,0,0,0,0,0,1
animal feeding,0,1,0,0,0,0,0,1
animal intestines,0,1,0,0,0,0,0,1
animal lives,0,1,0,0,0,0,0,1
animal protein,0,1,0,0,0,0,0,1
animal sanctuaries,0,1,0,0,0,0,0,1
animal shelters,0,1,0,0,0,0,0,1
animal sounds,1,0,0,0,0,0,0,1
animal's body,0,1,0,0,0,0,0,1
animals communicating,1,0,0,0,0,0,0,1
animals confront,0,0,0,0,0,1,0,1
animals infect,0,0,0,0,0,1,0,1
animals oladele,0,0,0,0,0,1,0,1
animals people,0,1,0,0,0,0,0,1
animals president,0,0,0,0,0,1,0,1
animals shelter,0,0,0,0,0,1,0,1
animated creations,0,1,0,0,0,0,0,1
anime style,0,0,0,0,0,1,0,1
anjali fears,0,0,0,0,1,0,0,1
anjali's family,0,0,0,0,1,0,0,1
anlleyn venegas,1,0,0,0,0,0,0,1
anna marciano,0,0,0,1,0,0,0,1
anna threw,0,1,0,0,0,0,0,1
annarita mariotti,0,0,0,0,0,1,0,1
annenberg foundation,0,0,1,0,0,0,0,1
announced closures,0,1,0,0,0,0,0,1
announced earlier,0,0,0,0,0,1,0,1
announced future,0,0,0,0,0,1,0,1
announced investment,0,0,0,0,0,1,0,1
announced megan,0,0,0,1,0,0,0,1
announced monday,0,0,0,0,0,1,0,1
announced plans,0,0,1,0,0,0,0,1
announced tuesday,1,0,0,0,0,0,0,1
announced yesterday,1,0,0,0,0,0,0,1
announcement drew,0,0,0,0,0,1,0,1
annual aerial,0,0,1,0,0,0,0,1
annual autumn,1,0,0,0,0,0,0,1
annual basis,0,1,0,0,0,0,0,1
annual bridge,0,0,0,1,0,0,0,1
annual budget,0,0,0,0,0,0,1,1
annual costs,0,1,0,0,0,0,0,1
annual deaths,0,0,0,0,1,0,0,1
annual financing,0,0,1,0,0,0,0,1
annual floods,0,0,0,0,0,1,0,1
annual global,0,1,0,0,0,0,0,1
annual greenhouse,1,0,0,0,0,0,0,1
annual heavy,0,0,0,0,1,0,0,1
annual march,0,0,0,1,0,0,0,1
annual poll,0,0,0,1,0,0,0,1
annual record,0,0,0,0,1,0,0,1
annual report,0,1,0,0,0,0,0,1
annual united,0,0,0,1,0,0,0,1
annually taking,0,1,0,0,0,0,0,1
anomalous temperatures,0,0,0,0,1,0,0,1
anonymous users,0,0,0,0,0,1,0,1
answer explains,0,1,0,0,0,0,0,1
answer npr's,0,0,0,0,1,0,0,1
answered questions,0,0,0,1,0,0,0,1
answers sound,0,0,0,0,0,1,0,1
antagonizing russia,0,0,0,1,0,0,0,1
antarctic peninsula's,0,1,0,0,0,0,0,1
antarctic sunset,0,1,0,0,0,0,0,1
antarctic whales,0,1,0,0,0,0,0,1
antarctica scientists,0,1,0,0,0,0,0,1
antarctica's thwaites,0,0,0,0,1,0,0,1
anthony gardrea,0,0,0,1,0,0,0,1
anthony leiserowitz,0,0,0,1,0,0,0,1
anthropogenic climate,0,0,0,0,0,1,0,1
anti climate,0,0,0,0,1,0,0,1
anti defamation,0,0,0,0,0,1,0,1
anti human,0,0,0,0,0,1,0,1
anti life,0,0,0,0,0,1,0,1
anti solar,0,0,0,0,1,0,0,1
antibiotics gasoline,0,0,1,0,0,0,0,1
anticipated development,0,1,0,0,0,0,0,1
anticipated meeting,0,1,0,0,0,0,0,1
antoinette serrato,0,0,0,0,0,1,0,1
antonia roybal,1,0,0,0,0,0,0,1
antonio hueso,0,0,0,0,0,0,1,1
antonio lopez,0,0,0,0,1,0,0,1
antony blinken,0,0,0,0,1,0,0,1
anvil shaped,0,0,0,0,0,1,0,1
anxiety started,0,1,0,0,0,0,0,1
anymore flood,1,0,0,0,0,0,0,1
anyone's gas,0,0,0,1,0,0,0,1
ap file,0,0,1,0,0,0,0,1
ap reports,0,0,0,1,0,0,0,1
ap rescuers,1,0,0,0,0,0,0,1
apartment building,0,1,0,0,0,0,0,1
apocalyptic climate,0,0,0,0,0,0,1,1
app called,0,0,0,1,0,0,0,1
app gasbuddy,1,0,0,0,0,0,0,1
appalachian artisan,0,1,0,0,0,0,0,1
appalachian media,0,1,0,0,0,0,0,1
appalachian mountains,0,1,0,0,0,0,0,1
appalchian school,0,1,0,0,0,0,0,1
appeared sensitive,0,0,0,0,0,1,0,1
appears cooler,0,0,0,1,0,0,0,1
appears designed,0,0,0,0,1,0,0,1
appears ready,0,0,0,0,1,0,0,1
applauding england's,0,0,0,1,0,0,0,1
applause lines,1,0,0,0,0,0,0,1
appliance makers,0,0,0,0,1,0,0,1
appliance people,0,0,0,1,0,0,0,1
appliance real,0,0,0,1,0,0,0,1
appliances kiki,0,1,0,0,0,0,0,1
appliances organizations,0,0,0,0,1,0,0,1
applied nutrition,0,1,0,0,0,0,0,1
applied pressure,0,0,0,0,1,0,0,1
applies specifically,0,0,0,1,0,0,0,1
appointment adding,0,0,0,1,0,0,0,1
appointment affect,0,0,0,1,0,0,0,1
appointment merrick,0,0,0,1,0,0,0,1
appointment noted,0,0,0,1,0,0,0,1
appointment underscores,0,0,0,1,0,0,0,1
appreciable length,0,0,0,0,0,1,0,1
approach chaturvedi,0,0,0,0,1,0,0,1
approach finding,0,1,0,0,0,0,0,1
approaches florida,0,1,0,0,0,0,0,1
approaching average,0,0,0,1,0,0,0,1
approaching tipping,0,1,0,0,0,0,0,1
appropriated funding,0,1,0,0,0,0,0,1
appropriations subcommittee,0,0,0,1,0,0,0,1
approval rating,1,0,0,0,0,0,0,1
approval tuesday,0,0,0,0,0,1,0,1
approval willow,0,0,0,0,0,1,0,1
approvals including,0,1,0,0,0,0,0,1
approve massive,0,0,0,0,0,1,0,1
approve willow,0,0,0,0,0,1,0,1
approved mealworms,0,0,0,0,0,1,0,1
approving renewable,0,0,0,0,1,0,0,1
approximately 120ft,0,0,0,0,0,1,0,1
approximately age,0,0,0,0,1,0,0,1
approximately double,0,0,0,0,1,0,0,1
approximately half,0,0,0,0,1,0,0,1
april julie,0,0,0,0,0,1,0,1
april los,0,0,1,0,0,0,0,1
april marcio,0,0,1,0,0,0,0,1
apryl marie,0,0,1,0,0,0,0,1
aquatic ecosystems,0,0,0,0,0,1,0,1
aquatic life,0,1,0,0,0,0,0,1
aquatic preserve,1,0,0,0,0,0,0,1
aquifers california,0,0,0,0,0,1,0,1
aquifers underground,0,0,0,0,0,1,0,1
arab bank,0,1,0,0,0,0,0,1
arabian peninsula,0,0,0,1,0,0,0,1
arabian peninsula's,0,0,0,1,0,0,0,1
arabic drift,0,1,0,0,0,0,0,1
arabic latin,0,1,0,0,0,0,0,1
arable land,0,0,0,1,0,0,0,1
arachnologist lauren,1,0,0,0,0,0,0,1
arame tall,1,0,0,0,0,0,0,1
arcadia county,1,0,0,0,0,0,0,1
archie contributed,0,0,0,1,0,0,0,1
archipelago olivier,1,0,0,0,0,0,0,1
archipelago rising,1,0,0,0,0,0,0,1
archipelago's electric,0,0,0,1,0,0,0,1
architect designer,0,1,0,0,0,0,0,1
archive housed,0,1,0,0,0,0,0,1
archives córdova,0,0,0,1,0,0,0,1
arctic air,0,0,0,0,1,0,0,1
arctic alaska,0,0,0,0,0,1,0,1
arctic arctic,0,0,1,0,0,0,0,1
arctic chill,0,0,0,0,1,0,0,1
arctic coasts,0,0,1,0,0,0,0,1
arctic ground,0,1,0,0,0,0,0,1
arctic ice,0,0,0,1,0,0,0,1
arctic indigenous,0,0,1,0,0,0,0,1
arctic outer,0,0,0,0,0,1,0,1
arctic reflect,0,0,1,0,0,0,0,1
arctic snap,0,0,0,0,1,0,0,1
arctic warming,0,0,1,0,0,0,0,1
arctic wednesday,0,0,0,1,0,0,0,1
area's climate,0,1,0,0,0,0,0,1
area's population,1,0,0,0,0,0,0,1
area's soil,0,1,0,0,0,0,0,1
arena crowd,0,1,0,0,0,0,0,1
argentina's los,0,1,0,0,0,0,0,1
argonne national,0,1,0,0,0,0,0,1
argues hybrids,0,0,0,0,1,0,0,1
arguments framed,0,0,0,1,0,0,0,1
ari daniel,0,0,0,0,0,1,0,1
arie kruglanski,0,0,0,1,0,0,0,1
aristotle wrote,0,0,0,0,0,1,0,1
ariz drive,0,0,0,0,1,0,0,1
ariz justin,0,0,0,0,0,1,0,1
arizona california,0,0,0,0,0,1,0,1
arizona department,0,0,0,0,1,0,0,1
arizona facing,0,0,0,0,1,0,0,1
arizona farmers,1,0,0,0,0,0,0,1
arizona greens,1,0,0,0,0,0,0,1
arizona plan,0,0,0,1,0,0,0,1
arizona politicians,0,0,0,0,1,0,0,1
arizona project,1,0,0,0,0,0,0,1
arizona saturday,0,0,0,0,1,0,0,1
arizona university,0,1,0,0,0,0,0,1
arizona utah,0,0,0,0,0,1,0,1
arizona's colorado,0,0,0,0,1,0,0,1
arizona's groundwater,0,0,0,0,1,0,0,1
arizona's rules,0,0,0,0,1,0,0,1
ark residents,0,0,0,0,0,0,1,1
arkansas capital,0,0,0,0,0,0,1,1
arkansas louisiana,0,0,0,0,0,1,0,1
arkansas spawned,0,1,0,0,0,0,0,1
arlington national,0,0,0,0,1,0,0,1
armed conflicts,0,1,0,0,0,0,0,1
armed guards,0,1,0,0,0,0,0,1
armored fighting,0,0,0,1,0,0,0,1
armored personnel,0,0,0,1,0,0,0,1
armored vehicles,0,0,0,1,0,0,0,1
arms dealers,0,0,0,1,0,0,0,1
army police,1,0,0,0,0,0,0,1
army's mission,0,0,1,0,0,0,0,1
arnold covers,0,0,1,0,0,0,0,1
aronczyk similar,0,0,0,1,0,0,0,1
arrange travel,0,1,0,0,0,0,0,1
arrest crews,0,0,0,1,0,0,0,1
arriba ballpark,0,1,0,0,0,0,0,1
arrival peter,0,1,0,0,0,0,0,1
arrival signifies,0,1,0,0,0,0,0,1
arrive in.this,0,1,0,0,0,0,0,1
arrived shortly,0,0,0,0,0,1,0,1
art facility,0,0,0,1,0,0,0,1
art installation,0,1,0,0,0,0,0,1
art kimberly,1,0,0,0,0,0,0,1
art projects,0,1,0,0,0,0,0,1
art subsurface,1,0,0,0,0,0,0,1
art test,0,1,0,0,0,0,0,1
art trapped,0,0,0,0,1,0,0,1
art walaa,0,0,0,0,1,0,0,1
article air,0,0,0,0,1,0,0,1
article headlines,0,0,0,1,0,0,0,1
article published,0,0,0,1,0,0,0,1
article's lead,0,0,0,1,0,0,0,1
articles reports,0,0,0,0,0,0,1,1
articles videos,0,0,0,0,1,0,0,1
artificial rinks,0,0,0,0,1,0,0,1
artificial turf,0,0,0,1,0,0,0,1
artificially low,0,0,0,0,1,0,0,1
artillery fire,0,0,0,1,0,0,0,1
artisan center,0,1,0,0,0,0,0,1
artisans documentary,0,1,0,0,0,0,0,1
artist's hands,0,0,0,1,0,0,0,1
artistic community,0,1,0,0,0,0,0,1
artistic education,0,1,0,0,0,0,0,1
artists educators,0,1,0,0,0,0,0,1
artists wrestling,0,0,0,1,0,0,0,1
arts commission,0,1,0,0,0,0,0,1
arts degree,0,1,0,0,0,0,0,1
arts education,0,1,0,0,0,0,0,1
arts festival,0,1,0,0,0,0,0,1
arts including,0,0,0,0,1,0,0,1
arts trust,0,1,0,0,0,0,0,1
artwork vandalism,0,0,1,0,0,0,0,1
arugula kale,0,0,0,1,0,0,0,1
asap sachs,0,0,1,0,0,0,0,1
asefaw berhe,0,0,1,0,0,0,0,1
asghar wrestled,1,0,0,0,0,0,0,1
ashland maine,1,0,0,0,0,0,0,1
ashley macmillan,0,0,0,0,0,0,1,1
ashore releases,0,0,0,0,0,1,0,1
asia home,0,0,0,0,0,0,1,1
asia south,0,1,0,0,0,0,0,1
asmeret asefaw,0,0,1,0,0,0,0,1
asparagus brown,0,1,0,0,0,0,0,1
aspen colo,0,0,0,0,0,0,1,1
aspirations overshadowing,0,0,0,0,1,0,0,1
assembled world,0,1,0,0,0,0,0,1
assembly lines,0,0,0,0,0,1,0,1
assembly plant,0,0,0,0,0,1,0,1
assess atlantic,0,0,0,0,1,0,0,1
assess climate,1,0,0,0,0,0,0,1
assessing weather,0,1,0,0,0,0,0,1
asset managers,0,1,0,0,0,0,0,1
assigning values,0,0,0,0,1,0,0,1
assignment spend,1,0,0,0,0,0,0,1
assistance local,0,0,0,0,1,0,0,1
assistant gm,1,0,0,0,0,0,0,1
assistant law,1,0,0,0,0,0,0,1
associate curator,0,0,0,1,0,0,0,1
associates refused,0,0,1,0,0,0,0,1
association aga,0,0,0,0,1,0,0,1
association called,0,0,0,1,0,0,0,1
association ema,0,0,1,0,0,0,0,1
association issued,0,0,0,1,0,0,0,1
association labels,0,0,0,0,1,0,0,1
association president,0,0,0,0,0,1,0,1
association warns,0,0,0,0,1,0,0,1
asthma chronic,0,0,0,1,0,0,0,1
asthma wrote,0,0,0,0,1,0,0,1
astronomical sum,0,1,0,0,0,0,0,1
asylum immigration,0,0,1,0,0,0,0,1
atchison levee,1,0,0,0,0,0,0,1
ate insects,0,0,0,0,0,1,0,1
atelier crenn,0,1,0,0,0,0,0,1
athletes safe,0,0,0,0,1,0,0,1
athletic tracks,0,1,0,0,0,0,0,1
atlantic american,0,0,0,0,0,1,0,1
atlantic coastline,0,1,0,0,0,0,0,1
atlantic council's,0,0,0,1,0,0,0,1
atlantic hurricane,0,1,0,0,0,0,0,1
atlantic sargassum,0,0,0,0,0,1,0,1
atlantic storms,0,0,0,0,1,0,0,1
atlantic white,0,1,0,0,0,0,0,1
atmosphere basically,0,1,0,0,0,0,0,1
atmosphere oil,0,1,0,0,0,0,0,1
atmosphere retreat,0,0,0,0,0,0,1,1
atmospheric data,0,0,0,0,1,0,0,1
atmospheric moisture,1,0,0,0,0,0,0,1
atmospheric physicists,0,0,1,0,0,0,0,1
atmospheric pressure,0,0,0,1,0,0,0,1
atmospheric processes,0,0,0,0,0,1,0,1
atmospheric science,1,0,0,0,0,0,0,1
atmospheric waves,0,0,0,1,0,0,0,1
atomic energy,0,0,0,1,0,0,0,1
atop concrete,0,0,0,0,0,1,0,1
atop sandbags,0,0,0,0,0,1,0,1
attack brown's,1,0,0,0,0,0,0,1
attack immigrants,1,0,0,0,0,0,0,1
attack patients,0,1,0,0,0,0,0,1
attack solar,0,0,0,0,1,0,0,1
attacks prevents,0,0,1,0,0,0,0,1
attacks renewable,0,0,1,0,0,0,0,1
attempted company,0,0,0,1,0,0,0,1
attended past,0,1,0,0,0,0,0,1
attendees walk,0,1,0,0,0,0,0,1
attending government,0,0,0,0,1,0,0,1
attention earlier,0,0,0,1,0,0,0,1
attention paid,0,1,0,0,0,0,0,1
attorney arguing,0,0,0,0,0,1,0,1
attorney general's,0,0,0,1,0,0,0,1
attract finance,0,1,0,0,0,0,0,1
attract millions,0,0,1,0,0,0,0,1
attractive houser,0,0,0,0,1,0,0,1
attractive projects,0,1,0,0,0,0,0,1
attribution difficult,0,0,0,0,0,1,0,1
attribution studies,0,1,0,0,0,0,0,1
atypical practice,0,0,1,0,0,0,0,1
atypical snowfall,0,0,0,0,1,0,0,1
aubrey npr,0,1,0,0,0,0,0,1
aubrey reports,0,1,0,0,0,0,0,1
auburn wig,1,0,0,0,0,0,0,1
auckland region,0,0,0,0,1,0,0,1
auction starting,0,0,0,0,1,0,0,1
audience responses,0,0,0,0,0,0,1,1
audiences responses,0,0,0,0,0,0,1,1
audio engineers,0,1,0,0,0,0,0,1
audio recording,0,0,0,0,0,1,0,1
audio story,0,0,0,0,1,0,0,1
audrey azoulay,0,1,0,0,0,0,0,1
augment existing,0,0,0,1,0,0,0,1
aument reports,0,0,0,0,0,1,0,1
aunt rain,0,0,0,1,0,0,0,1
austin continued,1,0,0,0,0,0,0,1
austin howard,0,0,0,0,1,0,0,1
austin meant,0,0,0,0,1,0,0,1
austin texas,0,0,0,0,1,0,0,1
australia australia's,0,1,0,0,0,0,0,1
australia's environment,0,1,0,0,0,0,0,1
australia's federal,0,1,0,0,0,0,0,1
australia's northeast,0,1,0,0,0,0,0,1
australia's previous,0,1,0,0,0,0,0,1
australian based,1,0,0,0,0,0,0,1
australian broadcasting,0,1,0,0,0,0,0,1
australian dollars,0,1,0,0,0,0,0,1
australian officials,0,1,0,0,0,0,0,1
austria offered,0,1,0,0,0,0,0,1
author aiqun,0,0,0,0,0,1,0,1
author eric,0,0,0,0,1,0,0,1
author geoffrey,0,0,0,1,0,0,0,1
author james,1,0,0,0,0,0,0,1
author luciano,0,0,0,1,0,0,0,1
author ruby,0,0,0,0,1,0,0,1
author samuel,0,1,0,0,0,0,0,1
author victor,0,0,0,0,0,1,0,1
author walker,0,0,0,0,0,1,0,1
authoritarian government,0,1,0,0,0,0,0,1
authoritative voices,0,1,0,0,0,0,0,1
authorities announced,1,0,0,0,0,0,0,1
authorities evacuated,0,1,0,0,0,0,0,1
authorities nominated,0,0,0,1,0,0,0,1
authorities relied,0,1,0,0,0,0,0,1
authorities warned,0,1,0,0,0,0,0,1
authority director,0,1,0,0,0,0,0,1
authorized conservation,0,0,0,0,0,0,1,1
authors added,1,0,0,0,0,0,0,1
authors climate,0,0,0,0,1,0,0,1
authors found,0,0,1,0,0,0,0,1
authors hope,0,0,0,0,0,1,0,1
authors npr,0,0,0,1,0,0,0,1
authors project,0,0,0,0,0,1,0,1
authors stopped,0,0,0,0,0,1,0,1
authors write,0,0,0,0,0,1,0,1
authors wrote,0,0,0,0,0,0,1,1
auto capital,0,0,0,0,0,1,0,1
auto plant,0,0,0,0,0,1,0,1
auto sector,0,0,0,0,0,1,0,1
auto showrooms,0,0,0,0,0,1,0,1
automakers continue,0,0,0,0,1,0,0,1
automakers investing,0,0,0,0,1,0,0,1
automatic rolls,0,0,0,1,0,0,0,1
automotive capital,0,0,0,0,0,1,0,1
automotive sector,0,0,0,0,0,1,0,1
autumn pilgrimage,1,0,0,0,0,0,0,1
availability water,0,0,0,0,0,1,0,1
avalanche warning,0,0,0,0,1,0,0,1
avalanches video,0,0,0,1,0,0,0,1
avengers actor,0,0,0,1,0,0,0,1
average american,0,1,0,0,0,0,0,1
average daily,0,0,0,1,0,0,0,1
average elevation,0,0,0,0,0,1,0,1
average global,0,0,1,0,0,0,0,1
average heavy,0,0,0,0,0,1,0,1
average home,1,0,0,0,0,0,0,1
average indian,0,1,0,0,0,0,0,1
average levels,0,0,0,1,0,0,0,1
average price,0,0,0,0,1,0,0,1
average rates,0,0,0,1,0,0,0,1
average snowpack,0,0,0,1,0,0,0,1
average u.s,0,1,0,0,0,0,0,1
average wildfire,1,0,0,0,0,0,0,1
average yearly,1,0,0,0,0,0,0,1
averbeck forest,0,0,0,0,0,0,1,1
avery hill,0,0,0,0,0,1,0,1
aviation airports,0,0,1,0,0,0,0,1
aviation authorities,0,0,0,0,1,0,0,1
avinash persaud,0,1,0,0,0,0,0,1
avoid blackouts,0,0,0,1,0,0,0,1
avoid buying,0,1,0,0,0,0,0,1
avoid coverage,0,0,1,0,0,0,0,1
avoid impulsive,0,0,0,0,1,0,0,1
avoid mountain,0,0,0,0,1,0,0,1
avoid potentially,0,1,0,0,0,0,0,1
avoid predators,1,0,0,0,0,0,0,1
avoidable plastic,0,0,0,1,0,0,0,1
avoided matt,0,0,0,0,1,0,0,1
avoided rolling,0,1,0,0,0,0,0,1
avoided sea,0,0,0,0,0,1,0,1
avoiding risk,0,1,0,0,0,0,0,1
avoiding tilling,0,1,0,0,0,0,0,1
awaited engineering,0,1,0,0,0,0,0,1
awaited step,0,0,0,1,0,0,0,1
awaiting regulatory,0,1,0,0,0,0,0,1
awaits gov,0,0,0,0,1,0,0,1
awards organized,0,1,0,0,0,0,0,1
awards recognize,0,1,0,0,0,0,0,1
awareness raising,0,0,0,0,1,0,0,1
awesome experience,0,0,0,1,0,0,0,1
awesome team,0,0,0,0,0,1,0,1
awful lot,0,1,0,0,0,0,0,1
ayana archie,0,0,0,1,0,0,0,1
ayen bior,0,1,0,0,0,0,0,1
ayesha john,0,1,0,0,0,0,0,1
aziza's aunt,1,0,0,0,0,0,0,1
babanki spoken,0,0,0,1,0,0,0,1
baby aziza,1,0,0,0,0,0,0,1
baby born,0,1,0,0,0,0,0,1
baby grand,0,0,0,0,1,0,0,1
baby picture,0,0,0,0,0,1,0,1
baby samira,1,0,0,0,0,0,0,1
baby sumatran,0,0,1,0,0,0,0,1
baby trout,0,0,0,1,0,0,0,1
baby's fine,1,0,0,0,0,0,0,1
baca vice,1,0,0,0,0,0,0,1
backfire badly,1,0,0,0,0,0,0,1
background overseeing,0,0,0,1,0,0,0,1
backup fossil,0,0,0,0,0,0,1,1
backup fuel,0,0,0,0,1,0,0,1
backup intake,0,1,0,0,0,0,0,1
backwards julia,0,0,0,0,0,0,1,1
bacon frying,1,0,0,0,0,0,0,1
bacon lettuce,0,0,0,0,0,1,0,1
bacteria samples,0,0,0,1,0,0,0,1
bad air,0,0,0,0,1,0,0,1
bad conditions,0,0,0,0,1,0,0,1
bad deluge,0,0,0,1,0,0,0,1
bad development,1,0,0,0,0,0,0,1
bad dust,0,0,0,0,1,0,0,1
bad harvest,0,0,0,0,0,1,0,1
bad idea,1,0,0,0,0,0,0,1
bad lucky,0,0,0,0,1,0,0,1
bad outcomes,0,0,0,0,0,1,0,1
bad projections,0,0,0,0,1,0,0,1
bad shape,0,1,0,0,0,0,0,1
bad storm,1,0,0,0,0,0,0,1
bad storms,0,0,0,1,0,0,0,1
badly damaged,1,0,0,0,0,0,0,1
bag andrew,0,0,1,0,0,0,0,1
bag shaped,1,0,0,0,0,0,0,1
bags hanging,0,1,0,0,0,0,0,1
bags yogurt,1,0,0,0,0,0,0,1
bahama authorities,0,1,0,0,0,0,0,1
bahama island,0,1,0,0,0,0,0,1
bahamas connected,0,1,0,0,0,0,0,1
bahamas including,0,1,0,0,0,0,0,1
bake bread,0,0,0,0,1,0,0,1
baker hide,0,1,0,0,0,0,0,1
balance snow,0,1,0,0,0,0,0,1
balancing scavenging,0,0,0,0,1,0,0,1
bald hillsides,0,0,0,1,0,0,0,1
ball field,0,1,0,0,0,0,0,1
ball field's,0,1,0,0,0,0,0,1
ball rolling,1,0,0,0,0,0,0,1
ballfields basketball,0,1,0,0,0,0,0,1
balloon concerns,0,0,0,0,1,0,0,1
balloon drama,0,0,0,0,1,0,0,1
balloon launch,0,0,0,0,1,0,0,1
balloon sticks,0,0,0,1,0,0,0,1
balloons burst,0,0,0,0,1,0,0,1
balloons destroyed,0,0,0,0,1,0,0,1
balloons launched,0,0,0,0,1,0,0,1
balloons provide,0,0,0,0,1,0,0,1
ballot box,0,1,0,0,0,0,0,1
ballot initiatives,0,0,1,0,0,0,0,1
ballpark estimate,0,0,0,0,1,0,0,1
ballpark evenings,0,1,0,0,0,0,0,1
ballpark's broken,0,1,0,0,0,0,0,1
ballpark's repairs,0,1,0,0,0,0,0,1
ballpark's restoration,0,1,0,0,0,0,0,1
bals policy,0,0,1,0,0,0,0,1
bamboo home,0,0,0,0,0,1,0,1
ban activates,0,0,0,1,0,0,0,1
ban applies,0,0,0,1,0,0,0,1
ban single,0,0,0,1,0,0,0,1
ban surfaced,0,0,0,1,0,0,0,1
bangladesh based,0,0,0,0,0,1,0,1
bangladesh begum's,0,0,0,0,0,1,0,1
bangladesh majida,0,0,0,0,0,1,0,1
bangladesh relies,0,0,0,0,0,1,0,1
bangladesh's biggest,0,0,0,0,0,1,0,1
bangladesh's capital,0,0,0,0,0,1,0,1
bangladesh's emergency,0,0,0,0,0,1,0,1
bangladesh's mobile,0,0,0,0,0,1,0,1
bangladeshi folk,0,0,0,0,0,1,0,1
bangladeshis leave,1,0,0,0,0,0,0,1
bangsamoro autonomous,1,0,0,0,0,0,0,1
banjo player,0,1,0,0,0,0,0,1
bank analyst,0,0,0,0,0,1,0,1
bank arame,1,0,0,0,0,0,0,1
bank leaders,0,0,0,0,0,1,0,1
bank president,1,0,0,0,0,0,0,1
bank shares,0,0,0,0,0,1,0,1
bank spokesperson,1,0,0,0,0,0,0,1
bank targeted,0,0,0,0,0,1,0,1
bank's decision,0,0,0,0,0,1,0,1
banks continue,0,0,0,0,0,1,0,1
banks corporations,0,0,0,0,0,0,1,1
banks inundated,0,0,0,1,0,0,0,1
banks serve,0,0,0,0,0,1,0,1
banks stop,0,0,0,0,0,1,0,1
banks tend,0,1,0,0,0,0,0,1
banks who've,0,0,0,0,0,1,0,1
banks worldwide,0,1,0,0,0,0,0,1
banned single,0,0,0,1,0,0,0,1
banning natural,0,0,0,1,0,0,0,1
banning sales,0,0,0,0,1,0,0,1
bans single,1,0,0,0,0,0,0,1
bapna ceo,0,0,1,0,0,0,0,1
barack obama's,1,0,0,0,0,0,0,1
barakah nuclear,0,0,0,1,0,0,0,1
barbados mia,0,1,0,0,0,0,0,1
barbados prime,0,1,0,0,0,0,0,1
barbara county's,0,0,0,1,0,0,0,1
barbara fire,0,0,0,1,0,0,0,1
barbara impacting,0,0,0,1,0,0,0,1
barbara matt,0,0,0,0,0,1,0,1
barbecue set.farmers,0,1,0,0,0,0,0,1
barber talks,0,1,0,0,0,0,0,1
barclay hope,0,0,1,0,0,0,0,1
barconie liberia,0,0,0,1,0,0,0,1
barconie ph,0,0,0,1,0,0,0,1
bardonecchia italy,0,1,0,0,0,0,0,1
bare eye,1,0,0,0,0,0,0,1
barefoot fisherman,1,0,0,0,0,0,0,1
barely nudged,0,0,0,0,1,0,0,1
barely projected,1,0,0,0,0,0,0,1
barely rains,1,0,0,0,0,0,0,1
barely recognize,0,0,0,0,1,0,0,1
barely surviving,0,0,0,0,1,0,0,1
barhopping friday,0,0,0,0,1,0,0,1
barhopping saturday,0,0,0,0,1,0,0,1
bark mulch,1,0,0,0,0,0,0,1
barnacles gobi,1,0,0,0,0,0,0,1
barnes ap,0,0,0,1,0,0,0,1
barrels daily,0,0,0,0,0,1,0,1
barren desert,0,0,0,0,1,0,0,1
barrier beauties,0,0,0,0,0,0,1,1
barron hide,0,1,0,0,0,0,0,1
barry ostrager,0,0,0,1,0,0,0,1
bars antibiotics,0,0,1,0,0,0,0,1
barua called,0,0,0,0,0,1,0,1
barua explains,0,0,0,0,0,1,0,1
barua's message,0,0,0,0,0,1,0,1
basal melting,0,0,0,0,1,0,0,1
base command,0,1,0,0,0,0,0,1
base defense,0,1,0,0,0,0,0,1
base environmental,0,1,0,0,0,0,0,1
base foul,0,1,0,0,0,0,0,1
base maintenance,0,1,0,0,0,0,0,1
base officials,0,1,0,0,0,0,0,1
base operations,0,1,0,0,0,0,0,1
baseball cap,0,1,0,0,0,0,0,1
baseball sized,1,0,0,0,0,0,0,1
based aaa,1,0,0,0,0,0,0,1
based design,1,0,0,0,0,0,0,1
based diets,0,1,0,0,0,0,0,1
based economist,1,0,0,0,0,0,0,1
based economy,0,0,0,1,0,0,0,1
based egyptian,0,0,0,0,1,0,0,1
based energy,0,0,0,0,1,0,0,1
based firefighter,0,0,1,0,0,0,0,1
based food,0,0,0,0,0,1,0,1
based heating,0,0,0,0,0,0,1,1
based information,0,0,0,0,0,1,0,1
based ingredients,0,1,0,0,0,0,0,1
based interim,0,1,0,0,0,0,0,1
based international,0,0,0,0,0,1,0,1
based internet,1,0,0,0,0,0,0,1
based mama,1,0,0,0,0,0,0,1
based meat,0,1,0,0,0,0,0,1
based national,0,1,0,0,0,0,0,1
based ngo,0,0,0,0,1,0,0,1
based ralston,0,0,0,0,1,0,0,1
based recipe,0,1,0,0,0,0,0,1
based solution,0,1,0,0,0,0,0,1
based solutions,0,1,0,0,0,0,0,1
based start,0,1,0,0,0,0,0,1
based stove,0,0,0,0,1,0,0,1
based study,0,0,0,1,0,0,0,1
based unesco,0,1,0,0,0,0,0,1
baseless claims,0,0,0,0,1,0,0,1
basement checking,0,0,0,1,0,0,0,1
basement friday,0,0,0,0,0,0,1,1
basement mark,1,0,0,0,0,0,0,1
basement u.s,1,0,0,0,0,0,0,1
basic amenities,1,0,0,0,0,0,0,1
basic assistance,0,0,0,0,1,0,0,1
basic electricity,0,1,0,0,0,0,0,1
basic food,0,0,1,0,0,0,0,1
basic idea,1,0,0,0,0,0,0,1
basic infrastructure,0,0,0,1,0,0,0,1
basic issue,0,0,0,1,0,0,0,1
basic physics,0,0,0,0,0,1,0,1
basic practice,0,0,0,1,0,0,0,1
basic sanitation,0,0,0,0,0,1,0,1
basic science,0,1,0,0,0,0,0,1
basically balance,0,0,1,0,0,0,0,1
basically disappearing,0,0,0,0,0,1,0,1
basically everybody's,1,0,0,0,0,0,0,1
basically lost,1,0,0,0,0,0,0,1
basically naked,0,1,0,0,0,0,0,1
basically pollution,0,0,0,0,1,0,0,1
basically raised,0,0,0,1,0,0,0,1
basically refers,0,1,0,0,0,0,0,1
basically throwaways,0,0,0,0,1,0,0,1
basil farms,0,1,0,0,0,0,0,1
basil growing,0,0,0,1,0,0,0,1
basin acres,1,0,0,0,0,0,0,1
basin experienced,1,0,0,0,0,0,0,1
basin governments,0,0,0,1,0,0,0,1
basins pits,0,0,0,1,0,0,0,1
basis boykoff,0,0,0,0,0,0,1,1
basis marciano,0,0,0,1,0,0,0,1
basketball court,0,1,0,0,0,0,0,1
basketball courts,0,1,0,0,0,0,0,1
bat feces,0,0,0,0,0,1,0,1
bathes sea,0,1,0,0,0,0,0,1
bathtub turetsky,0,1,0,0,0,0,0,1
bathtubs enter,0,0,1,0,0,0,0,1
batrawy joins,0,0,0,1,0,0,0,1
batrawy npr,0,0,0,1,0,0,0,1
batrawy reports,0,0,0,1,0,0,0,1
bats bat,0,0,0,0,0,1,0,1
batteries batteries,1,0,0,0,0,0,0,1
batteries king,0,0,1,0,0,0,0,1
batteries millions,0,1,0,0,0,0,0,1
batteries winter,0,1,0,0,0,0,0,1
battery company,0,0,0,0,0,1,0,1
battery electric,0,0,0,0,1,0,0,1
battery maker,0,0,0,0,0,1,0,1
battery manufacturer,0,0,0,0,1,0,0,1
battery manufacturing,0,0,0,0,0,1,0,1
battery market,0,1,0,0,0,0,0,1
battery minerals,0,0,0,0,1,0,0,1
battery powered,0,0,0,0,0,1,0,1
battery production,0,0,0,0,0,1,0,1
battery raw,0,1,0,0,0,0,0,1
battery resources,0,0,0,0,1,0,0,1
battery supply,0,0,0,0,0,1,0,1
battle finally,0,0,0,0,1,0,0,1
battle increasingly,0,0,0,0,0,0,1,1
battle tank,0,0,0,1,0,0,0,1
battle tanks,0,0,0,1,0,0,0,1
battling extreme,0,0,0,1,0,0,0,1
baudet tweeted,0,0,0,0,0,1,0,1
bay cuba,0,0,0,0,1,0,0,1
bay east,1,0,0,0,0,0,0,1
bay facility,0,0,0,0,1,0,0,1
bay home,0,0,1,0,0,0,0,1
bay include,0,0,0,1,0,0,0,1
bay mary,0,0,0,1,0,0,0,1
bay municipal,0,0,0,1,0,0,0,1
bay officials,0,0,0,1,0,0,0,1
bay polar,0,0,1,0,0,0,0,1
bay shore,0,0,0,1,0,0,0,1
bay special,0,0,0,0,0,1,0,1
bay times,0,0,1,0,0,0,0,1
bay's mangroves,1,0,0,0,0,0,0,1
bayou pointe,1,0,0,0,0,0,0,1
bayou southeast,0,1,0,0,0,0,0,1
bayram anna,0,0,0,0,0,1,0,1
bbc reported,0,0,0,0,0,1,0,1
beach chairs,0,1,0,0,0,0,0,1
beach community,1,0,0,0,0,0,0,1
beach county,0,1,0,0,0,0,0,1
beach erosion,0,1,0,0,0,0,0,1
beach hurricane,0,1,0,0,0,0,0,1
beach shelters,0,1,0,0,0,0,0,1
beach tropical,0,1,0,0,0,0,0,1
beach washed,0,1,0,0,0,0,0,1
beach win,1,0,0,0,0,0,0,1
bean plants,1,0,0,0,0,0,0,1
bear capital,0,0,1,0,0,0,0,1
bear cubs,0,0,1,0,0,0,0,1
bear jails,0,0,0,1,0,0,0,1
bear patrols,0,0,0,1,0,0,0,1
bear stands,1,0,0,0,0,0,0,1
beardsley joins,0,1,0,0,0,0,0,1
bearing dengue,1,0,0,0,0,0,0,1
bearing trees,0,0,0,0,0,1,0,1
bears caribou,0,0,0,0,0,1,0,1
bears compared,0,0,1,0,0,0,0,1
bears historically,0,0,0,0,0,1,0,1
bears rely,0,0,1,0,0,0,0,1
bears struggle,0,0,1,0,0,0,0,1
bears walruses,0,0,0,0,0,1,0,1
beattie tugs,0,0,0,1,0,0,0,1
beautiful beaches,0,0,0,1,0,0,0,1
beautiful berms,0,0,0,0,1,0,0,1
beautiful ecosystem,0,0,1,0,0,0,0,1
beautiful happening,0,1,0,0,0,0,0,1
beautiful initiative,0,0,1,0,0,0,0,1
beautiful landscapes,0,0,0,1,0,0,0,1
beautiful neighborhood,1,0,0,0,0,0,0,1
bed dries,0,0,0,0,1,0,0,1
bed kris,1,0,0,0,0,0,0,1
bed sheets,0,0,0,0,0,1,0,1
bed tuesday,0,0,0,1,0,0,0,1
bedrock ecosystem,0,1,0,0,0,0,0,1
bedroom community,0,0,0,0,1,0,0,1
bedroom slum,1,0,0,0,0,0,0,1
bee boxes,0,0,0,1,0,0,0,1
bee expert,0,0,0,1,0,0,0,1
bee habitat,0,0,0,1,0,0,0,1
bee health,0,0,0,1,0,0,0,1
bee waggle,0,0,0,0,0,1,0,1
beef costs,0,0,1,0,0,0,0,1
beeping angrily,0,0,0,1,0,0,0,1
beer snippets,0,1,0,0,0,0,0,1
bees crawl,0,0,0,1,0,0,0,1
bees inside,0,0,0,1,0,0,0,1
bees picked,0,0,0,1,0,0,0,1
bees university,0,0,0,1,0,0,0,1
bees warm,0,0,0,1,0,0,0,1
begin carrying,0,0,0,1,0,0,0,1
begin overflowing,0,0,0,1,0,0,0,1
begin targeting,0,1,0,0,0,0,0,1
begin testing,0,0,0,1,0,0,0,1
begin tonight's,0,1,0,0,0,0,0,1
begin trials,0,0,0,0,0,1,0,1
begins crying,1,0,0,0,0,0,0,1
begum describes,0,0,0,0,0,1,0,1
begum squats,0,0,0,0,0,1,0,1
begum's house,0,0,0,0,0,1,0,1
begum's kitchen,0,0,0,0,0,1,0,1
begum's neighbor,0,0,0,0,0,1,0,1
begum's region,0,0,0,0,0,1,0,1
begun embracing,0,0,1,0,0,0,0,1
begun listening,1,0,0,0,0,0,0,1
begun planting,0,0,1,0,0,0,0,1
begun thinking,0,1,0,0,0,0,0,1
bejeweled bag,1,0,0,0,0,0,0,1
believed lost,0,1,0,0,0,0,0,1
believes lawmakers,0,0,0,0,1,0,0,1
believes lobbying,0,0,1,0,0,0,0,1
believing alabama,0,0,1,0,0,0,0,1
belize agreed,0,0,0,0,1,0,0,1
belize agrees,0,0,0,0,1,0,0,1
bell center.this,1,0,0,0,0,0,0,1
bell owns,0,1,0,0,0,0,0,1
bell studies,0,0,1,0,0,0,0,1
bell's declaration,0,1,0,0,0,0,0,1
belle reed's,0,1,0,0,0,0,0,1
belo monte,0,1,0,0,0,0,0,1
beloved east,0,1,0,0,0,0,0,1
beloved home,0,0,0,1,0,0,0,1
beloved mountain,0,0,1,0,0,0,0,1
belt begins,0,0,0,0,0,1,0,1
ben jerry's,0,1,0,0,0,0,0,1
ben king,0,0,1,0,0,0,0,1
ben shapiro,0,0,0,0,0,1,0,1
ben zaken,0,1,0,0,0,0,0,1
benard mwenja,1,0,0,0,0,0,0,1
bend ore,1,0,0,0,0,0,0,1
bend ranch,0,0,0,0,1,0,0,1
beneath ice,1,0,0,0,0,0,0,1
beneath philadelphia's,1,0,0,0,0,0,0,1
benefits equitably,0,0,0,1,0,0,0,1
benefits passing,1,0,0,0,0,0,0,1
benson polytechnic,0,1,0,0,0,0,0,1
benson project,0,1,0,0,0,0,0,1
benton found,0,0,0,0,1,0,0,1
benton spent,0,0,0,0,1,0,0,1
berginnis executive,0,0,0,1,0,0,0,1
bering sea,0,0,1,0,0,0,0,1
berkeley earth,0,0,0,1,0,0,0,1
berlin airports,0,0,1,0,0,0,0,1
berlin commuter,0,0,1,0,0,0,0,1
berlin hannibal,0,0,1,0,0,0,0,1
berlin schnarr,0,0,1,0,0,0,0,1
bernardino airport,0,0,0,0,0,1,0,1
bernardino county,0,0,0,0,0,1,0,1
bernardino madison,0,0,0,0,0,1,0,1
bernardino riverside,0,0,0,0,1,0,0,1
bernardo flores,0,0,0,0,0,0,1,1
berry afp,0,0,0,0,1,0,0,1
beshear's office,0,1,0,0,0,0,0,1
best.for npr,0,0,0,1,0,0,0,1
beth novey,0,0,0,0,0,0,1,1
beth pratt,0,0,1,0,0,0,0,1
bets duke,0,0,1,0,0,0,0,1
bettina strauss,0,0,1,0,0,0,0,1
betz national,0,1,0,0,0,0,0,1
beverage containers,0,0,0,1,0,0,0,1
beverage corporation,0,1,0,0,0,0,0,1
beverly hills,0,0,1,0,0,0,0,1
bhola killed,0,0,0,0,0,1,0,1
bianca garcia,0,1,0,0,0,0,0,1
biased reporting,0,0,1,0,0,0,0,1
biblical bodies,0,1,0,0,0,0,0,1
bicycle tire,0,0,0,1,0,0,0,1
bidding processes,1,0,0,0,0,0,0,1
bidding requirements,0,1,0,0,0,0,0,1
biden arrived,0,1,0,0,0,0,0,1
biden arrives,0,1,0,0,0,0,0,1
biden attempted,0,1,0,0,0,0,0,1
biden authorized,0,0,0,0,0,1,0,1
biden coming,0,0,0,1,0,0,0,1
biden documents,0,0,0,1,0,0,0,1
biden earlier,0,0,0,0,0,0,1,1
biden era,0,0,0,0,0,0,1,1
biden indonesian,0,0,0,0,1,0,0,1
biden papers,0,0,0,1,0,0,0,1
biden prepares,0,0,0,0,0,1,0,1
biden speaks,0,1,0,0,0,0,0,1
biden told,0,1,0,0,0,0,0,1
biden traveled,1,0,0,0,0,0,0,1
biden understands,0,0,0,0,0,1,0,1
biden visited,0,0,0,0,1,0,0,1
biden won,1,0,0,0,0,0,0,1
biden's announcement,1,0,0,0,0,0,0,1
biden's campaign,0,0,0,0,0,1,0,1
biden's climate,0,0,0,0,0,0,1,1
biden's decision,0,0,0,0,0,1,0,1
biden's effort,0,1,0,0,0,0,0,1
biden's executive,1,0,0,0,0,0,0,1
biden's home,0,0,0,1,0,0,0,1
biden's office,0,0,0,1,0,0,0,1
biden's pledge,0,1,0,0,0,0,0,1
biden's proposed,0,1,0,0,0,0,0,1
biden's trip,1,0,0,0,0,0,0,1
biden's wednesday,1,0,0,0,0,0,0,1
bigger environmental,1,0,0,0,0,0,0,1
bigger fundamental,0,0,0,0,0,1,0,1
bigger lesson,0,0,0,1,0,0,0,1
bigger mammals,0,1,0,0,0,0,0,1
bigger nations,0,1,0,0,0,0,0,1
bigger price,0,0,0,0,1,0,0,1
bigger push,0,1,0,0,0,0,0,1
bigger ralston,0,0,0,0,1,0,0,1
bigger role,0,1,0,0,0,0,0,1
bigger scale,0,1,0,0,0,0,0,1
bigger sources,0,0,0,1,0,0,0,1
bigger trees,1,0,0,0,0,0,0,1
bigger water,0,0,0,0,1,0,0,1
bigger world,0,1,0,0,0,0,0,1
biggest asset,0,0,0,0,0,1,0,1
biggest challenge,0,1,0,0,0,0,0,1
biggest champions,1,0,0,0,0,0,0,1
biggest difference,0,1,0,0,0,0,0,1
biggest economy,0,1,0,0,0,0,0,1
biggest emitter,0,0,0,0,0,1,0,1
biggest emitters,0,1,0,0,0,0,0,1
biggest european,0,0,0,1,0,0,0,1
biggest global,0,0,0,0,1,0,0,1
biggest hope,0,1,0,0,0,0,0,1
biggest hurdle,0,0,0,0,1,0,0,1
biggest jump,1,0,0,0,0,0,0,1
biggest news,0,1,0,0,0,0,0,1
biggest oil,0,0,0,1,0,0,0,1
biggest polluters,0,1,0,0,0,0,0,1
biggest population,0,1,0,0,0,0,0,1
biggest sources,0,1,0,0,0,0,0,1
biggest successes,0,0,1,0,0,0,0,1
biggest tension,0,0,1,0,0,0,0,1
biggest topics,0,0,0,0,0,1,0,1
biggest towns,1,0,0,0,0,0,0,1
biggest trees,0,0,1,0,0,0,0,1
biggest wind,0,0,0,0,1,0,0,1
bike lanes,0,0,0,1,0,0,0,1
biking building,0,0,0,0,0,1,0,1
bilal ahmed,0,0,0,0,0,1,0,1
bildagentur universal,0,0,1,0,0,0,0,1
bill britt,0,0,1,0,0,0,0,1
bill called,0,0,0,1,0,0,0,1
bill gates,0,1,0,0,0,0,0,1
bill hare,0,0,0,1,0,0,0,1
bill hearings,0,0,0,1,0,0,0,1
bill includes,0,0,0,1,0,0,0,1
bill lee,0,0,0,0,0,0,1,1
bill mckibben,0,0,0,0,0,1,0,1
bill reauthorization,0,0,0,1,0,0,0,1
bill requires,0,1,0,0,0,0,0,1
bill rutan,0,0,0,0,0,0,1,1
bill senator,0,0,0,0,0,0,1,1
bill.ximena bustillo,0,0,0,0,0,0,1,1
billfish krill,0,0,0,0,0,1,0,1
billion annual,0,0,1,0,0,0,0,1
billion australian,0,1,0,0,0,0,0,1
billion canadian,0,0,0,0,0,1,0,1
billion carbon,0,0,0,1,0,0,0,1
billion children,0,1,0,0,0,0,0,1
billion climate,0,0,0,0,1,0,0,1
billion contract,0,0,0,1,0,0,0,1
billion developing,0,1,0,0,0,0,0,1
billion euro,0,0,0,1,0,0,0,1
billion facility,0,0,0,0,1,0,0,1
billion fund,0,1,0,0,0,0,0,1
billion gallons,1,0,0,0,0,0,0,1
billion grant,0,0,0,0,0,0,1,1
billion human,0,0,1,0,0,0,0,1
billion living,0,0,1,0,0,0,0,1
billion pledge,0,1,0,0,0,0,0,1
billion population,0,0,1,0,0,0,0,1
billion proposal,0,0,0,0,0,1,0,1
billion specifically,0,1,0,0,0,0,0,1
billion spent,1,0,0,0,0,0,0,1
billion willow,0,0,0,0,0,1,0,1
billionaire garibaldi,0,0,0,0,1,0,0,1
billionth resident,0,1,0,0,0,0,0,1
bills laughter,1,0,0,0,0,0,0,1
bills matrix,0,0,1,0,0,0,0,1
bills ranging,0,0,0,0,1,0,0,1
bills torchinsky,0,0,0,0,1,0,0,1
billy burke,0,0,1,0,0,0,0,1
bin ladin,0,0,0,0,0,1,0,1
bin zayed,0,0,0,1,0,0,0,1
binding framework,0,0,0,0,1,0,0,1
binding global,0,0,1,0,0,0,0,1
binding targets,0,0,0,1,0,0,0,1
binghamton university,0,1,0,0,0,0,0,1
bingler ceo,1,0,0,0,0,0,0,1
bingler's firm,1,0,0,0,0,0,0,1
bins meets,1,0,0,0,0,0,0,1
bio digester,0,1,0,0,0,0,0,1
bio fertilizer,0,1,0,0,0,0,0,1
biodiversity averbeck,0,0,0,0,0,0,1,1
biodiversity conference's,0,0,0,0,1,0,0,1
biodiversity crisis,0,0,1,0,0,0,0,1
biodiversity documents,0,0,1,0,0,0,0,1
biodiversity feeds,0,0,1,0,0,0,0,1
biodiversity nature,0,0,1,0,0,0,0,1
biodiversity projects,0,0,1,0,0,0,0,1
biodiversity protection,0,1,0,0,0,0,0,1
biodiversity resources,0,0,1,0,0,0,0,1
biodiversity sam,0,0,0,0,1,0,0,1
biodiversity scientists,0,0,1,0,0,0,0,1
biodiversity united,0,0,0,0,1,0,0,1
biographical exhibitions,0,1,0,0,0,0,0,1
biological anthropology,0,0,0,0,0,1,0,1
biological mechanisms,0,1,0,0,0,0,0,1
biologically diverse,1,0,0,0,0,0,0,1
biologically healthy,0,0,0,0,1,0,0,1
biologist simon,0,0,0,0,1,0,0,1
biologists biochemists,0,1,0,0,0,0,0,1
biologists talk,0,0,1,0,0,0,0,1
biology professor,0,0,1,0,0,0,0,1
biomass machine,0,1,0,0,0,0,0,1
biomass pellets,0,1,0,0,0,0,0,1
biomedical engineering,0,1,0,0,0,0,0,1
biopsied directly,0,1,0,0,0,0,0,1
biotech firm,0,0,0,1,0,0,0,1
bipartisan congressional,0,0,0,0,0,1,0,1
bipartisan efforts,0,0,0,0,1,0,0,1
birch solar,0,0,0,0,1,0,0,1
bird flu,0,0,0,0,1,0,0,1
bird makes,1,0,0,0,0,0,0,1
birds abigail,0,0,0,0,0,1,0,1
birth rates,0,1,0,0,0,0,0,1
birthplace thousands,0,1,0,0,0,0,0,1
bit benton,0,0,0,0,1,0,0,1
bit disappointed,0,0,0,1,0,0,0,1
bit drier,0,0,0,0,0,0,1,1
bit unusual,0,0,1,0,0,0,0,1
bit warmer,0,0,0,0,0,0,1,1
bit worse,0,0,0,0,0,0,1,1
bitter gourds,0,0,0,0,0,1,0,1
bitton's neighborhood,0,0,0,0,1,0,0,1
black baseball,0,1,0,0,0,0,0,1
black bicycle,0,0,0,1,0,0,0,1
black community,0,0,0,1,0,0,0,1
black granite,0,1,0,0,0,0,0,1
black hawk,0,0,0,0,0,1,0,1
black lung,1,0,0,0,0,0,0,1
black mesh,0,0,0,0,0,1,0,1
black neighborhood,1,0,0,0,0,0,0,1
black objects,0,0,0,0,0,0,1,1
black robe,1,0,0,0,0,0,0,1
black scar,0,1,0,0,0,0,0,1
black tea,1,0,0,0,0,0,0,1
black town,0,0,0,0,0,1,0,1
blackboard holding,0,0,0,1,0,0,0,1
blackboard scrawled,1,0,0,0,0,0,0,1
blackened crater,0,0,1,0,0,0,0,1
blackout analysts,0,0,0,0,1,0,0,1
blackout disaster,0,0,0,0,1,0,0,1
blackouts gripped,0,0,0,0,1,0,0,1
blacktop purple,0,0,0,1,0,0,0,1
blacktop streets,0,0,0,1,0,0,0,1
blade seasonal,0,0,0,0,0,1,0,1
bland joins,0,0,0,1,0,0,0,1
blankets socks,0,0,0,0,1,0,0,1
blast hitting,0,0,1,0,0,0,0,1
blasted past,1,0,0,0,0,0,0,1
blasting debris,0,0,0,1,0,0,0,1
blazing speed,0,1,0,0,0,0,0,1
bleachers replaced,0,1,0,0,0,0,0,1
bleaching coral,0,1,0,0,0,0,0,1
bleak headlines,0,1,0,0,0,0,0,1
bleaker suggested,0,0,1,0,0,0,0,1
bleeding muthogo,1,0,0,0,0,0,0,1
bleeding shock,0,0,0,0,0,1,0,1
blend cultivated,0,1,0,0,0,0,0,1
blended approach,0,1,0,0,0,0,0,1
blended finance,0,1,0,0,0,0,0,1
bless selma,0,0,0,1,0,0,0,1
blessed trinette,0,0,0,0,0,1,0,1
blighted empty,0,0,0,0,1,0,0,1
blinken's trip,0,0,0,0,1,0,0,1
blinken's visit,0,0,0,0,1,0,0,1
blips related,1,0,0,0,0,0,0,1
blizzard warning,0,0,0,0,1,0,0,1
blizzard warnings,0,0,0,0,1,0,0,1
blm managed,0,0,0,0,1,0,0,1
blm published,0,0,0,0,0,1,0,1
blm's revised,0,0,0,0,0,1,0,1
bloc's emissions,0,0,0,0,0,1,0,1
block basement,0,0,0,0,0,0,1,1
block municipalities,0,0,0,1,0,0,0,1
block satellites,0,0,0,1,0,0,0,1
block willow,0,0,0,0,0,1,0,1
blocked language,0,0,1,0,0,0,0,1
blocking production,1,0,0,0,0,0,0,1
blocking streets,0,1,0,0,0,0,0,1
blocks drilling,0,0,0,0,0,1,0,1
blonde girl,1,0,0,0,0,0,0,1
blood play,0,0,0,0,1,0,0,1
blood secretions,0,0,0,0,0,1,0,1
bloody diarrhea,0,0,0,0,0,1,0,1
bloomberg article,0,0,0,0,0,1,0,1
bloomberg opinion,0,0,0,0,0,1,0,1
bloombergnef roughly,0,1,0,0,0,0,0,1
blowing dust,0,0,0,0,1,0,0,1
blue dots,0,0,0,1,0,0,0,1
blue eyes,0,1,0,0,0,0,0,1
blue grass,0,1,0,0,0,0,0,1
blue green,0,0,0,1,0,0,0,1
blue pacific,0,1,0,0,0,0,0,1
blue plastic,1,0,0,0,0,0,0,1
blue recycling,1,0,0,0,0,0,0,1
blue tent,1,0,0,0,0,0,0,1
blue turquoise,0,1,0,0,0,0,0,1
blue water,0,0,0,1,0,0,0,1
blunt chest,0,0,0,1,0,0,0,1
bluntly speaking,0,0,1,0,0,0,0,1
board approach,0,0,0,0,0,0,1,1
board flooding,0,0,0,0,0,1,0,1
board proposed,1,0,0,0,0,0,0,1
board separately,0,0,0,1,0,0,0,1
boasted clients,0,0,1,0,0,0,0,1
boat bus,1,0,0,0,0,0,0,1
boat captain,0,0,0,0,1,0,0,1
boat carrying,0,1,0,0,0,0,0,1
boat experienced,0,0,0,0,1,0,0,1
boat harbor,0,1,0,0,0,0,0,1
boat helping,1,0,0,0,0,0,0,1
boat jostled,1,0,0,0,0,0,0,1
boat journey,0,0,0,0,1,0,0,1
boat ramp,0,1,0,0,0,0,0,1
boat rides,1,0,0,0,0,0,0,1
boat services,1,0,0,0,0,0,0,1
boat strewn,1,0,0,0,0,0,0,1
boat tours,0,1,0,0,0,0,0,1
boat traffic,0,0,0,0,1,0,0,1
boats called,0,0,0,0,1,0,0,1
boats captained,1,0,0,0,0,0,0,1
boats houses,1,0,0,0,0,0,0,1
boats shallow,1,0,0,0,0,0,0,1
boats snowmachines,0,0,0,0,0,1,0,1
bob follansbee,0,0,0,0,0,1,0,1
bob graham,1,0,0,0,0,0,0,1
bob henson,0,0,0,1,0,0,0,1
bob martinez,1,0,0,0,0,0,0,1
bob ramorino,0,0,1,0,0,0,0,1
bobsled chute,0,0,0,1,0,0,0,1
boca raton,0,1,0,0,0,0,0,1
boda bodas,1,0,0,0,0,0,0,1
bodas motorcycle,1,0,0,0,0,0,0,1
bodies begum,0,0,0,0,0,1,0,1
bodies pierre,0,0,1,0,0,0,0,1
bodily fluids,0,0,0,0,0,1,0,1
body aches,0,0,0,0,0,1,0,1
body noaa,0,0,0,0,1,0,0,1
body safoora,1,0,0,0,0,0,0,1
body's organs,0,0,0,0,0,1,0,1
boil water,1,0,0,0,0,0,0,1
boiled egg,0,0,0,1,0,0,0,1
boilers alongside,1,0,0,0,0,0,0,1
boise concrete,1,0,0,0,0,0,0,1
bold ambitious,0,1,0,0,0,0,0,1
bolivar peninsula,0,0,0,0,0,0,1,1
bolsonaro government,0,1,0,0,0,0,0,1
bolsonaro john,0,1,0,0,0,0,0,1
bolsonaro lula,0,0,0,0,0,0,1,1
bolster national,0,0,0,0,0,1,0,1
bolster tree,0,0,1,0,0,0,0,1
bolster water,0,0,0,0,0,1,0,1
bolten told,0,0,1,0,0,0,0,1
bomb cyclone,0,0,0,1,0,0,0,1
bone dry,0,0,1,0,0,0,0,1
bonnie jo,0,0,0,0,0,1,0,1
bonus episodes,0,0,1,0,0,0,0,1
bony fish,0,0,0,0,0,1,0,1
book published,0,0,0,0,0,1,0,1
book sort,0,0,0,0,1,0,0,1
booming central,0,0,0,0,1,0,0,1
booming economy,0,0,0,0,1,0,0,1
booming urban,0,0,0,1,0,0,0,1
boost efforts,0,0,0,0,1,0,0,1
boost investments,0,1,0,0,0,0,0,1
boost national,0,0,0,0,0,1,0,1
boost oil,0,1,0,0,0,0,0,1
boosted heavy,1,0,0,0,0,0,0,1
boosting oil,0,0,0,0,0,1,0,1
boosting production,1,0,0,0,0,0,0,1
boosting regional,0,0,0,0,0,1,0,1
boots pirani,0,1,0,0,0,0,0,1
border communities,0,1,0,0,0,0,0,1
border crossing,0,1,0,0,0,0,0,1
border fear,0,0,1,0,0,0,0,1
border fence,0,1,0,0,0,0,0,1
border hamed,0,0,1,0,0,0,0,1
border illegally,0,1,0,0,0,0,0,1
border management,0,0,1,0,0,0,0,1
border movement,1,0,0,0,0,0,0,1
border policy,0,0,1,0,0,0,0,1
border remains,0,0,1,0,0,0,0,1
border smashed,0,0,0,1,0,0,0,1
border yeah,0,0,1,0,0,0,0,1
border zone,0,1,0,0,0,0,0,1
borders freely,0,1,0,0,0,0,0,1
borders outright,1,0,0,0,0,0,0,1
borders yellen,1,0,0,0,0,0,0,1
boris worm,0,0,0,0,1,0,0,1
born east,0,1,0,0,0,0,0,1
born primed,0,0,0,1,0,0,0,1
borrowed generator,0,0,0,0,1,0,0,1
bosch afp,0,1,0,0,0,0,0,1
boston suburb,0,0,0,0,0,1,0,1
boston warming,0,0,0,0,1,0,0,1
bottle bills,1,0,0,0,0,0,0,1
bottles collected,1,0,0,0,0,0,0,1
bottles people,1,0,0,0,0,0,0,1
bou soppekou,1,0,0,0,0,0,0,1
bought flood,0,0,0,1,0,0,0,1
boulder environmental,0,0,0,0,0,0,1,1
boulder novelty,0,0,0,1,0,0,0,1
bounce cool,0,0,1,0,0,0,0,1
bouncing balls,0,0,0,1,0,0,0,1
bountiful crop,0,1,0,0,0,0,0,1
boutique outfit,0,0,0,0,1,0,0,1
bouys afp,0,0,0,0,0,1,0,1
bovine serum,0,1,0,0,0,0,0,1
bowls cutlery,0,0,0,1,0,0,0,1
box trucks,0,0,0,0,0,1,0,1
box tucked,0,1,0,0,0,0,0,1
boxes heaped,1,0,0,0,0,0,0,1
boxes wooden,0,0,0,1,0,0,0,1
boy nutritional,1,0,0,0,0,0,0,1
boy's mother,1,0,0,0,0,0,0,1
boyfriend lived,0,0,0,0,0,0,1,1
boykoff told,0,0,0,0,0,0,1,1
boys raced,0,1,0,0,0,0,0,1
boys rosensweig,0,1,0,0,0,0,0,1
bp oil,0,1,0,0,0,0,0,1
bp refinery,0,0,0,0,1,0,0,1
bp's stock,0,0,0,0,1,0,0,1
brad martin,1,0,0,0,0,0,0,1
brad pitt,0,0,1,0,0,0,0,1
brad smith,0,1,0,0,0,0,0,1
brad udall,0,0,0,1,0,0,0,1
brad wilson,0,0,0,0,1,0,0,1
bradley fighting,0,0,0,1,0,0,0,1
brady npr,0,0,0,0,1,0,0,1
brady seals,0,0,0,1,0,0,0,1
brady talked,0,0,0,1,0,0,0,1
brain regions,0,0,0,0,1,0,0,1
brakes harder,0,0,0,0,0,1,0,1
branding pressure,0,0,0,0,0,1,0,1
brandon ap,0,1,0,0,0,0,0,1
brandon bell,0,1,0,0,0,0,0,1
brands ranging,0,1,0,0,0,0,0,1
brasch reports,0,1,0,0,0,0,0,1
brave people,0,1,0,0,0,0,0,1
bravely tackle,0,0,1,0,0,0,0,1
brazil deforestation,0,0,0,0,0,0,1,1
brazil eyder,0,0,0,0,1,0,0,1
brazil politically,0,1,0,0,0,0,0,1
brazil reached,0,1,0,0,0,0,0,1
brazil speaking,0,0,1,0,0,0,0,1
brazil's emissions,0,0,0,0,1,0,0,1
brazil's president,0,1,0,0,0,0,0,1
brazil's presidential,0,1,0,0,0,0,0,1
brazilian amazon,0,0,0,0,0,0,1,1
brazilian city,0,1,0,0,0,0,0,1
brazilian green,0,1,0,0,0,0,0,1
breached levees,0,0,0,0,0,1,0,1
bread ostensibly,0,0,0,0,0,1,0,1
breadbasket regions,0,0,1,0,0,0,0,1
break forever,0,1,0,0,0,0,0,1
break kenya,0,1,0,0,0,0,0,1
break mankani,1,0,0,0,0,0,0,1
break top,0,0,0,0,1,0,0,1
breaking ceremony,0,0,0,0,1,0,0,1
breaking point.i,0,0,0,0,1,0,0,1
breaking record,0,0,0,0,1,0,0,1
breast brian,0,1,0,0,0,0,0,1
breast minus,0,1,0,0,0,0,0,1
breath hoping,0,0,0,0,0,1,0,1
breathe wetlands,0,0,1,0,0,0,0,1
breathtaking conflict,0,0,0,1,0,0,0,1
brehman ap,0,0,0,0,1,0,0,1
brenda huerta,0,0,0,0,0,1,0,1
brendan smialowski,0,1,0,0,0,0,0,1
brett fleck,0,0,0,0,1,0,0,1
brett kavanaugh,0,0,0,0,0,1,0,1
brew coffee,0,0,0,1,0,0,0,1
brew meat,0,1,0,0,0,0,0,1
brewery style,0,1,0,0,0,0,0,1
brewing system,0,0,0,1,0,0,0,1
brews strong,0,0,0,0,0,0,1,1
brexit margherita,0,0,0,0,0,1,0,1
brian burgess,0,0,1,0,0,0,0,1
brian humphrey,0,0,0,0,1,0,0,1
brian inganga,1,0,0,0,0,0,0,1
brian moench,0,0,0,0,1,0,0,1
brian o'donnell,0,0,1,0,0,0,0,1
brian rees,0,0,0,0,0,0,1,1
brian wheeler,0,0,0,0,1,0,0,1
briars scrape,1,0,0,0,0,0,0,1
bric dollars,1,0,0,0,0,0,0,1
bric program,1,0,0,0,0,0,0,1
brick houses,0,0,0,1,0,0,0,1
brick phone,0,0,0,0,0,1,0,1
brick phones,0,0,0,0,0,1,0,1
brick plant,1,0,0,0,0,0,0,1
brick school,0,0,0,1,0,0,0,1
brickwork depicting,1,0,0,0,0,0,0,1
bridge crossing,0,0,0,1,0,0,0,1
bridge fuel,0,0,1,0,0,0,0,1
bridgeville delaware,0,0,0,0,0,0,1,1
briefing yesterday,0,0,0,0,0,1,0,1
briefly closed,1,0,0,0,0,0,0,1
briefly cut,1,0,0,0,0,0,0,1
bright future,1,0,0,0,0,0,0,1
bright geometric,1,0,0,0,0,0,0,1
bright orange,0,0,0,0,1,0,0,1
bright red,0,0,0,0,1,0,0,1
bright spot,0,0,0,0,1,0,0,1
bright white,0,0,0,1,0,0,0,1
brimmed wool,0,1,0,0,0,0,0,1
brine flies,0,0,0,0,1,0,0,1
bring demise,0,0,0,0,0,1,0,1
bring heavy,0,0,0,0,1,0,0,1
bring meat,0,1,0,0,0,0,0,1
bring rain,0,0,0,0,0,1,0,1
bring unsheltered,0,0,0,0,1,0,0,1
bring upside,0,1,0,0,0,0,0,1
bring widespread,0,0,0,0,1,0,0,1
bringing damaged,0,1,0,0,0,0,0,1
bringing heavy,0,0,0,1,0,0,0,1
bringing life,0,0,0,0,0,1,0,1
bringing snow,0,0,0,0,0,1,0,1
bringing tomatoes,0,0,0,0,0,1,0,1
brings communities,0,1,0,0,0,0,0,1
brings renewed,0,0,0,1,0,0,0,1
brink municipalities,1,0,0,0,0,0,0,1
brit hanson,0,0,1,0,0,0,0,1
britain tidy,0,0,0,1,0,0,0,1
britain's alok,0,0,0,1,0,0,0,1
british activist,0,1,0,0,0,0,0,1
british authorities,0,0,0,0,0,1,0,1
british climate,0,0,0,0,0,1,0,1
british homes,0,1,0,0,0,0,0,1
british medical,0,1,0,0,0,0,0,1
british nonprofit,0,0,0,1,0,0,0,1
british petroleum,0,1,0,0,0,0,0,1
british prime,0,1,0,0,0,0,0,1
britney schmidt,0,0,0,0,1,0,0,1
britt affirms,0,0,1,0,0,0,0,1
britt alabama,0,0,1,0,0,0,0,1
britt cast,0,0,1,0,0,0,0,1
britt wrote,0,0,1,0,0,0,0,1
bro hey,1,0,0,0,0,0,0,1
broad based,0,0,0,0,0,1,0,1
broad climate,0,1,0,0,0,0,0,1
broad international,0,0,1,0,0,0,0,1
broad range,0,0,0,0,0,1,0,1
broad ruling,0,0,0,0,0,1,0,1
broad street,0,0,0,1,0,0,0,1
broad themes,1,0,0,0,0,0,0,1
broadcaster deutschlandfunk,0,0,1,0,0,0,0,1
broadcaster pat,0,0,0,0,0,1,0,1
broadcaster zdf,0,0,1,0,0,0,0,1
broadcasting corp,0,1,0,0,0,0,0,1
broadcasting's conrad,0,0,0,0,1,0,0,1
broader agenda,0,0,0,0,1,0,0,1
broader budget,0,0,0,0,0,0,1,1
broader effort,0,1,0,0,0,0,0,1
broader goal,0,0,1,0,0,0,0,1
broader region,0,0,0,0,0,1,0,1
broader representation,0,0,0,0,0,1,0,1
broader scientific,0,0,0,1,0,0,0,1
broader view,0,1,0,0,0,0,0,1
broadly ryan,0,1,0,0,0,0,0,1
broadly snow,0,0,1,0,0,0,0,1
broccoli economist,0,0,0,0,0,1,0,1
broke flooded,0,0,0,0,0,1,0,1
broke ground,0,0,0,0,0,1,0,1
broke levees,0,0,0,1,0,0,0,1
broken levees,0,0,0,0,0,1,0,1
broken link,0,1,0,0,0,0,0,1
broken residences,0,0,0,1,0,0,0,1
broken skin,0,0,0,0,0,1,0,1
broker peace,0,1,0,0,0,0,0,1
brokers factories,0,0,0,0,0,1,0,1
bronte wittpenn,0,1,0,0,0,0,0,1
brooklyn bridge,0,0,0,0,1,0,0,1
brother decided,0,1,0,0,0,0,0,1
brother erick,0,0,0,0,1,0,0,1
brother manning,1,0,0,0,0,0,0,1
brother's village,0,0,1,0,0,0,0,1
brothers now.did,0,1,0,0,0,0,0,1
brothers rest,0,1,0,0,0,0,0,1
brought green,0,0,0,1,0,0,0,1
brought heavy,0,0,0,1,0,0,0,1
brought shirtsleeve,0,0,0,1,0,0,0,1
brown chairs,0,1,0,0,0,0,0,1
brown chapel's,0,0,0,1,0,0,0,1
brown rice,0,1,0,0,0,0,0,1
brown sludge,1,0,0,0,0,0,0,1
brown university,0,0,0,1,0,0,0,1
brown water,0,0,0,0,0,1,0,1
brown zemela,1,0,0,0,0,0,0,1
brown's record,1,0,0,0,0,0,0,1
bruce devine,0,0,0,0,1,0,0,1
bruce friedrich,0,1,0,0,0,0,0,1
bruce leads,0,0,0,0,1,0,0,1
bruno oberle,0,1,0,0,0,0,0,1
brush dipped,0,0,1,0,0,0,0,1
brushy fork,1,0,0,0,0,0,0,1
brutal heat,0,0,0,0,0,1,0,1
brutal system,0,0,0,1,0,0,0,1
bryan choctaw,0,1,0,0,0,0,0,1
bryan hill's,0,1,0,0,0,0,0,1
bryant air,0,0,0,0,0,0,1,1
bryce gray,1,0,0,0,0,0,0,1
bubble bursting,1,0,0,0,0,0,0,1
bubbling aquarium,0,0,0,1,0,0,0,1
bucharest romania,0,0,0,1,0,0,0,1
buchele kut,0,0,0,0,1,0,0,1
bucket chain,0,0,1,0,0,0,0,1
bucket list,0,0,0,0,1,0,0,1
buckeye mayor,0,0,0,0,1,0,0,1
buckeye's growth,0,0,0,0,1,0,0,1
buckling roads,0,1,0,0,0,0,0,1
buddy television,0,1,0,0,0,0,0,1
budge cut,1,0,0,0,0,0,0,1
budget bill,0,0,0,1,0,0,0,1
budget deficits,1,0,0,0,0,0,0,1
budget items,0,1,0,0,0,0,0,1
budget proposal,0,0,0,0,0,0,1,1
budget request,0,1,0,0,0,0,0,1
budgets carbon,0,1,0,0,0,0,0,1
buffalo ny,0,0,0,1,0,0,0,1
bug late,0,0,0,0,0,1,0,1
bugs conservative,0,0,0,0,0,1,0,1
bugs lesnik,0,0,0,0,0,1,0,1
bugs proliferated,0,0,0,0,0,1,0,1
bugs set,0,0,0,0,0,1,0,1
build coal,0,0,0,0,1,0,0,1
build consensus,0,0,0,1,0,0,0,1
build existing,0,0,0,1,0,0,0,1
build hydrogen,0,0,1,0,0,0,0,1
build indonesia's,0,0,0,0,1,0,0,1
build models,0,1,0,0,0,0,0,1
build natural,0,0,1,0,0,0,0,1
build piers,0,1,0,0,0,0,0,1
build pipelines,0,0,0,0,1,0,0,1
build reefs,1,0,0,0,0,0,0,1
build roads,0,0,0,0,0,1,0,1
build social,0,1,0,0,0,0,0,1
build solar,0,0,0,0,1,0,0,1
build valeti,0,1,0,0,0,0,0,1
build water,0,0,0,0,0,1,0,1
building advocate,0,1,0,0,0,0,0,1
building blocks,0,0,0,0,0,1,0,1
building cleaner,0,0,0,0,0,1,0,1
building collapse,0,1,0,0,0,0,0,1
building dams,0,0,0,0,0,1,0,1
building doorways,0,1,0,0,0,0,0,1
building flood,0,1,0,0,0,0,0,1
building flooded,0,1,0,0,0,0,0,1
building fossil,0,0,1,0,0,0,0,1
building gas,0,1,0,0,0,0,0,1
building hold,0,0,0,1,0,0,0,1
building homes,0,0,0,0,0,1,0,1
building industry,0,1,0,0,0,0,0,1
building infrastructure,0,0,0,1,0,0,0,1
building instruments,0,1,0,0,0,0,0,1
building manufacturing,0,0,0,0,0,1,0,1
building myer,0,1,0,0,0,0,0,1
building natural,0,0,1,0,0,0,0,1
building pipelines,0,0,0,0,0,1,0,1
building pond,0,0,0,0,0,1,0,1
building putting,0,1,0,0,0,0,0,1
building resilient,1,0,0,0,0,0,0,1
building scenes,0,1,0,0,0,0,0,1
building solar,0,1,0,0,0,0,0,1
building vehicles,0,0,0,0,1,0,0,1
building water,0,1,0,0,0,0,0,1
building's detailed,1,0,0,0,0,0,0,1
buildings buckling,0,1,0,0,0,0,0,1
buildings fallen,1,0,0,0,0,0,0,1
buildings including,1,0,0,0,0,0,0,1
buildings monschauer,0,0,0,0,0,0,1,1
buildings orange,0,1,0,0,0,0,0,1
buildings thornton,1,0,0,0,0,0,0,1
buildings wrote,1,0,0,0,0,0,0,1
built adhiguna,0,0,0,0,1,0,0,1
built environment,0,0,0,1,0,0,0,1
built ultimately,0,0,0,0,1,0,0,1
bukaty ap,0,0,0,0,1,0,0,1
bulbous bluegrass,0,0,0,0,1,0,0,1
bulging shopping,1,0,0,0,0,0,0,1
bulky nokia,0,0,0,0,0,1,0,1
bull toronto,0,1,0,0,0,0,0,1
bulldozers backhoes,1,0,0,0,0,0,0,1
bulldozers focused,0,1,0,0,0,0,0,1
bulldozers plowed,0,0,0,0,0,0,1,1
bumpy road,0,1,0,0,0,0,0,1
bunk beds,0,0,0,0,0,1,0,1
buontha ap,0,1,0,0,0,0,0,1
buoys offshore,0,0,0,0,0,1,0,1
burbank airport,0,0,0,0,1,0,0,1
burbank orlando,0,1,0,0,0,0,0,1
burden residents,0,0,0,0,0,1,0,1
bureaucratic morass,0,1,0,0,0,0,0,1
burgeoning population,0,1,0,0,0,0,0,1
burger adds,0,0,0,0,1,0,0,1
burger executive,0,0,0,0,1,0,0,1
burger obsessed,0,1,0,0,0,0,0,1
burgess write,0,0,1,0,0,0,0,1
burgess writes,0,0,1,0,0,0,0,1
burgess wrote,0,0,1,0,0,0,0,1
burial ceremonies,0,0,0,0,0,1,0,1
buried bodies,1,0,0,0,0,0,0,1
buried deep,1,0,0,0,0,0,0,1
burn additional,1,0,0,0,0,0,0,1
burn fossil,0,1,0,0,0,0,0,1
burn gas,0,0,0,1,0,0,0,1
burned coal,1,0,0,0,0,0,0,1
burned trees,0,0,0,0,0,0,1,1
burner consumed,0,0,0,0,1,0,0,1
burner designs,0,0,0,0,1,0,0,1
burner development,0,0,0,0,1,0,0,1
burner kitchen,0,0,0,0,1,0,0,1
burner thermo,0,0,0,0,1,0,0,1
burners cleaner,0,0,0,1,0,0,0,1
burners cost,0,0,0,0,1,0,0,1
burners emit,0,0,0,1,0,0,0,1
burning cow,0,1,0,0,0,0,0,1
burning heat,0,0,0,0,0,0,1,1
burning industrial,1,0,0,0,0,0,0,1
burning natural,0,0,0,0,1,0,0,1
burning oil,1,0,0,0,0,0,0,1
burning peatlands,0,0,0,0,0,0,1,1
burning stoves,0,0,0,1,0,0,0,1
burns dried,0,0,0,0,0,1,0,1
burns extrapolations,0,0,0,0,0,0,1,1
burns fossil,0,0,0,0,1,0,0,1
burns found,0,0,0,0,0,0,1,1
burns natural,1,0,0,0,0,0,0,1
burns told,0,0,0,0,0,0,1,1
bus investments,0,0,0,0,0,0,1,1
bus service,1,0,0,0,0,0,0,1
bus stops,0,0,0,0,1,0,0,1
buses curriculum,0,1,0,0,0,0,0,1
buses shoved,0,1,0,0,0,0,0,1
bushmeat diet,0,0,0,0,0,1,0,1
business decisions,0,1,0,0,0,0,0,1
business investment,0,0,0,0,0,1,0,1
business leaders,0,0,1,0,0,0,0,1
business model,0,0,0,0,1,0,0,1
business plans,0,0,1,0,0,0,0,1
business stories,0,1,0,0,0,0,0,1
business ventures,0,1,0,0,0,0,0,1
business.for mike,0,1,0,0,0,0,0,1
businesses bob,0,0,0,0,0,1,0,1
businesses damaged,0,1,0,0,0,0,0,1
businesses president,0,0,0,0,0,0,1,1
businesses shaw,0,0,1,0,0,0,0,1
businesses splintered,0,0,0,0,0,0,1,1
businessman elon,1,0,0,0,0,0,0,1
bussing migrants,0,1,0,0,0,0,0,1
bustillo jonathan,0,0,0,0,0,0,1,1
bustillo npr,0,0,0,0,0,0,1,1
bustling city,0,1,0,0,0,0,0,1
busy holiday,0,0,1,0,0,0,0,1
busy jetty,1,0,0,0,0,0,0,1
busy month,0,0,0,0,0,0,1,1
busy ports,0,0,0,0,0,1,0,1
busy schedule,0,0,0,0,1,0,0,1
busy upscale,0,1,0,0,0,0,0,1
buttazzoni telling,0,0,0,0,0,1,0,1
butter lettuce,0,0,0,0,0,1,0,1
butterflies flying,0,0,1,0,0,0,0,1
buy carbon,0,1,0,0,0,0,0,1
buy electric,0,0,0,1,0,0,0,1
buy fertilizer,1,0,0,0,0,0,0,1
buy firearms,0,0,0,0,1,0,0,1
buy ingredients,0,0,1,0,0,0,0,1
buy ranges,0,0,0,0,1,0,0,1
buyer earlier,1,0,0,0,0,0,0,1
buying carbon,0,1,0,0,0,0,0,1
buying cheap,0,1,0,0,0,0,0,1
buying clothes,0,1,0,0,0,0,0,1
buying hardwood,1,0,0,0,0,0,0,1
buyout program,0,0,0,0,1,0,0,1
buyouts levee,1,0,0,0,0,0,0,1
buyouts provide,1,0,0,0,0,0,0,1
bygone age,1,0,0,0,0,0,0,1
bygone era,1,0,0,0,0,0,0,1
byron donalds,1,0,0,0,0,0,0,1
byu study,0,0,0,0,1,0,0,1
cabinet meeting,0,1,0,0,0,0,0,1
cabinet minister,0,0,1,0,0,0,0,1
cain spokesperson,0,1,0,0,0,0,0,1
cairo ill,0,1,0,0,0,0,0,1
calculates averages,0,0,0,1,0,0,0,1
caldart volunteers,0,0,0,0,0,1,0,1
caldart's president,0,0,0,0,0,1,0,1
caldwell ayen,0,1,0,0,0,0,0,1
caleb jones,0,1,0,0,0,0,0,1
calif decades,0,0,1,0,0,0,0,1
calif eric,0,0,0,1,0,0,0,1
calif john,0,0,0,0,1,0,0,1
calif justin,0,0,0,1,0,0,0,1
calif merced,0,0,0,1,0,0,0,1
calif noah,0,0,0,1,0,0,0,1
calif relentless,0,0,0,1,0,0,0,1
california actively,0,0,0,1,0,0,0,1
california activists,0,0,0,0,0,1,0,1
california agencies,1,0,0,0,0,0,0,1
california berkeley,0,0,0,0,0,1,0,1
california braced,0,0,0,1,0,0,0,1
california causing,0,0,0,0,0,1,0,1
california cities,0,0,0,0,0,1,0,1
california counties,0,0,0,0,1,0,0,1
california cue,0,0,0,0,0,1,0,1
california davis,0,0,0,0,0,1,0,1
california deal,1,0,0,0,0,0,0,1
california depends,0,0,0,0,0,1,0,1
california disaster,0,0,0,0,0,1,0,1
california energy,0,0,0,1,0,0,0,1
california estimates,0,1,0,0,0,0,0,1
california expect,0,0,0,1,0,0,0,1
california extension,0,0,0,0,0,1,0,1
california gov,0,0,1,0,0,0,0,1
california homes,0,0,0,1,0,0,0,1
california hurricanes,0,0,0,0,1,0,0,1
california kenneth,0,0,0,1,0,0,0,1
california laist,0,0,0,0,1,0,0,1
california listen,0,0,0,1,0,0,0,1
california local,0,0,0,1,0,0,0,1
california looked,0,0,0,1,0,0,0,1
california los,0,0,0,0,0,1,0,1
california mario,0,0,1,0,0,0,0,1
california maryland,0,0,0,0,0,1,0,1
california massive,1,0,0,0,0,0,0,1
california meeting,0,0,0,1,0,0,0,1
california merced,0,0,1,0,0,0,0,1
california nevada,0,0,0,0,1,0,0,1
california oregon,0,0,0,0,1,0,0,1
california overnight,0,0,0,1,0,0,0,1
california regional,0,0,1,0,0,0,0,1
california resident,0,0,0,1,0,0,0,1
california santa,0,0,0,0,1,0,0,1
california set,0,0,0,1,0,0,0,1
california specifically,1,0,0,0,0,0,0,1
california standards,0,0,0,0,0,1,0,1
california starting,0,0,0,0,1,0,0,1
california stricter,0,0,1,0,0,0,0,1
california swain,0,0,0,0,0,0,1,1
california tomorrow,0,0,0,1,0,0,0,1
california truck,0,0,0,0,0,1,0,1
california utility,0,0,0,0,1,0,0,1
california valleys,0,0,0,0,1,0,0,1
california water,0,0,0,0,0,1,0,1
california wildlife,0,0,1,0,0,0,0,1
california yeah,0,0,0,0,1,0,0,1
california.jake bittle's,0,0,0,0,1,0,0,1
california's act,0,0,1,0,0,0,0,1
california's aquifers,0,0,0,0,0,1,0,1
california's borders,0,0,0,0,0,1,0,1
california's climate,0,1,0,0,0,0,0,1
california's counties,0,0,0,0,0,1,0,1
california's eastern,0,0,0,0,1,0,0,1
california's extremes,0,0,0,0,0,1,0,1
california's greenhouse,0,0,0,0,0,1,0,1
california's history,0,0,0,1,0,0,0,1
california's inland,0,0,0,0,0,1,0,1
california's largest,0,0,0,1,0,0,0,1
california's major,0,0,0,0,0,1,0,1
california's norman,0,0,1,0,0,0,0,1
california's rainy,0,0,0,0,0,1,0,1
california's reservoirs,0,0,0,0,0,1,0,1
california's response,1,0,0,0,0,0,0,1
california's roads,0,0,0,1,0,0,0,1
california's run,0,0,0,0,0,1,0,1
california's salinas,0,0,0,0,0,1,0,1
california's sierra,0,0,0,0,0,1,0,1
california's storms,0,0,0,1,0,0,0,1
california's truck,0,0,0,0,0,1,0,1
californians prepare,0,0,0,0,1,0,0,1
call alabama,0,0,1,0,0,0,0,1
call demographic,0,1,0,0,0,0,0,1
call global,0,0,0,1,0,0,0,1
call increases,1,0,0,0,0,0,0,1
call natural,0,0,0,0,1,0,0,1
call rivers,0,0,0,1,0,0,0,1
call salad,0,1,0,0,0,0,0,1
call unusual,0,0,0,0,1,0,0,1
callaway associate,0,0,0,0,0,0,1,1
called atmospheric,0,0,0,0,0,1,0,1
called basal,0,0,0,0,1,0,0,1
called bear,0,0,0,1,0,0,0,1
called billion,0,0,0,1,0,0,0,1
called blister,0,0,0,0,0,1,0,1
called bomb,0,0,0,1,0,0,0,1
called brad,0,0,1,0,0,0,0,1
called canopy,0,0,1,0,0,0,0,1
called chesterfield,0,0,0,0,1,0,0,1
called citizens,0,0,0,0,1,0,0,1
called cultivators,0,1,0,0,0,0,0,1
called dawn,0,0,0,1,0,0,0,1
called exxonmobil,0,0,0,1,0,0,0,1
called finger,0,0,0,0,0,1,0,1
called globe,0,0,0,1,0,0,0,1
called gozo,1,0,0,0,0,0,0,1
called green,0,0,0,0,1,0,0,1
called guayule,1,0,0,0,0,0,0,1
called hardin,0,0,0,0,1,0,0,1
called healthier,0,1,0,0,0,0,0,1
called humboldt,0,0,0,0,0,1,0,1
called hydrofluorocarbons,0,0,0,0,0,0,1,1
called hydrophones,1,0,0,0,0,0,0,1
called kapins,0,0,0,0,0,1,0,1
called lava,0,0,0,0,1,0,0,1
called letzte,0,0,1,0,0,0,0,1
called lost,0,0,0,1,0,0,0,1
called low,0,0,0,0,1,0,0,1
called managed,1,0,0,0,0,0,0,1
called melilla,0,1,0,0,0,0,0,1
called memphis,0,1,0,0,0,0,0,1
called microbialites,0,0,0,0,1,0,0,1
called natural,0,0,1,0,0,0,0,1
called neodymium,0,0,0,1,0,0,0,1
called overshoot,0,0,0,1,0,0,0,1
called piedmont,0,1,0,0,0,0,0,1
called pineapple,0,0,0,0,0,1,0,1
called pirogues,0,0,0,0,1,0,0,1
called plans,0,0,0,0,1,0,0,1
called pr100,0,0,0,1,0,0,0,1
called praseodymium,0,0,0,1,0,0,0,1
called precipitation,0,0,0,0,0,0,1,1
called rebecca,0,1,0,0,0,0,0,1
called recyclable,1,0,0,0,0,0,0,1
called resilience,0,0,0,0,1,0,0,1
called rufisque,0,1,0,0,0,0,0,1
called ryugu,0,0,0,0,0,1,0,1
called samson,0,1,0,0,0,0,0,1
called selma,0,0,0,1,0,0,0,1
called shareholder,0,0,0,0,0,0,1,1
called southwest's,0,0,1,0,0,0,0,1
called sponge,0,0,0,0,1,0,0,1
called thermo,0,0,0,0,1,0,0,1
called title,0,1,0,0,0,0,0,1
called tornado,0,0,0,0,0,1,0,1
called weather,0,0,0,0,0,1,0,1
called wetlands,0,1,0,0,0,0,0,1
calling greenpeace's,1,0,0,0,0,0,0,1
calling people,0,0,1,0,0,0,0,1
calling soil,0,0,1,0,0,0,0,1
calls fogel,0,0,1,0,0,0,0,1
calls greenpeace,0,0,0,1,0,0,0,1
calls mankani,1,0,0,0,0,0,0,1
calls social,0,0,0,0,0,1,0,1
callum smith,0,0,0,0,0,0,1,1
calmed slightly,0,0,1,0,0,0,0,1
calmly sets,0,0,0,1,0,0,0,1
caloosahatchee river,1,0,0,0,0,0,0,1
caloric corporation,0,0,0,0,1,0,0,1
camden snow,0,0,0,0,1,0,0,1
camera image,0,0,0,1,0,0,0,1
camera inside,0,0,0,1,0,0,0,1
cameroon persistent,0,0,1,0,0,0,0,1
camilla fenning,0,0,0,0,1,0,0,1
camp called,0,1,0,0,0,0,0,1
camp close,0,0,1,0,0,0,0,1
camp located,0,1,0,0,0,0,0,1
camp mankani,1,0,0,0,0,0,0,1
camp neighbors.she,0,0,1,0,0,0,0,1
camp residents,0,0,1,0,0,0,0,1
campaign ads,1,0,0,0,0,0,0,1
campaign committee,0,0,0,0,1,0,0,1
campaign contribution,1,0,0,0,0,0,0,1
campaign event,1,0,0,0,0,0,0,1
campaign finance,0,0,0,0,1,0,0,1
campaign greenpeace,0,0,0,1,0,0,0,1
campaign materials,0,0,0,0,1,0,0,1
campaign merchandise,0,0,0,1,0,0,0,1
campaign pledges,0,0,0,0,0,1,0,1
campaign promise,0,0,0,0,0,1,0,1
campaign replete,0,0,1,0,0,0,0,1
campaign spitler,0,0,0,1,0,0,0,1
campaign trail,1,0,0,0,0,0,0,1
campaigns advertisements,0,0,1,0,0,0,0,1
campaigns people,0,0,0,0,1,0,0,1
camps boats,0,0,1,0,0,0,0,1
camps john,1,0,0,0,0,0,0,1
campus dining,0,1,0,0,0,0,0,1
campuses communities,1,0,0,0,0,0,0,1
canada afp,0,0,0,0,0,1,0,1
canada hj,0,0,0,0,0,1,0,1
canada hopes,0,0,0,0,0,1,0,1
canada james,0,0,0,0,0,0,1,1
canada offers,0,0,0,0,0,1,0,1
canada polar,0,0,0,1,0,0,0,1
canada sadly,0,1,0,0,0,0,0,1
canada's auto,0,0,0,0,0,1,0,1
canada's capital,0,0,0,0,1,0,0,1
canada's dalhousie,0,0,0,0,1,0,0,1
canada's david,0,0,0,0,0,1,0,1
canada's economy,0,0,0,0,0,1,0,1
canada's federal,0,0,0,0,0,1,0,1
canada's national,0,0,0,0,1,0,0,1
canada's treasured,0,0,0,0,1,0,0,1
canadian aid,1,0,0,0,0,0,0,1
canadian auto,0,0,0,0,0,1,0,1
canadian automobile,0,0,0,0,0,1,0,1
canadian border,0,1,0,0,0,0,0,1
canadian bucket,0,0,0,0,1,0,0,1
canadian dollars,0,0,0,0,0,1,0,1
canadian dream,0,0,0,0,1,0,0,1
canadian prime,0,0,0,0,0,1,0,1
canal ready,0,0,0,0,1,0,0,1
canal running,0,1,0,0,0,0,0,1
canal system,1,0,0,0,0,0,0,1
canals accelerating,0,1,0,0,0,0,0,1
canary yellow,0,0,0,1,0,0,0,1
canberra australia,0,1,0,0,0,0,0,1
cancel classes,0,1,0,0,0,0,0,1
canceled due,0,1,0,0,0,0,0,1
canceled manila's,1,0,0,0,0,0,0,1
canceled mark,0,0,0,0,1,0,0,1
canceling flights,0,0,1,0,0,0,0,1
cancelled excessive,0,0,0,1,0,0,0,1
cancels projects,0,0,0,0,1,0,0,1
cancer causing,0,0,0,0,1,0,0,1
cancer cells,0,0,0,0,0,1,0,1
candelaria chief,0,0,0,0,1,0,0,1
candidates run,0,1,0,0,0,0,0,1
candy bars,0,0,1,0,0,0,0,1
caniparoli told,0,1,0,0,0,0,0,1
canned stuff,0,1,0,0,0,0,0,1
cannon food,0,1,0,0,0,0,0,1
canny ktoo,0,0,0,0,0,1,0,1
canopy ecologist,0,0,1,0,0,0,0,1
canopy partners,0,0,1,0,0,0,0,1
canyon dam,0,1,0,0,0,0,0,1
canyon leak,1,0,0,0,0,0,0,1
canyon road,0,0,1,0,0,0,0,1
canyon wildlife,0,0,1,0,0,0,0,1
canyons carved,0,1,0,0,0,0,0,1
caonillas river,0,1,0,0,0,0,0,1
cap means,0,0,0,0,0,1,0,1
cap pollution,0,0,0,0,1,0,0,1
capacity added,0,0,0,0,1,0,0,1
capacity mcelroy,0,0,0,1,0,0,0,1
cape town,1,0,0,0,0,0,0,1
capillaries crisscrossing,0,0,0,0,0,1,0,1
capita meaning,0,0,0,1,0,0,0,1
capital awareness,0,0,0,0,0,1,0,1
capital commission,0,0,0,0,1,0,0,1
capital congress,1,0,0,0,0,0,0,1
capital construction,0,1,0,0,0,0,0,1
capital dhaka,0,0,0,0,0,1,0,1
capital noticed,0,0,0,0,0,1,0,1
capital outflows,1,0,0,0,0,0,0,1
capital people,0,0,0,0,0,1,0,1
capitalist john,0,1,0,0,0,0,0,1
capitol lawmakers,0,0,0,0,1,0,0,1
capitolist based,0,0,1,0,0,0,0,1
capitolist blasted,0,0,1,0,0,0,0,1
capitolist emails,0,0,1,0,0,0,0,1
capitolist florida,0,0,1,0,0,0,0,1
capitolist ran,0,0,1,0,0,0,0,1
capitolist stands,0,0,1,0,0,0,0,1
capitolist's editor,0,0,1,0,0,0,0,1
capping effort,1,0,0,0,0,0,0,1
capping temperatures,0,1,0,0,0,0,0,1
cappucci meteorologist,0,0,0,0,0,0,1,1
caps paired,0,0,0,0,0,1,0,1
capt stephen,0,1,0,0,0,0,0,1
captain adrian,0,1,0,0,0,0,0,1
captain ryan,1,0,0,0,0,0,0,1
captain scott,0,1,0,0,0,0,0,1
captain warned,1,0,0,0,0,0,0,1
caption africa's,0,1,0,0,0,0,0,1
caption alabama,0,0,1,0,0,0,0,1
caption antarctica,0,1,0,0,0,0,0,1
caption arctic,0,0,0,0,1,0,0,1
caption arizona's,0,0,0,0,1,0,0,1
caption bats,0,0,0,0,0,1,0,1
caption benard,1,0,0,0,0,0,0,1
caption bob,0,0,0,0,0,1,0,1
caption brothers,0,1,0,0,0,0,0,1
caption cambodian,0,0,0,0,0,1,0,1
caption carly,0,0,0,0,1,0,0,1
caption chicken,0,1,0,0,0,0,0,1
caption citizens,0,0,0,0,1,0,0,1
caption contractors,0,1,0,0,0,0,0,1
caption critical,0,0,0,0,0,1,0,1
caption danny,0,1,0,0,0,0,0,1
caption dawn,0,0,0,0,0,1,0,1
caption delegates,0,0,1,0,0,0,0,1
caption demonstrators,0,0,0,1,0,0,0,1
caption desoto,1,0,0,0,0,0,0,1
caption dozens,1,0,0,0,0,0,0,1
caption drag,1,0,0,0,0,0,0,1
caption droz's,0,0,0,0,1,0,0,1
caption electric,0,0,0,0,0,1,0,1
caption emerging,0,0,0,0,1,0,0,1
caption emily,0,1,0,0,0,0,0,1
caption emperor,1,0,0,0,0,0,0,1
caption ethnobotany,0,1,0,0,0,0,0,1
caption evan,0,0,1,0,0,0,0,1
caption farmers,1,0,0,0,0,0,0,1
caption flood,0,0,0,1,0,0,0,1
caption floodwater,0,0,0,0,0,1,0,1
caption florida,0,0,1,0,0,0,0,1
caption fred,0,1,0,0,0,0,0,1
caption gabriella,0,0,0,1,0,0,0,1
caption gandiol,0,1,0,0,0,0,0,1
caption gas,0,0,0,0,1,0,0,1
caption golabari,0,0,0,0,0,1,0,1
caption greta,0,0,0,0,1,0,0,1
caption guet,0,1,0,0,0,0,0,1
caption hail,1,0,0,0,0,0,0,1
caption harold,0,0,0,1,0,0,0,1
caption harper,1,0,0,0,0,0,0,1
caption heat,0,0,0,0,0,0,1,1
caption homeless,0,0,0,0,1,0,0,1
caption jaycee,0,0,0,0,0,0,1,1
caption jeremiah,0,0,0,0,0,0,1,1
caption john,0,0,0,0,1,0,0,1
caption karen,0,0,0,0,1,0,0,1
caption kelna,0,0,0,0,0,1,0,1
caption kenyan,0,1,0,0,0,0,0,1
caption logan,0,1,0,0,0,0,0,1
caption majida,0,0,0,0,0,1,0,1
caption mamadou,0,1,0,0,0,0,0,1
caption managing,1,0,0,0,0,0,0,1
caption melilla,0,1,0,0,0,0,0,1
caption misinformation,0,0,0,0,1,0,0,1
caption misty,0,0,0,0,0,0,1,1
caption nazma,0,0,0,0,0,1,0,1
caption netting,0,0,0,1,0,0,0,1
caption normangeline,0,1,0,0,0,0,0,1
caption nur,0,0,0,0,0,1,0,1
caption nurse,0,0,0,1,0,0,0,1
caption oceans,0,1,0,0,0,0,0,1
caption page,0,0,0,0,1,0,0,1
caption pape,0,0,0,0,1,0,0,1
caption participants,0,0,0,0,0,1,0,1
caption person,0,0,1,0,0,0,0,1
caption phoebe,0,1,0,0,0,0,0,1
caption pinaki,0,0,0,0,1,0,0,1
caption plastic,0,0,1,0,0,0,0,1
caption prema,0,1,0,0,0,0,0,1
caption presidents,0,1,0,0,0,0,0,1
caption protecting,0,1,0,0,0,0,0,1
caption protesters,0,0,0,0,0,1,0,1
caption rangers,0,0,0,0,0,0,1,1
caption recently,0,0,0,1,0,0,0,1
caption remains,1,0,0,0,0,0,0,1
caption roads,0,0,0,1,0,0,0,1
caption rocks,0,0,0,1,0,0,0,1
caption roger,0,0,0,0,1,0,0,1
caption safoora,1,0,0,0,0,0,0,1
caption sandbags,0,1,0,0,0,0,0,1
caption sarah,0,0,0,1,0,0,0,1
caption sayed,0,1,0,0,0,0,0,1
caption scenes,0,1,0,0,0,0,0,1
caption science,0,0,0,1,0,0,0,1
caption scientists,0,1,0,0,0,0,0,1
caption sibley,0,0,0,1,0,0,0,1
caption skiers,0,0,0,1,0,0,0,1
caption slack,0,0,0,1,0,0,0,1
caption slack's,0,0,0,1,0,0,0,1
caption snow,0,0,0,0,1,0,0,1
caption sofía,0,0,0,1,0,0,0,1
caption steam,0,1,0,0,0,0,0,1
caption steve,1,0,0,0,0,0,0,1
caption suhani,0,0,0,0,1,0,0,1
caption sultan,0,0,0,0,0,1,0,1
caption sun,0,0,0,0,0,1,0,1
caption thawing,0,1,0,0,0,0,0,1
caption thunberg,0,0,0,0,1,0,0,1
caption tomato,0,0,0,0,0,1,0,1
caption truck,0,0,1,0,0,0,0,1
caption trucks,0,0,0,0,0,1,0,1
caption u.s,1,0,0,0,0,0,0,1
caption united,0,1,0,0,0,0,0,1
caption unwanted,1,0,0,0,0,0,0,1
caption utility,0,0,1,0,0,0,0,1
caption vanessa,0,1,0,0,0,0,0,1
caption view,0,0,0,0,0,0,1,1
caption virginia,1,0,0,0,0,0,0,1
caption warren,0,1,0,0,0,0,0,1
caption western,1,0,0,0,0,0,0,1
caption wrecked,1,0,0,0,0,0,0,1
captivating residents,0,0,1,0,0,0,0,1
capture rain,0,0,0,0,0,1,0,1
capture technologies,0,0,0,1,0,0,0,1
captured co2,0,0,0,0,0,1,0,1
captures waste,1,0,0,0,0,0,0,1
car buyers,0,0,0,0,1,0,0,1
car hydroplaned,0,0,0,1,0,0,0,1
car living,0,0,0,1,0,0,0,1
car mandate,0,0,0,1,0,0,0,1
car mary,0,1,0,0,0,0,0,1
car producers,0,0,0,0,0,1,0,1
car screeching,0,0,0,0,0,1,0,1
car seat,0,1,0,0,0,0,0,1
car shopper,0,0,0,0,1,0,0,1
car shut,0,0,1,0,0,0,0,1
car trips,0,0,0,0,1,0,0,1
carbó director,0,0,0,1,0,0,0,1
carbon alternatives,0,0,0,0,1,0,0,1
carbon assessments,1,0,0,0,0,0,0,1
carbon biodiversity,0,0,1,0,0,0,0,1
carbon chaturvedi,0,0,0,0,1,0,0,1
carbon climate,1,0,0,0,0,0,0,1
carbon coin,0,1,0,0,0,0,0,1
carbon dicroce,1,0,0,0,0,0,0,1
carbon economy,0,0,0,0,0,1,0,1
carbon free,0,1,0,0,0,0,0,1
carbon fuels,0,0,0,0,1,0,0,1
carbon future,1,0,0,0,0,0,0,1
carbon leaks,0,0,1,0,0,0,0,1
carbon neutrality,0,1,0,0,0,0,0,1
carbon npr's,0,0,0,0,1,0,0,1
carbon operations,1,0,0,0,0,0,0,1
carbon public,0,0,0,0,0,1,0,1
carbon rich,0,1,0,0,0,0,0,1
carbon saving,0,0,0,0,0,1,0,1
carbon savings,1,0,0,0,0,0,0,1
carbon stored,0,1,0,0,0,0,0,1
carbon task,1,0,0,0,0,0,0,1
carbon technologies,1,0,0,0,0,0,0,1
carbon transportation,0,0,0,0,1,0,0,1
carbon ultimately,0,1,0,0,0,0,0,1
carbonic acid,0,0,0,0,0,1,0,1
carcinogens including,0,0,0,0,1,0,0,1
cardboard boxes,0,0,0,1,0,0,0,1
cardiac arrest,0,0,0,1,0,0,0,1
cardinal rule,0,0,1,0,0,0,0,1
cardiology lab,0,1,0,0,0,0,0,1
cardiovascular disease,0,0,0,0,1,0,0,1
care costs,0,1,0,0,0,0,0,1
care pick,0,0,0,0,0,1,0,1
carefully controlled,0,1,0,0,0,0,0,1
carefully vetted,0,1,0,0,0,0,0,1
cari told,0,1,0,0,0,0,0,1
caribbean caused,0,0,0,1,0,0,0,1
caribbean coast,1,0,0,0,0,0,0,1
caribbean island,0,0,0,0,1,0,0,1
caribbean peoples,0,0,0,1,0,0,0,1
caribbean sala,0,1,0,0,0,0,0,1
carl friedrich,0,0,0,1,0,0,0,1
carl lewis,0,1,0,0,0,0,0,1
carla grenell,0,0,0,0,1,0,0,1
carlos fajardo,0,0,0,1,0,0,0,1
carlos giusti,0,0,0,1,0,0,0,1
carlos lopes,1,0,0,0,0,0,0,1
carlos montero,0,1,0,0,0,0,0,1
carlos morales,0,0,1,0,0,0,0,1
carlson laura,0,0,0,0,0,1,0,1
carlyn iverson,0,0,0,0,0,1,0,1
carmakers headquartered,0,0,0,0,0,1,0,1
carmen drahl,0,0,0,0,1,0,0,1
carnival day,0,1,0,0,0,0,0,1
carnival peter,0,1,0,0,0,0,0,1
carnival team,0,1,0,0,0,0,0,1
carolina agencies,0,1,0,0,0,0,0,1
carolina bevin,0,1,0,0,0,0,0,1
carolina coast,0,1,0,0,0,0,0,1
carolina counties,0,0,0,0,1,0,0,1
carolina forecasters,0,1,0,0,0,0,0,1
carolina neighbors,0,1,0,0,0,0,0,1
carolina puerto,0,1,0,0,0,0,0,1
carolina republican,0,1,0,0,0,0,0,1
carolina republicans,0,1,0,0,0,0,0,1
carolina tin,0,1,0,0,0,0,0,1
carolina university,0,1,0,0,0,0,0,1
carolina's lowcountryjay,0,1,0,0,0,0,0,1
carolina's pawleys,1,0,0,0,0,0,0,1
carolina's plan,0,1,0,0,0,0,0,1
carolinas florida,1,0,0,0,0,0,0,1
caroline brehman,0,0,0,0,1,0,0,1
carpenter reports,0,0,0,0,1,0,0,1
carpenter's elk,0,1,0,0,0,0,0,1
carr fire,1,0,0,0,0,0,0,1
carrie happy,0,0,0,1,0,0,0,1
carroll told,0,0,0,0,0,0,1,1
carry infantry,0,0,0,1,0,0,0,1
carry sewage,0,0,0,1,0,0,0,1
carry steam,1,0,0,0,0,0,0,1
carry widespread,0,0,0,0,1,0,0,1
carrying rescued,0,1,0,0,0,0,0,1
carrying soil,0,0,0,1,0,0,0,1
carrying water,0,0,0,0,0,1,0,1
cars china's,0,0,0,0,0,1,0,1
cars drop,0,0,0,0,0,1,0,1
cars flooded,0,1,0,0,0,0,0,1
cars marrying,0,0,0,0,1,0,0,1
cars passing,0,0,1,0,0,0,0,1
cars trains,0,0,0,0,0,1,0,1
carson california,0,0,0,1,0,0,0,1
carson stiff,0,1,0,0,0,0,0,1
cart driver,1,0,0,0,0,0,0,1
cart water,0,0,0,0,0,1,0,1
carter alexander,0,0,0,0,1,0,0,1
carter picked,0,0,0,0,0,1,0,1
carving called,0,1,0,0,0,0,0,1
carving global,0,1,0,0,0,0,0,1
carving olympics,0,1,0,0,0,0,0,1
carving skills,0,1,0,0,0,0,0,1
carving tools,0,1,0,0,0,0,0,1
cary institute,0,0,1,0,0,0,0,1
casamicciola collapsing,0,1,0,0,0,0,0,1
casamicciola feared,0,1,0,0,0,0,0,1
cascade mountains,0,0,0,0,1,0,0,1
cascading climate,0,1,0,0,0,0,0,1
cascading frames,0,0,0,1,0,0,0,1
cascading hazards,0,0,0,1,0,0,0,1
cash infusion,0,1,0,0,0,0,0,1
cash strapped,0,0,0,0,0,1,0,1
cassells graduated,0,1,0,0,0,0,0,1
cast blame,0,0,1,0,0,0,0,1
cast dunn,0,0,1,0,0,0,0,1
castillo ap,1,0,0,0,0,0,0,1
castillo photo,0,1,0,0,0,0,0,1
castro valley,0,0,0,1,0,0,0,1
casual observer,0,0,1,0,0,0,0,1
cat vehicle,0,0,0,0,0,1,0,1
catastrophe risk,0,0,0,0,1,0,0,1
catastrophic climate,0,0,0,0,0,1,0,1
catastrophic consequences,0,0,1,0,0,0,0,1
catastrophic debris,0,0,0,1,0,0,0,1
catastrophic disruptions,0,0,0,0,0,1,0,1
catastrophic event,0,0,0,0,1,0,0,1
catastrophic flood,0,0,0,0,1,0,0,1
catastrophic future,0,0,0,1,0,0,0,1
catastrophic hurricane,0,1,0,0,0,0,0,1
catastrophic language,0,0,0,1,0,0,0,1
catastrophic outcomes,0,1,0,0,0,0,0,1
catastrophic sea,0,1,0,0,0,0,0,1
catch material,0,0,0,1,0,0,0,1
catch rainwater,0,0,0,0,0,1,0,1
catch workers,0,1,0,0,0,0,0,1
catchall absorbing,0,0,0,0,0,1,0,1
catfish farmer,0,0,1,0,0,0,0,1
cathode active,0,0,0,0,0,1,0,1
catholic nation,1,0,0,0,0,0,0,1
cathy day,0,0,0,0,0,0,1,1
catl tells,0,1,0,0,0,0,0,1
cattle compared,0,1,0,0,0,0,0,1
cattle farming,0,0,0,0,0,0,1,1
cattle land,0,1,0,0,0,0,0,1
caught fire,0,0,0,0,1,0,0,1
caught stealing,0,1,0,0,0,0,0,1
caused caused,1,0,0,0,0,0,0,1
caused downstream,0,0,0,0,1,0,0,1
caused energy,0,0,0,0,0,1,0,1
caused flash,0,0,0,1,0,0,0,1
caused flooding,0,0,0,1,0,0,0,1
caused foodborne,0,0,0,0,0,1,0,1
caused levee,0,0,0,0,0,0,1,1
caused massive,0,0,0,0,0,1,0,1
caused unprecedented,0,1,0,0,0,0,0,1
causing billions,0,0,0,1,0,0,0,1
causing carcinogens,0,0,0,0,1,0,0,1
causing catastrophic,0,0,1,0,0,0,0,1
causing damage,0,0,0,0,0,1,0,1
causing debris,0,0,0,1,0,0,0,1
causing destruction,0,0,0,0,0,0,1,1
causing economic,1,0,0,0,0,0,0,1
causing flooding,0,0,0,1,0,0,0,1
causing friction,0,0,0,0,0,1,0,1
causing hundreds,0,0,0,1,0,0,0,1
causing major,0,0,0,1,0,0,0,1
causing permafrost,0,1,0,0,0,0,0,1
causing storm,0,1,0,0,0,0,0,1
causing storms,0,1,0,0,0,0,0,1
causing temperatures,0,1,0,0,0,0,0,1
causing widespread,0,0,0,0,0,1,0,1
caution countries,0,0,0,1,0,0,0,1
cautionary notes,0,1,0,0,0,0,0,1
cautionary tale,0,0,0,0,1,0,0,1
cautionary tales,0,0,0,0,0,1,0,1
cautioned colleagues,0,0,0,0,1,0,0,1
cautious optimism,0,0,0,1,0,0,0,1
cautious robert,0,1,0,0,0,0,0,1
cautiously optimistic,0,1,0,0,0,0,0,1
cavaretta south,0,1,0,0,0,0,0,1
cave bonnie,0,0,0,0,0,1,0,1
cavernous malls,0,0,0,1,0,0,0,1
caves bats,0,0,0,0,0,1,0,1
cavite province,1,0,0,0,0,0,0,1
cbd including,0,0,1,0,0,0,0,1
cbd negotiates,0,0,1,0,0,0,0,1
cbs hide,0,0,1,0,0,0,0,1
cease rapidly,0,0,0,0,1,0,0,1
ceasing development,1,0,0,0,0,0,0,1
cedar key,0,1,0,0,0,0,0,1
cedar rapids,1,0,0,0,0,0,0,1
cedar trees,0,1,0,0,0,0,0,1
ceiling fiona,0,1,0,0,0,0,0,1
celebrate seasonal,0,0,0,0,0,1,0,1
celebrity cat,0,0,1,0,0,0,0,1
celebrity feuds,0,0,0,0,0,1,0,1
celebrity influencer,0,0,1,0,0,0,0,1
celebrity reads,0,0,1,0,0,0,0,1
celery accompanied,0,0,0,0,0,1,0,1
celery covid,0,0,0,0,0,1,0,1
celery grows,0,0,0,0,0,1,0,1
celery harvest,0,0,0,0,0,1,0,1
celest samas,0,0,0,0,1,0,0,1
cell bank,0,1,0,0,0,0,0,1
cell cultured,0,1,0,0,0,0,0,1
cell manufacturing,0,0,0,0,0,1,0,1
cell samples,0,1,0,0,0,0,0,1
cell signals,0,0,0,0,0,1,0,1
cell trucks,0,0,0,0,0,1,0,1
cellphone providers,0,0,0,0,0,1,0,1
cellphone service,1,0,0,0,0,0,0,1
cellphone video,0,0,0,1,0,0,0,1
cells biopsied,0,1,0,0,0,0,0,1
cells cells,0,1,0,0,0,0,0,1
cells multiplying,0,1,0,0,0,0,0,1
cells start,0,1,0,0,0,0,0,1
celsius thresholds,0,1,0,0,0,0,0,1
celsius world,1,0,0,0,0,0,0,1
cement absorbs,0,0,0,1,0,0,0,1
cement factory,0,1,0,0,0,0,0,1
cement production,1,0,0,0,0,0,0,1
cement steel,0,0,0,0,0,1,0,1
cemeteries deepening,1,0,0,0,0,0,0,1
cent petteri,0,1,0,0,0,0,0,1
center appalshop,0,1,0,0,0,0,0,1
center climate,0,0,0,1,0,0,0,1
center earlier,0,1,0,0,0,0,0,1
center jamie,0,1,0,0,0,0,0,1
center left,0,1,0,0,0,0,0,1
center officials,0,1,0,0,0,0,0,1
center opinions,0,1,0,0,0,0,0,1
center stephanie,0,1,0,0,0,0,0,1
center waiting,0,1,0,0,0,0,0,1
center warnings,0,1,0,0,0,0,0,1
center welcoming,0,1,0,0,0,0,0,1
center wrote,0,0,0,0,1,0,0,1
center.this angers,1,0,0,0,0,0,0,1
center's advisory,0,1,0,0,0,0,0,1
center's climate,1,0,0,0,0,0,0,1
center's film,0,1,0,0,0,0,0,1
centigrade warmer,0,1,0,0,0,0,0,1
centimeters farther,0,0,0,0,1,0,0,1
central americans,0,0,1,0,0,0,0,1
central analysis,1,0,0,0,0,0,0,1
central appalachia,0,1,0,0,0,0,0,1
central appalachians,0,0,0,0,1,0,0,1
central auckland,0,0,0,0,1,0,0,1
central caribbean,1,0,0,0,0,0,0,1
central component,0,0,0,0,1,0,0,1
central data,1,0,0,0,0,0,0,1
central europe,0,0,0,1,0,0,0,1
central facility,1,0,0,0,0,0,0,1
central hide,0,0,0,1,0,0,0,1
central michigan,0,0,0,0,0,1,0,1
central park,0,0,0,0,1,0,0,1
central plains,0,0,0,0,0,1,0,1
central plant,1,0,0,0,0,0,0,1
central swath,0,0,0,0,0,1,0,1
centrist campaign,1,0,0,0,0,0,0,1
centuries ago,0,0,1,0,0,0,0,1
centuries mastering,0,0,0,0,1,0,0,1
century average,0,0,0,1,0,0,0,1
century commercial,0,1,0,0,0,0,0,1
century compared,0,1,0,0,0,0,0,1
century congress,0,1,0,0,0,0,0,1
century fortunately,0,0,0,1,0,0,0,1
century melodramatic,0,0,1,0,0,0,0,1
century mines,0,1,0,0,0,0,0,1
century rebecca,0,0,0,1,0,0,0,1
century scientists,0,0,0,1,0,0,0,1
century time,0,0,0,0,0,1,0,1
ceo bob,0,0,1,0,0,0,0,1
ceo bryce,1,0,0,0,0,0,0,1
ceo dan,1,0,0,0,0,0,0,1
ceo eric,0,0,1,0,0,0,0,1
ceo jeff,0,0,1,0,0,0,0,1
ceo mark,0,0,1,0,0,0,0,1
ceo pitts,0,0,1,0,0,0,0,1
ceo scott,0,1,0,0,0,0,0,1
ceo thomas,0,0,1,0,0,0,0,1
ceo title,0,0,0,1,0,0,0,1
ceramic plate,0,0,0,0,1,0,0,1
ceramic plates,0,0,0,0,1,0,0,1
ceraweek conference,0,0,0,0,0,1,0,1
cerebral palsy,1,0,0,0,0,0,0,1
ceremonial dig,0,0,0,0,0,1,0,1
ceremony indonesia's,0,0,0,0,1,0,0,1
certified heat,0,0,0,0,0,0,1,1
chad berginnis,0,0,0,1,0,0,0,1
chad brown,0,1,0,0,0,0,0,1
chad life,0,0,1,0,0,0,0,1
chad niger,0,0,1,0,0,0,0,1
chad's decades,0,0,1,0,0,0,0,1
chad's western,0,0,1,0,0,0,0,1
chaideer mahyuddin,0,0,0,0,0,0,1,1
chain crises,0,0,0,0,0,1,0,1
chain partnership,0,1,0,0,0,0,0,1
chain security,1,0,0,0,0,0,0,1
chain stopping,0,0,0,0,1,0,0,1
chains leading,1,0,0,0,0,0,0,1
chainsaws buzzed,0,0,0,0,0,0,1,1
chair alexander,0,0,0,0,1,0,0,1
chair spoke,0,1,0,0,0,0,0,1
chairman jerome,0,0,0,0,0,1,0,1
chairman klaus,0,0,0,0,0,1,0,1
challenge california,0,0,0,0,0,1,0,1
challenge lopes,1,0,0,0,0,0,0,1
challenge ramorino,0,0,1,0,0,0,0,1
challenges africa,0,1,0,0,0,0,0,1
challenges involved,0,0,1,0,0,0,0,1
challenges linked,0,1,0,0,0,0,0,1
challenges npr's,0,1,0,0,0,0,0,1
challenges shareholders,1,0,0,0,0,0,0,1
challenging difficult,0,0,0,0,1,0,0,1
challenging mainstream,0,0,0,0,1,0,0,1
challenging releases,0,0,0,1,0,0,0,1
challenging series,0,0,0,1,0,0,0,1
challenging week,0,0,0,1,0,0,0,1
champenois coal,0,0,0,0,1,0,0,1
champions awards,0,1,0,0,0,0,0,1
chance guterres,0,1,0,0,0,0,0,1
chance residents,0,0,0,0,1,0,0,1
chandan khanna,0,0,0,0,0,1,0,1
chang spoke,0,0,0,0,1,0,0,1
change adds,0,0,0,1,0,0,0,1
change affect,0,1,0,0,0,0,0,1
change affects,0,1,0,0,0,0,0,1
change akter,0,0,0,0,0,1,0,1
change baltimore,0,0,0,1,0,0,0,1
change biden,1,0,0,0,0,0,0,1
change bringing,0,0,0,1,0,0,0,1
change burning,0,0,1,0,0,0,0,1
change caused,0,1,0,0,0,0,0,1
change causing,0,0,0,0,0,1,0,1
change chaired,0,1,0,0,0,0,0,1
change christopher,1,0,0,0,0,0,0,1
change coastal,0,0,0,0,1,0,0,1
change communication,0,0,0,1,0,0,0,1
change communities,0,0,0,0,0,1,0,1
change conservationists,0,0,0,0,0,1,0,1
change continues,0,0,0,0,0,0,1,1
change conversation,0,0,1,0,0,0,0,1
change cop27,0,1,0,0,0,0,0,1
change countries,0,0,0,0,0,1,0,1
change coupled,0,0,1,0,0,0,0,1
change creating,1,0,0,0,0,0,0,1
change crisis,0,1,0,0,0,0,0,1
change curriculum,0,1,0,0,0,0,0,1
change deepened,1,0,0,0,0,0,0,1
change disproportionately.i,0,1,0,0,0,0,0,1
change dramas,0,0,0,0,0,0,1,1
change earthquakes,0,0,0,1,0,0,0,1
change envoy,0,0,0,1,0,0,0,1
change exacerbated,1,0,0,0,0,0,0,1
change exerts,0,0,0,0,1,0,0,1
change expert,1,0,0,0,0,0,0,1
change exposes,0,1,0,0,0,0,0,1
change extreme,0,1,0,0,0,0,0,1
change fast,0,0,0,0,1,0,0,1
change feel,0,0,0,0,0,0,1,1
change feels,1,0,0,0,0,0,0,1
change figured,0,0,0,1,0,0,0,1
change flooding,0,0,0,0,1,0,0,1
change focused,0,0,1,0,0,0,0,1
change focuses,0,1,0,0,0,0,0,1
change forecasting,0,0,0,1,0,0,0,1
change forecasts,0,0,0,1,0,0,0,1
change forgetting,0,0,1,0,0,0,0,1
change future,0,0,0,0,0,0,1,1
change golabari,0,0,0,0,0,1,0,1
change government,0,1,0,0,0,0,0,1
change governments,0,1,0,0,0,0,0,1
change greenhouse,0,0,0,1,0,0,0,1
change gwyn,0,0,0,1,0,0,0,1
change happening,1,0,0,0,0,0,0,1
change harm,0,0,0,0,0,1,0,1
change harms,0,0,0,1,0,0,0,1
change harold,0,0,0,0,0,1,0,1
change impact,0,1,0,0,0,0,0,1
change impacts,0,1,0,0,0,0,0,1
change inslee,0,0,0,0,1,0,0,1
change ipcc,0,0,0,0,0,1,0,1
change isabel,0,1,0,0,0,0,0,1
change jacquet,0,0,0,1,0,0,0,1
change jeff,0,0,0,1,0,0,0,1
change jerolmack,0,0,0,1,0,0,0,1
change joe,0,1,0,0,0,0,0,1
change laurie,1,0,0,0,0,0,0,1
change law,0,0,0,0,1,0,0,1
change lightning,0,0,1,0,0,0,0,1
change linguists,0,0,0,1,0,0,0,1
change meant,0,1,0,0,0,0,0,1
change migration,0,1,0,0,0,0,0,1
change mitigation,0,1,0,0,0,0,0,1
change models,1,0,0,0,0,0,0,1
change negotiations,0,1,0,0,0,0,0,1
change noah,0,0,0,0,1,0,0,1
change northern,0,0,0,1,0,0,0,1
change oil,1,0,0,0,0,0,0,1
change oregon,1,0,0,0,0,0,0,1
change owe,0,1,0,0,0,0,0,1
change phoebe,0,1,0,0,0,0,0,1
change plan,0,1,0,0,0,0,0,1
change plummer,0,1,0,0,0,0,0,1
change police,0,0,1,0,0,0,0,1
change positive,1,0,0,0,0,0,0,1
change process,0,1,0,0,0,0,0,1
change produces,0,0,0,1,0,0,0,1
change project,0,1,0,0,0,0,0,1
change projections,0,0,0,1,0,0,0,1
change projects,0,0,0,0,1,0,0,1
change putting,0,1,0,0,0,0,0,1
change received,0,0,1,0,0,0,0,1
change regime,0,1,0,0,0,0,0,1
change related,0,0,1,0,0,0,0,1
change report,0,0,0,0,0,1,0,1
change reports,0,0,0,0,0,0,1,1
change require,1,0,0,0,0,0,0,1
change research,0,0,0,1,0,0,0,1
change researchers,0,0,1,0,0,0,0,1
change robin,0,0,0,0,0,0,1,1
change ron,0,1,0,0,0,0,0,1
change schnarr,0,0,0,1,0,0,0,1
change sea,0,0,1,0,0,0,0,1
change sean,0,0,0,0,1,0,0,1
change significantly,0,0,1,0,0,0,0,1
change social,0,0,0,0,0,1,0,1
change solutions,0,1,0,0,0,0,0,1
change space,0,0,0,0,0,0,1,1
change stories,0,0,0,0,0,0,1,1
change storytelling,0,0,1,0,0,0,0,1
change technological,0,0,0,0,1,0,0,1
change threatening,0,1,0,0,0,0,0,1
change threshold,0,0,0,1,0,0,0,1
change udall,0,0,0,1,0,0,0,1
change vulnerable,0,0,0,0,0,1,0,1
change wealthy,0,1,0,0,0,0,0,1
change winners,0,1,0,0,0,0,0,1
change wong,0,1,0,0,0,0,0,1
change world,0,1,0,0,0,0,0,1
change worse,0,0,0,1,0,0,0,1
change worsened,0,0,0,1,0,0,0,1
change.and esme,0,0,0,1,0,0,0,1
change.org petition,0,0,0,0,0,1,0,1
change's impact,0,0,0,1,0,0,0,1
changed dramatically,1,0,0,0,0,0,0,1
changed due,0,0,0,1,0,0,0,1
changing climates,1,0,0,0,0,0,0,1
changing conditions,0,0,1,0,0,0,0,1
changing emissions,0,0,1,0,0,0,0,1
changing environment,0,1,0,0,0,0,0,1
changing investment,0,0,0,0,0,1,0,1
changing mindsets,0,1,0,0,0,0,0,1
changing oceans,0,0,0,0,0,1,0,1
changing region,0,0,0,1,0,0,0,1
changing system,0,0,0,0,1,0,0,1
channel notes,0,0,0,0,0,1,0,1
channel tunnel,0,1,0,0,0,0,0,1
channel waters,0,1,0,0,0,0,0,1
channeling water,0,0,0,0,0,1,0,1
channels formed,1,0,0,0,0,0,0,1
chaos irreversible,0,1,0,0,0,0,0,1
chaos robin,0,0,0,0,0,1,0,1
chaotic breakup,0,0,0,0,1,0,0,1
chaotic people,0,0,0,0,1,0,0,1
chaotic situation,1,0,0,0,0,0,0,1
chapel's intact,0,0,0,1,0,0,0,1
chapped ungloved,0,0,1,0,0,0,0,1
chappell afp,0,0,1,0,0,0,0,1
chapter dry,0,1,0,0,0,0,0,1
character assassinations,0,0,1,0,0,0,0,1
character rebecca,0,0,0,0,0,0,1,1
characteristics johnson,0,0,0,0,1,0,0,1
charged storm,0,1,0,0,0,0,0,1
charging customers,0,0,0,1,0,0,0,1
charging fearlessly,0,0,1,0,0,0,0,1
charitable trusts,1,0,0,0,0,0,0,1
charity foundation,1,0,0,0,0,0,0,1
charlene lake,0,1,0,0,0,0,0,1
charles iii,0,1,0,0,0,0,0,1
charles koch,0,0,0,0,1,0,0,1
charleston power,0,0,0,0,1,0,0,1
charleston thursday,0,1,0,0,0,0,0,1
charlie stock,0,0,0,0,0,1,0,1
charlotte emily,0,1,0,0,0,0,0,1
charlotte n.c,0,1,0,0,0,0,0,1
charter captain,1,0,0,0,0,0,0,1
charting forward,0,1,0,0,0,0,0,1
chasers.firefighter bolten,0,0,1,0,0,0,0,1
cheap carbon,0,1,0,0,0,0,0,1
cheap federally,1,0,0,0,0,0,0,1
cheap oil,0,0,0,0,0,0,1,1
cheap packages,0,0,0,0,1,0,0,1
cheap santa,0,0,0,1,0,0,0,1
cheaper sources,0,1,0,0,0,0,0,1
cheating gore,0,1,0,0,0,0,0,1
check cars,0,1,0,0,0,0,0,1
check hornewer,0,0,0,0,1,0,0,1
cheered alabama,0,0,1,0,0,0,0,1
cheese spicer,0,0,0,1,0,0,0,1
chef chris,0,1,0,0,0,0,0,1
chellie pingree,0,0,0,1,0,0,0,1
chemical reaction,0,1,0,0,0,0,0,1
chemical safety,0,0,0,0,0,0,1,1
chemical storage,0,1,0,0,0,0,0,1
chemistry council,1,0,0,0,0,0,0,1
cherished original,0,1,0,0,0,0,0,1
chest deep,0,1,0,0,0,0,0,1
chest pain,0,0,0,0,0,1,0,1
chest trauma,0,0,0,1,0,0,0,1
chesterfield heights,0,0,0,0,1,0,0,1
chevrolet sedan,0,1,0,0,0,0,0,1
chevron grace,1,0,0,0,0,0,0,1
chewy closely,0,1,0,0,0,0,0,1
chhin sothy,0,0,0,0,0,1,0,1
chicago assistant,1,0,0,0,0,0,0,1
chicago kamil,0,0,0,0,1,0,0,1
chicken basically,0,1,0,0,0,0,0,1
chicken dish,0,1,0,0,0,0,0,1
chicken liver,1,0,0,0,0,0,0,1
chicken pan,0,1,0,0,0,0,0,1
chicken product,0,1,0,0,0,0,0,1
chickens hanging,0,1,0,0,0,0,0,1
chief bill,0,0,1,0,0,0,0,1
chief kivoi,0,1,0,0,0,0,0,1
chief operating,0,1,0,0,0,0,0,1
chief procurement,0,1,0,0,0,0,0,1
chief scientific,0,1,0,0,0,0,0,1
chief vince,0,0,1,0,0,0,0,1
chien indian,1,0,0,0,0,0,0,1
chien la,1,0,0,0,0,0,0,1
chien reef,1,0,0,0,0,0,0,1
chikondi ap,0,0,0,0,0,1,0,1
child labor,1,0,0,0,0,0,0,1
child policy,0,1,0,0,0,0,0,1
child's car,0,1,0,0,0,0,0,1
children aged,0,1,0,0,0,0,0,1
children ages,0,0,0,0,1,0,0,1
children door,0,0,1,0,0,0,0,1
children fill,0,0,0,0,1,0,0,1
children gas,0,0,0,1,0,0,0,1
children huddled,0,0,0,0,0,0,1,1
children infusing,0,1,0,0,0,0,0,1
children living,0,1,0,0,0,0,0,1
children ran,1,0,0,0,0,0,0,1
children remained,0,1,0,0,0,0,0,1
children speaking,0,1,0,0,0,0,0,1
children squeezed,1,0,0,0,0,0,0,1
children tiny,0,0,0,0,0,1,0,1
children u.n,0,0,1,0,0,0,0,1
children waiting,1,0,0,0,0,0,0,1
children warning,1,0,0,0,0,0,0,1
children who've,1,0,0,0,0,0,0,1
children's league,0,1,0,0,0,0,0,1
chile mexico,0,0,0,0,0,1,0,1
chill temperatures,0,0,0,0,1,0,0,1
chilled environments,0,0,0,1,0,0,0,1
chilled water,1,0,0,0,0,0,0,1
chills headache,0,0,0,0,0,1,0,1
chilly relations,0,1,0,0,0,0,0,1
chilukuri contributed,0,0,0,0,1,0,0,1
china correspondent,0,0,0,0,1,0,0,1
china dominates,0,0,0,1,0,0,0,1
china emits,0,1,0,0,0,0,0,1
china hawks,0,0,0,0,1,0,0,1
china leads,0,0,0,0,0,1,0,1
china marburg,0,0,0,0,0,1,0,1
china permitted,0,0,0,0,0,1,0,1
china reiterated,0,1,0,0,0,0,0,1
china relationship,0,0,0,0,1,0,0,1
china sea,1,0,0,0,0,0,0,1
china tang,0,0,0,0,0,1,0,1
china yeah,0,0,0,0,0,1,0,1
china's dominance,0,0,0,0,0,1,0,1
china's emissions,0,1,0,0,0,0,0,1
china's leader,0,1,0,0,0,0,0,1
china's population,0,1,0,0,0,0,0,1
china's provincial,0,0,0,0,0,1,0,1
china's yunnan,0,1,0,0,0,0,0,1
chinese battery,0,0,0,0,1,0,0,1
chinese climate,0,1,0,0,0,0,0,1
chinese foreign,0,0,0,0,1,0,0,1
chinese government,0,1,0,0,0,0,0,1
chinese grid,0,0,0,0,0,1,0,1
chinese military,0,0,0,0,1,0,0,1
chinese president,0,1,0,0,0,0,0,1
chinese surveillance,0,0,0,0,1,0,0,1
ching ceo,0,0,0,0,1,0,0,1
chinned firefighters,0,0,1,0,0,0,0,1
chip somodevilla,0,0,0,0,0,1,0,1
chiu ap,0,0,0,1,0,0,0,1
chloe veltman,0,1,0,0,0,0,0,1
chocolate cake,0,1,0,0,0,0,0,1
choice ten,0,0,0,1,0,0,0,1
choice uc,0,0,0,1,0,0,0,1
choices gore,0,1,0,0,0,0,0,1
choices include,0,0,0,0,0,1,0,1
choices johnson,1,0,0,0,0,0,0,1
choices readily,0,0,0,0,0,1,0,1
choking bird,1,0,0,0,0,0,0,1
chorus starts,0,0,0,1,0,0,0,1
chose fairmount,1,0,0,0,0,0,0,1
chosen track,0,1,0,0,0,0,0,1
chris day,0,0,0,0,0,0,1,1
chris jones,0,1,0,0,0,0,0,1
chris paddie,0,0,0,0,1,0,0,1
chris spear,0,0,0,0,0,1,0,1
christi craddick,0,0,0,0,1,0,0,1
christi texas,0,1,0,0,0,0,0,1
christian broadcaster,0,0,0,0,0,1,0,1
christine arrasmith,0,0,0,1,0,0,0,1
christmas mess,0,0,0,1,0,0,0,1
christmas weekend,0,0,0,1,0,0,0,1
christopher columbus,0,0,0,0,0,1,0,1
christopher intagliata,0,0,0,0,1,0,0,1
christopher valadez,0,0,0,0,0,1,0,1
chronic obstructive,0,0,0,1,0,0,0,1
chronic underfunding,0,1,0,0,0,0,0,1
chronic water,0,0,0,0,0,1,0,1
chuck strouse,0,0,1,0,0,0,0,1
chukchi sea,0,0,0,0,0,1,0,1
chukchi seas,0,0,0,0,0,1,0,1
church building,0,1,0,0,0,0,0,1
church lay,1,0,0,0,0,0,0,1
cia prison,0,0,0,0,1,0,0,1
ciaran o'connor,0,0,0,0,0,1,0,1
ciera crawford,0,0,0,0,0,0,1,1
cinder block,0,0,0,0,0,0,1,1
cinder blocks,0,1,0,0,0,0,0,1
circular economy,0,0,0,1,0,0,0,1
circularity revolution,1,0,0,0,0,0,0,1
circulated video,0,1,0,0,0,0,0,1
circumstances willem,0,0,1,0,0,0,0,1
circus schorsch,0,0,1,0,0,0,0,1
cirino edited,0,0,0,1,0,0,0,1
cirino maggie,1,0,0,0,0,0,0,1
cirino takes,1,0,0,0,0,0,0,1
cited community,0,0,0,0,1,0,0,1
cited health,0,0,0,1,0,0,0,1
cites separate,1,0,0,0,0,0,0,1
cites tidewater,0,1,0,0,0,0,0,1
cities campuses,1,0,0,0,0,0,0,1
cities dating,0,0,0,0,1,0,0,1
cities exist,0,0,0,0,0,1,0,1
cities perched,0,1,0,0,0,0,0,1
cities set,0,0,0,0,1,0,0,1
cities surrounded,0,1,0,0,0,0,0,1
cities trapping,1,0,0,0,0,0,0,1
cities utah,0,0,0,0,1,0,0,1
citing accounts,1,0,0,0,0,0,0,1
citing household,0,0,0,0,1,0,0,1
citizens mayors,0,1,0,0,0,0,0,1
citizens romero,0,0,0,0,0,1,0,1
citizens westward,0,0,0,0,0,1,0,1
citizenship vote,0,0,0,1,0,0,0,1
citrus farms,1,0,0,0,0,0,0,1
city bitton's,0,0,0,0,1,0,0,1
city black,0,0,0,0,0,1,0,1
city bottom,0,1,0,0,0,0,0,1
city commuter,0,0,0,1,0,0,0,1
city councils,0,0,0,1,0,0,0,1
city crews,0,0,0,1,0,0,0,1
city cut,0,0,0,0,1,0,0,1
city data,0,0,0,1,0,0,0,1
city dweller,0,0,0,0,1,0,0,1
city dwellers,1,0,0,0,0,0,0,1
city government,0,1,0,0,0,0,0,1
city governments,0,1,0,0,0,0,0,1
city hall,0,0,0,0,1,0,0,1
city international,0,0,0,0,1,0,0,1
city iowa,0,1,0,0,0,0,0,1
city issued,0,0,0,1,0,0,0,1
city las,0,0,0,1,0,0,0,1
city leonardo,0,0,0,0,1,0,0,1
city lifted,0,0,0,1,0,0,0,1
city lost,0,0,0,0,1,0,0,1
city manager,0,0,0,1,0,0,0,1
city mayor,1,0,0,0,0,0,0,1
city metro,0,0,0,0,1,0,0,1
city mexico,0,0,0,0,0,1,0,1
city operated,0,0,0,0,1,0,0,1
city owned,1,0,0,0,0,0,0,1
city project,0,0,0,1,0,0,0,1
city received,0,0,0,0,1,0,0,1
city recently,0,0,0,0,1,0,0,1
city sits,0,0,0,0,1,0,0,1
city skyline,0,0,0,0,1,0,0,1
city slack,0,0,0,1,0,0,0,1
city spencer,0,0,0,0,1,0,0,1
city talk,1,0,0,0,0,0,0,1
city thoroughfare,0,0,1,0,0,0,0,1
city top,0,1,0,0,0,0,0,1
city urged,0,0,0,0,0,1,0,1
city water,0,1,0,0,0,0,0,1
city workers,0,1,0,0,0,0,0,1
city.this episode,0,1,0,0,0,0,0,1
city's aging,0,0,0,1,0,0,0,1
city's emergency,0,0,0,0,1,0,0,1
city's history,0,1,0,0,0,0,0,1
city's mayor,0,0,0,0,1,0,0,1
city's public,0,0,1,0,0,0,0,1
city's top,0,1,0,0,0,0,0,1
city's vice,0,0,0,0,1,0,0,1
city's west,0,0,0,0,1,0,0,1
civic platform,0,0,0,0,0,1,0,1
civil conflicts,0,0,1,0,0,0,0,1
civil engineering,0,0,0,0,1,0,0,1
civilian flight,0,0,0,0,1,0,0,1
civilian officials,0,1,0,0,0,0,0,1
civilian stuff,0,1,0,0,0,0,0,1
civilized person,0,0,0,0,0,1,0,1
claim asylum,0,0,1,0,0,0,0,1
claim stems,0,0,0,0,0,1,0,1
claimed solar,0,0,0,0,1,0,0,1
clammy british,0,0,0,0,0,1,0,1
clara river,0,0,0,0,1,0,0,1
clarita north,0,0,0,0,1,0,0,1
clark company,1,0,0,0,0,0,0,1
clarke heads,0,0,0,0,0,1,0,1
clashing ideologies,0,0,1,0,0,0,0,1
class communities,0,0,0,1,0,0,0,1
class inspired,0,0,0,1,0,0,0,1
classified materials,0,0,0,1,0,0,0,1
classroom door,0,0,0,1,0,0,0,1
claudio palomba,0,1,0,0,0,0,0,1
clay pipes,0,0,0,1,0,0,0,1
clay pot,0,1,0,0,0,0,0,1
clean coal,0,0,0,0,1,0,0,1
clean cooking,0,1,0,0,0,0,0,1
clean drinking,0,0,0,0,0,0,1,1
clean economy,0,0,0,0,0,1,0,1
clean energy.so,0,1,0,0,0,0,0,1
clean fuel,0,0,0,0,1,0,0,1
clean infrastructure,0,1,0,0,0,0,0,1
clean ocean,0,0,0,0,1,0,0,1
clean reliable,0,0,0,0,0,1,0,1
clean tech,0,0,0,0,0,1,0,1
clean technology,1,0,0,0,0,0,0,1
clean transportation,0,0,0,0,1,0,0,1
cleaner air,0,0,0,0,1,0,0,1
cleaner burner,0,0,0,1,0,0,0,1
cleaner industries,0,0,0,0,0,1,0,1
cleaner jet,0,0,1,0,0,0,0,1
cleaner option,0,0,1,0,0,0,0,1
cleaner power,0,0,0,0,0,1,0,1
cleaner type,0,0,0,1,0,0,0,1
cleaners legislation,0,1,0,0,0,0,0,1
cleanup funds,1,0,0,0,0,0,0,1
clearing roads,0,1,0,0,0,0,0,1
clearing wide,0,0,0,0,0,0,1,1
cleetus climate,0,0,0,1,0,0,0,1
cleetus policy,0,0,0,1,0,0,0,1
cleft chinned,0,0,1,0,0,0,0,1
clichés red,0,0,1,0,0,0,0,1
clients fishing,1,0,0,0,0,0,0,1
clients including,0,0,1,0,0,0,0,1
clients invisibility,0,0,1,0,0,0,0,1
clients payments,0,0,1,0,0,0,0,1
cliff towering,0,1,0,0,0,0,0,1
climate accord,1,0,0,0,0,0,0,1
climate advisor,0,1,0,0,0,0,0,1
climate agenda,0,1,0,0,0,0,0,1
climate analytics,0,0,0,1,0,0,0,1
climate assessment,0,0,0,1,0,0,0,1
climate bank,0,1,0,0,0,0,0,1
climate bill,0,0,0,1,0,0,0,1
climate book,0,0,0,0,1,0,0,1
climate candidates,0,1,0,0,0,0,0,1
climate catastrophe,0,1,0,0,0,0,0,1
climate center,0,1,0,0,0,0,0,1
climate certified,0,0,0,0,0,0,1,1
climate change.and,0,0,0,1,0,0,0,1
climate change.what,0,0,0,0,0,0,1,1
climate change's,0,0,0,1,0,0,0,1
climate condition,0,1,0,0,0,0,0,1
climate conditions,0,0,0,0,0,1,0,1
climate conferences,0,0,1,0,0,0,0,1
climate connection,0,1,0,0,0,0,0,1
climate deal,0,0,0,0,1,0,0,1
climate decisions,0,0,0,0,0,1,0,1
climate desk.michael,0,0,1,0,0,0,0,1
climate devastation,1,0,0,0,0,0,0,1
climate disruption,0,0,0,0,1,0,0,1
climate disruption.martí,0,0,0,0,1,0,0,1
climate economics,0,1,0,0,0,0,0,1
climate engagement,0,1,0,0,0,0,0,1
climate extremism,0,1,0,0,0,0,0,1
climate funding,0,1,0,0,0,0,0,1
climate funds,0,1,0,0,0,0,0,1
climate gathering,0,1,0,0,0,0,0,1
climate gatherings,0,1,0,0,0,0,0,1
climate heating,1,0,0,0,0,0,0,1
climate hotspots,0,1,0,0,0,0,0,1
climate implications,0,1,0,0,0,0,0,1
climate induced,0,0,0,1,0,0,0,1
climate information,0,1,0,0,0,0,0,1
climate insurance,0,1,0,0,0,0,0,1
climate integrity,0,0,0,1,0,0,0,1
climate investing,1,0,0,0,0,0,0,1
climate investment,0,1,0,0,0,0,0,1
climate investments,0,0,0,0,0,1,0,1
climate issues,0,1,0,0,0,0,0,1
climate law,0,1,0,0,0,0,0,1
climate litigation,0,1,0,0,0,0,0,1
climate mario,0,0,0,0,0,1,0,1
climate media,0,0,0,1,0,0,0,1
climate messaging,0,0,0,0,1,0,0,1
climate migrant,1,0,0,0,0,0,0,1
climate minister,0,1,0,0,0,0,0,1
climate movement,1,0,0,0,0,0,0,1
climate mwenja,1,0,0,0,0,0,0,1
climate negotiators,0,0,0,1,0,0,0,1
climate neutral,0,0,0,0,0,1,0,1
climate oases.this,1,0,0,0,0,0,0,1
climate objectives,1,0,0,0,0,0,0,1
climate officials,0,0,0,0,0,1,0,1
climate organizing,0,1,0,0,0,0,0,1
climate package,0,1,0,0,0,0,0,1
climate plan,0,1,0,0,0,0,0,1
climate play,0,1,0,0,0,0,0,1
climate pressures,0,0,0,0,0,1,0,1
climate promises,0,0,0,0,0,1,0,1
climate proposals,0,0,0,0,0,0,1,1
climate protesters,0,0,0,1,0,0,0,1
climate protests,0,1,0,0,0,0,0,1
climate rainfall,0,0,0,1,0,0,0,1
climate reducing,0,0,0,1,0,0,0,1
climate regime,0,1,0,0,0,0,0,1
climate report,0,1,0,0,0,0,0,1
climate reporter,0,0,0,0,1,0,0,1
climate researchers,0,0,0,1,0,0,0,1
climate resilient,0,1,0,0,0,0,0,1
climate resolutions,0,0,0,0,0,0,1,1
climate rules,0,0,1,0,0,0,0,1
climate ryan,0,1,0,0,0,0,0,1
climate simulations,0,0,0,0,0,1,0,1
climate situation,0,0,0,1,0,0,0,1
climate strategies,0,1,0,0,0,0,0,1
climate strikes,0,1,0,0,0,0,0,1
climate studies,0,0,0,1,0,0,0,1
climate summits,0,1,0,0,0,0,0,1
climate system,0,0,0,1,0,0,0,1
climate talk,0,0,0,1,0,0,0,1
climate target,0,0,1,0,0,0,0,1
climate tech,0,0,0,0,1,0,0,1
climate victim,0,0,0,0,0,1,0,1
climate videos,0,1,0,0,0,0,0,1
climate watchdog,0,0,1,0,0,0,0,1
climate whiplash,0,0,0,1,0,0,0,1
climate why'd,0,0,1,0,0,0,0,1
climate.gov hide,0,0,0,0,0,1,0,1
climates monschauer,0,0,0,0,0,1,0,1
climatologist decades,0,0,0,0,0,1,0,1
climatologist mary,0,0,0,1,0,0,0,1
climb dramatically,0,1,0,0,0,0,0,1
climbed sharply,1,0,0,0,0,0,0,1
clinical psychologist,0,1,0,0,0,0,0,1
clinical trials,0,0,0,0,0,1,0,1
clinton administration,0,0,1,0,0,0,0,1
clock effort,0,1,0,0,0,0,0,1
clocked temperatures,0,0,0,1,0,0,0,1
clockwork pumpkin,1,0,0,0,0,0,0,1
clogged interstate,0,0,0,0,1,0,0,1
close accounts,0,0,0,0,0,1,0,1
closed amid,1,0,0,0,0,0,0,1
closed loop,1,0,0,0,0,0,0,1
closed roads,0,0,0,0,1,0,0,1
closed schools,0,1,0,0,0,0,0,1
closed wednesday,0,0,0,1,0,0,0,1
closed yesterday,0,0,0,1,0,0,0,1
closely gemma,0,0,0,0,1,0,0,1
closely michael,0,0,1,0,0,0,0,1
closely reid,0,1,0,0,0,0,0,1
closely replicating,0,1,0,0,0,0,0,1
closely tied,0,0,0,0,1,0,0,1
closely tracking,0,0,0,0,0,1,0,1
closing window,0,0,0,0,0,1,0,1
clothes concealing,1,0,0,0,0,0,0,1
clothes dryer,0,0,0,1,0,0,0,1
clothes firsthand,0,1,0,0,0,0,0,1
clotheslines stephanie,0,1,0,0,0,0,0,1
clothing caught,0,0,0,0,1,0,0,1
cloud seeding,0,0,0,0,1,0,0,1
clouds gusty,0,1,0,0,0,0,0,1
cloudy bitter,0,0,0,0,1,0,0,1
cloudy brown,0,0,0,0,0,1,0,1
club's clean,0,0,0,0,1,0,0,1
cnn's don,0,1,0,0,0,0,0,1
co2 coalition,0,0,0,0,1,0,0,1
co2 concentrations,1,0,0,0,0,0,0,1
co2 remains,1,0,0,0,0,0,0,1
coaches erika,0,1,0,0,0,0,0,1
coaching softball,0,1,0,0,0,0,0,1
coal accounts,0,0,0,0,1,0,0,1
coal ancona,1,0,0,0,0,0,0,1
coal billionaire,0,0,0,0,1,0,0,1
coal burning,0,0,0,1,0,0,0,1
coal chanda,0,0,0,0,1,0,0,1
coal collecting,0,0,0,0,1,0,0,1
coal collectors,0,0,0,0,1,0,0,1
coal completely,0,1,0,0,0,0,0,1
coal developments,0,0,0,0,1,0,0,1
coal friendly,0,0,0,0,1,0,0,1
coal includes,0,0,0,0,1,0,0,1
coal india,0,0,0,0,1,0,0,1
coal listen,0,1,0,0,0,0,0,1
coal lobby,0,0,0,0,0,1,0,1
coal luhut,0,0,0,0,1,0,0,1
coal mines,1,0,0,0,0,0,0,1
coal npr,0,0,0,0,1,0,0,1
coal picking,0,0,0,0,1,0,0,1
coal plant,0,0,0,0,0,1,0,1
coal prices,0,0,0,0,1,0,0,1
coal producer,0,0,0,0,1,0,0,1
coal ramping,1,0,0,0,0,0,0,1
coal reining,0,0,0,0,1,0,0,1
coal research,0,0,0,0,1,0,0,1
coal reserves,0,0,0,0,1,0,0,1
coal rich,0,0,0,0,1,0,0,1
coal slurry,1,0,0,0,0,0,0,1
coal stop,0,0,0,0,1,0,0,1
coal suharsono,0,0,0,0,1,0,0,1
coal thieves,0,0,0,0,1,0,0,1
coalfield dotted,0,0,0,0,1,0,0,1
coalition expects,1,0,0,0,0,0,0,1
coalition government,0,0,0,1,0,0,0,1
coalition's climate,0,1,0,0,0,0,0,1
coalition's oyster,1,0,0,0,0,0,0,1
coast cities,1,0,0,0,0,0,0,1
coast damaged,0,1,0,0,0,0,0,1
coast including,0,0,0,1,0,0,0,1
coast nicole,0,1,0,0,0,0,0,1
coast nineteen,0,0,0,1,0,0,0,1
coast nj,0,0,0,0,1,0,0,1
coast plan,1,0,0,0,0,0,0,1
coast portland,0,0,0,0,1,0,0,1
coast sixteen,0,0,0,0,1,0,0,1
coast storms,0,0,0,0,1,0,0,1
coast testing,0,0,0,0,1,0,0,1
coast's major,0,0,0,0,1,0,0,1
coastal counties,0,0,0,1,0,0,0,1
coastal development,1,0,0,0,0,0,0,1
coastal erosion,0,1,0,0,0,0,0,1
coastal highway,0,0,0,1,0,0,0,1
coastal land,0,1,0,0,0,0,0,1
coastal louisiana,1,0,0,0,0,0,0,1
coastal marshes,0,1,0,0,0,0,0,1
coastal north,0,0,0,0,1,0,0,1
coastal pacific,0,0,0,1,0,0,0,1
coastal planning,0,0,0,0,1,0,0,1
coastal provinces,1,0,0,0,0,0,0,1
coastal town,0,1,0,0,0,0,0,1
coastal waterways,0,1,0,0,0,0,0,1
coastline california,0,0,0,1,0,0,0,1
coastline causing,0,0,0,1,0,0,0,1
coastline deane,1,0,0,0,0,0,0,1
coastline ringo,0,0,0,1,0,0,0,1
coastlines vulnerable,0,0,0,1,0,0,0,1
coax saudi,1,0,0,0,0,0,0,1
cobalt industry,1,0,0,0,0,0,0,1
cobalt mined,1,0,0,0,0,0,0,1
coffee cup,0,0,0,1,0,0,0,1
coffee french,0,0,0,1,0,0,0,1
coffee instant,0,0,0,1,0,0,0,1
coffee intake,0,0,0,1,0,0,0,1
coffee makers,0,0,0,1,0,0,0,1
coffey suggested,0,0,0,0,0,1,0,1
cofffrini afp,0,0,0,0,0,1,0,1
cogeneration facility,1,0,0,0,0,0,0,1
cogswell dam,0,0,0,0,1,0,0,1
cohen reports,0,0,0,0,1,0,0,1
coherent march,0,0,0,0,1,0,0,1
coin sort,0,0,0,0,1,0,0,1
cold arctic,0,0,0,0,1,0,0,1
cold climates,0,0,0,0,0,1,0,1
cold cuts,1,0,0,0,0,0,0,1
cold gray,0,0,0,0,1,0,0,1
cold morning,0,0,0,0,1,0,0,1
cold snaps,0,0,0,0,1,0,0,1
cold storm,0,0,0,0,1,0,0,1
cold storms,0,0,0,0,0,1,0,1
cold wet,0,0,0,0,0,1,0,1
coldest weather,0,0,0,0,0,0,1,1
coldest windchill,0,0,0,0,1,0,0,1
collaborative solution,0,0,0,1,0,0,0,1
collapse ice,0,1,0,0,0,0,0,1
collapse sending,0,1,0,0,0,0,0,1
collapsing buildings,0,1,0,0,0,0,0,1
collapsing ice,0,1,0,0,0,0,0,1
collapsing miller's,0,0,0,0,0,0,1,1
collar workers,0,0,0,0,0,1,0,1
colleague ari,0,0,0,0,0,1,0,1
colleague emily,0,0,0,0,0,1,0,1
colleague nancy,0,0,0,0,1,0,0,1
colleague nate,0,1,0,0,0,0,0,1
colleague nazma,0,0,0,0,0,1,0,1
colleagues developed,0,0,0,0,0,1,0,1
colleagues predict,1,0,0,0,0,0,0,1
colleagues published,0,0,0,1,0,0,0,1
colleagues walk,0,1,0,0,0,0,0,1
collect brine,0,0,0,0,1,0,0,1
collect environmental,0,0,0,0,1,0,0,1
collect intel,0,0,0,0,1,0,0,1
collect leaves,1,0,0,0,0,0,0,1
collect rainwater,1,0,0,0,0,0,0,1
collected cans,0,0,0,0,1,0,0,1
collecting sediment,0,0,0,1,0,0,0,1
collecting street,0,0,0,1,0,0,0,1
collecting temperature,0,0,0,1,0,0,0,1
collecting temperatures,0,0,0,1,0,0,0,1
collecting views,0,0,0,1,0,0,0,1
collection slack,0,0,0,1,0,0,0,1
collective audience,0,0,1,0,0,0,0,1
collective focus,0,0,0,1,0,0,0,1
collective harms,0,0,0,1,0,0,0,1
collective ownership,0,1,0,0,0,0,0,1
collective recovery,0,1,0,0,0,0,0,1
collective suicide,0,1,0,0,0,0,0,1
collective victims,0,0,0,1,0,0,0,1
collectively killing,0,0,0,0,0,1,0,1
collectively mobilize,0,1,0,0,0,0,0,1
collectively promised,0,1,0,0,0,0,0,1
collectively received,0,0,1,0,0,0,0,1
collectively survive,0,1,0,0,0,0,0,1
collectors ages,0,0,0,0,1,0,0,1
collects cooking,0,0,0,0,1,0,0,1
collects shells,1,0,0,0,0,0,0,1
college campuses,1,0,0,0,0,0,0,1
college castles,0,1,0,0,0,0,0,1
collins colo,0,1,0,0,0,0,0,1
colombia's national,1,0,0,0,0,0,0,1
colonel lisa,0,1,0,0,0,0,0,1
colonial fire,0,0,0,0,0,1,0,1
colonialism mismanagement,0,0,0,1,0,0,0,1
color generating,0,0,1,0,0,0,0,1
color posture,0,0,1,0,0,0,0,1
color scientists,0,0,0,1,0,0,0,1
color slack,0,0,0,1,0,0,0,1
color temporary,0,0,0,0,0,1,0,1
colorado gas,0,1,0,0,0,0,0,1
colorado meteorologist,0,0,0,1,0,0,0,1
colorado public,0,1,0,0,0,0,0,1
colorado regulators,0,1,0,0,0,0,0,1
colorado topped,1,0,0,0,0,0,0,1
colorado utah,0,0,0,1,0,0,0,1
colorado weather,1,0,0,0,0,0,0,1
colored house,0,0,0,0,0,0,1,1
colorful leaves,1,0,0,0,0,0,0,1
colorful mural,0,0,0,1,0,0,0,1
colorful thin,1,0,0,0,0,0,0,1
column alabama,0,0,1,0,0,0,0,1
columnist matthew,0,0,0,1,0,0,0,1
colville river,0,0,0,0,0,1,0,1
combination journalism,0,0,1,0,0,0,0,1
combine winds,0,1,0,0,0,0,0,1
combines data,0,0,0,1,0,0,0,1
combining photographs,0,1,0,0,0,0,0,1
combustible engines,1,0,0,0,0,0,0,1
combustible set,0,0,1,0,0,0,0,1
combustion engines,0,0,0,0,0,1,0,1
comcast towers,1,0,0,0,0,0,0,1
come.for npr,0,0,0,1,0,0,0,1
comfort residents,0,0,0,0,0,0,1,1
comfy positions,0,1,0,0,0,0,0,1
coming ashore,0,1,0,0,0,0,0,1
coming downhill,0,0,0,1,0,0,0,1
coming marty,0,0,0,1,0,0,0,1
coming online,0,0,0,0,1,0,0,1
coming quil,0,1,0,0,0,0,0,1
coming season,0,0,1,0,0,0,0,1
coming tuesday,0,0,0,0,1,0,0,1
commemorate martin,0,0,0,1,0,0,0,1
comment eric,0,0,0,0,0,1,0,1
comment opencast,0,0,0,0,1,0,0,1
comment opportunities,1,0,0,0,0,0,0,1
comment torchinsky,0,0,0,0,1,0,0,1
commentator michael,0,0,0,0,0,1,0,1
commented publicly,0,0,0,0,1,0,0,1
comments rick,0,1,0,0,0,0,0,1
commerce committee,0,0,0,0,0,0,1,1
commercial airlines,0,0,1,0,0,0,0,1
commercial buildings,0,1,0,0,0,0,0,1
commercial fishing,0,1,0,0,0,0,0,1
commercial operations,0,1,0,0,0,0,0,1
commercial oyster,0,0,0,0,0,0,1,1
commercial production,0,1,0,0,0,0,0,1
commercial vehicles,0,0,1,0,0,0,0,1
commercial whaling,0,1,0,0,0,0,0,1
commercialized driven,0,1,0,0,0,0,0,1
commission adopted,0,1,0,0,0,0,0,1
commission executive,0,0,0,0,0,1,0,1
commission meeting,0,1,0,0,0,0,0,1
commission notes,0,0,0,0,1,0,0,1
commission suggested,0,1,0,0,0,0,0,1
commissioner deriso,1,0,0,0,0,0,0,1
commissioner richard,0,0,0,1,0,0,0,1
commissioner robert,0,1,0,0,0,0,0,1
commissioner terry,0,0,1,0,0,0,0,1
commissioners oppose,0,0,0,0,1,0,0,1
commit australia,0,1,0,0,0,0,0,1
commit policy,0,1,0,0,0,0,0,1
commitment pepsico,0,1,0,0,0,0,0,1
commitments governments,0,1,0,0,0,0,0,1
committee denounced,0,1,0,0,0,0,0,1
committee hearings,0,0,0,0,1,0,0,1
commodity crop,0,1,0,0,0,0,0,1
commodity system,0,1,0,0,0,0,0,1
common boundary,0,1,0,0,0,0,0,1
common garcia,0,1,0,0,0,0,0,1
common mary,0,0,0,1,0,0,0,1
common mollies,0,0,0,1,0,0,0,1
common scientists,0,1,0,0,0,0,0,1
common term,0,0,0,0,1,0,0,1
common themes,0,1,0,0,0,0,0,1
common winter,0,0,0,1,0,0,0,1
commonly littered,0,0,0,1,0,0,0,1
commonly referred,0,0,0,1,0,0,0,1
communicate abstract,1,0,0,0,0,0,0,1
communication failures,0,0,0,0,1,0,0,1
communication issues,1,0,0,0,0,0,0,1
communication manager,0,0,1,0,0,0,0,1
communication spreading,0,0,0,0,0,1,0,1
communication susan,0,0,0,0,1,0,0,1
communications chair,0,0,1,0,0,0,0,1
communications enthusiast,0,0,0,0,1,0,0,1
communities bric,1,0,0,0,0,0,0,1
communities checking,0,1,0,0,0,0,0,1
communities damaged,0,0,1,0,0,0,0,1
communities decimated,1,0,0,0,0,0,0,1
communities destroyed,1,0,0,0,0,0,0,1
communities earlier,0,0,0,1,0,0,0,1
communities fema,0,1,0,0,0,0,0,1
communities helping,0,1,0,0,0,0,0,1
communities include,0,0,0,0,0,1,0,1
communities lance,0,0,0,0,0,1,0,1
communities prepare,0,0,0,0,1,0,0,1
communities project,1,0,0,0,0,0,0,1
communities recognized,0,0,0,0,1,0,0,1
communities requires,0,0,1,0,0,0,0,1
communities risk,0,0,0,1,0,0,0,1
communities sopa,0,1,0,0,0,0,0,1
communities suffering,0,1,0,0,0,0,0,1
communities surface,0,0,0,1,0,0,0,1
communities telling,1,0,0,0,0,0,0,1
communities time,1,0,0,0,0,0,0,1
community activist,0,0,0,0,1,0,0,1
community based,1,0,0,0,0,0,0,1
community benefits,0,1,0,0,0,0,0,1
community developers,0,0,0,0,1,0,0,1
community dilkins,0,0,0,0,0,1,0,1
community endangered,0,1,0,0,0,0,0,1
community foundation,0,1,0,0,0,0,0,1
community garden,0,1,0,0,0,0,0,1
community growth,1,0,0,0,0,0,0,1
community justice,0,0,0,1,0,0,0,1
community led,0,1,0,0,0,0,0,1
community meeting,1,0,0,0,0,0,0,1
community mohamed,0,0,0,1,0,0,0,1
community observes,0,0,0,0,1,0,0,1
community organizer,0,0,0,0,1,0,0,1
community organizing,1,0,0,0,0,0,0,1
community reefs,1,0,0,0,0,0,0,1
community relations,0,1,0,0,0,0,0,1
community resilience,0,0,0,1,0,0,0,1
community resources,0,1,0,0,0,0,0,1
community roughly,1,0,0,0,0,0,0,1
community solutions,0,0,0,0,0,1,0,1
community stephen,0,1,0,0,0,0,0,1
community tragedy,1,0,0,0,0,0,0,1
community water,0,0,0,0,0,1,0,1
commuter roads,0,0,1,0,0,0,0,1
companies advocates,0,0,0,0,1,0,0,1
companies basically,0,0,0,1,0,0,0,1
companies feel,0,0,1,0,0,0,0,1
companies including,0,1,0,0,0,0,0,1
companies industry,0,0,0,1,0,0,0,1
companies installed,1,0,0,0,0,0,0,1
companies investors,0,0,1,0,0,0,0,1
companies involved,0,1,0,0,0,0,0,1
companies mining,0,1,0,0,0,0,0,1
companies moved,0,0,0,0,0,1,0,1
companies npr's,0,0,1,0,0,0,0,1
companies operating,0,0,1,0,0,0,0,1
companies owning,0,0,0,0,0,1,0,1
companies pump,0,1,0,0,0,0,0,1
companies rarely,1,0,0,0,0,0,0,1
companies released,0,0,1,0,0,0,0,1
companies reports,0,0,0,1,0,0,0,1
companies researchers,1,0,0,0,0,0,0,1
companies spend,0,0,1,0,0,0,0,1
companies tracked,0,0,1,0,0,0,0,1
companies tracy,0,0,1,0,0,0,0,1
companies volvo,0,0,1,0,0,0,0,1
company addresses,0,1,0,0,0,0,0,1
company adnoc,0,0,0,1,0,0,0,1
company afloat,0,1,0,0,0,0,0,1
company approached,0,1,0,0,0,0,0,1
company bankruptcies,1,0,0,0,0,0,0,1
company broke,0,0,0,1,0,0,0,1
company called,0,1,0,0,0,0,0,1
company cleared,0,1,0,0,0,0,0,1
company clients,0,0,1,0,0,0,0,1
company continues,0,0,0,0,1,0,0,1
company disinformation,0,0,0,1,0,0,0,1
company executives,0,0,0,1,0,0,0,1
company exxonmobil,0,0,0,1,0,0,0,1
company filed,1,0,0,0,0,0,0,1
company funded,0,0,0,1,0,0,0,1
company invest,0,0,0,0,0,1,0,1
company involved,0,0,0,0,1,0,0,1
company ls,0,0,0,0,1,0,0,1
company luma,0,0,0,1,0,0,0,1
company offered,0,0,0,0,1,0,0,1
company officials,1,0,0,0,0,0,0,1
company owns,0,0,1,0,0,0,0,1
company pitts,0,0,1,0,0,0,0,1
company posed,0,0,0,1,0,0,0,1
company powerco,0,0,0,0,0,1,0,1
company produces,0,1,0,0,0,0,0,1
company proposed,0,0,0,0,1,0,0,1
company puerto,0,0,0,1,0,0,0,1
company responds,0,1,0,0,0,0,0,1
company sachs,0,0,1,0,0,0,0,1
company scrapped,0,0,0,0,1,0,0,1
company stripe,0,0,0,1,0,0,0,1
company wound,1,0,0,0,0,0,0,1
company.ceraweek attracts,0,0,0,0,0,1,0,1
company's ambitious,0,1,0,0,0,0,0,1
company's history,0,0,0,1,0,0,0,1
company's owner,0,1,0,0,0,0,0,1
company's press,0,0,1,0,0,0,0,1
company's submission,0,1,0,0,0,0,0,1
compare migrants,0,1,0,0,0,0,0,1
compare sources,0,1,0,0,0,0,0,1
compared electric,0,0,0,0,1,0,0,1
compared immigrants,0,1,0,0,0,0,0,1
compared tornado,0,0,0,0,0,1,0,1
compares supercells,0,0,0,0,0,1,0,1
comparing filtered,0,0,0,1,0,0,0,1
comparing readings,0,0,0,1,0,0,0,1
comparison mubadala,0,0,0,1,0,0,0,1
compelling arguments,0,0,1,0,0,0,0,1
compelling climate,0,0,0,0,0,0,1,1
compensate countries,0,1,0,0,0,0,0,1
compensate low,0,1,0,0,0,0,0,1
compensate lower,0,1,0,0,0,0,0,1
compensate people,1,0,0,0,0,0,0,1
compensate poorer,0,1,0,0,0,0,0,1
compensating developing,0,1,0,0,0,0,0,1
compensating landowners,1,0,0,0,0,0,0,1
competing challenges,0,1,0,0,0,0,0,1
competing nations,0,0,0,1,0,0,0,1
competing superpowers,0,1,0,0,0,0,0,1
competition continues,0,0,0,0,1,0,0,1
competitive building,0,1,0,0,0,0,0,1
competitors owners,0,0,1,0,0,0,0,1
complete data,0,1,0,0,0,0,0,1
complete failure,0,0,0,1,0,0,0,1
complete flip,0,0,0,0,1,0,0,1
complete opposite,0,0,0,1,0,0,0,1
complete surprise,0,0,0,1,0,0,0,1
completed resilience,0,1,0,0,0,0,0,1
completely absurd,0,0,0,0,1,0,0,1
completely closed,0,1,0,0,0,0,0,1
completely contradictory,0,1,0,0,0,0,0,1
completely destroyed,0,0,0,1,0,0,0,1
completely disappear,0,0,0,0,1,0,0,1
completely dry,0,0,0,0,1,0,0,1
completely drying,0,0,0,0,1,0,0,1
completely ripped,0,1,0,0,0,0,0,1
completely unnecessary,0,0,0,1,0,0,0,1
completely untenable,0,0,0,0,0,0,1,1
completes protections,0,0,0,0,0,1,0,1
complex burned,1,0,0,0,0,0,0,1
complex computer,1,0,0,0,0,0,0,1
complex conversation,0,0,0,0,0,0,1,1
complex political,0,1,0,0,0,0,0,1
complex set,0,0,0,0,0,1,0,1
complex stream,0,0,1,0,0,0,0,1
complex tale,0,1,0,0,0,0,0,1
complex talks,0,0,0,1,0,0,0,1
complex web,0,0,1,0,0,0,0,1
complex yeah,0,0,0,1,0,0,0,1
complicate matters,1,0,0,0,0,0,0,1
complicated complex,0,1,0,0,0,0,0,1
complicated computer,0,0,0,0,0,1,0,1
complicated economic,0,1,0,0,0,0,0,1
complicated fifty,1,0,0,0,0,0,0,1
complicated negotiations,0,0,0,0,1,0,0,1
complicated phoenix,0,0,0,0,1,0,0,1
complicated picture,0,0,1,0,0,0,0,1
complicated question,0,1,0,0,0,0,0,1
complicated role,0,1,0,0,0,0,0,1
component free,0,1,0,0,0,0,0,1
compostable coffee,0,0,0,1,0,0,0,1
composting pumpkins,0,1,0,0,0,0,0,1
comprehensive climate,0,1,0,0,0,0,0,1
comprehensive monitoring,0,0,0,0,0,1,0,1
compressed liquified,0,1,0,0,0,0,0,1
compressor stations,0,0,0,1,0,0,0,1
compromise cop28,0,0,0,1,0,0,0,1
compromised schaeffer,0,0,1,0,0,0,0,1
compton wrote,0,0,0,0,0,1,0,1
computer guy,0,0,0,0,1,0,0,1
computer simulations,0,0,0,0,0,1,0,1
computing power,0,0,0,0,0,1,0,1
concannon edits,0,0,1,0,0,0,0,1
concentrated animal,0,1,0,0,0,0,0,1
concentrated damage,0,1,0,0,0,0,0,1
concentrated poultry,0,1,0,0,0,0,0,1
concentrated primarily,0,1,0,0,0,0,0,1
concerned yeah,0,0,0,1,0,0,0,1
concerns scott,0,0,0,1,0,0,0,1
concert erin,0,0,0,0,0,0,1,1
concert frederick,0,0,0,0,0,0,1,1
concert organized,0,1,0,0,0,0,0,1
concert venue,0,0,0,0,0,0,1,1
conclusions wrote,0,0,0,1,0,0,0,1
conclusively connect,0,0,0,0,0,1,0,1
concord n.h,0,0,0,1,0,0,0,1
concrete development,0,1,0,0,0,0,0,1
concrete feat,1,0,0,0,0,0,0,1
concrete foundations,0,1,0,0,0,0,0,1
concrete materials,0,0,0,1,0,0,0,1
concrete reinforced,0,0,0,0,0,1,0,1
concretely manage,0,0,0,0,0,1,0,1
concurrent plunge,0,0,1,0,0,0,0,1
concussive blast,0,0,1,0,0,0,0,1
condensation funnels,0,0,0,0,0,1,0,1
condition pritzker,0,0,0,0,0,0,1,1
conditional license,0,0,0,1,0,0,0,1
conditioners cooling,0,0,0,1,0,0,0,1
conditioners heat,0,0,0,0,0,0,1,1
conditioning heating,0,0,0,0,0,0,1,1
conditions additional,0,1,0,0,0,0,0,1
conditions anderson,0,0,0,0,0,0,1,1
conditions driven,0,0,0,0,0,1,0,1
conditions farmers,0,0,0,0,0,1,0,1
conditions favorable,0,0,0,0,0,1,0,1
conditions imposed,0,0,0,1,0,0,0,1
conditions improve,0,0,0,0,0,1,0,1
conditions including,0,0,0,0,0,1,0,1
conditions politically,1,0,0,0,0,0,0,1
conditions thursday,0,1,0,0,0,0,0,1
conditions water,0,1,0,0,0,0,0,1
condominium buildings,0,1,0,0,0,0,0,1
conduct agriculture,0,0,0,0,0,1,0,1
conduct transactions,0,0,1,0,0,0,0,1
conducting annual,0,0,1,0,0,0,0,1
conducting search,1,0,0,0,0,0,0,1
conducts research,0,0,1,0,0,0,0,1
cone bearing,0,0,0,0,0,1,0,1
confederated tribes,0,0,0,0,0,1,0,1
conference accountable,0,1,0,0,0,0,0,1
conference agreed,0,1,0,0,0,0,0,1
conference attendees,0,1,0,0,0,0,0,1
conference aya,0,0,0,1,0,0,0,1
conference cop28,0,0,0,0,0,1,0,1
conference developed,0,1,0,0,0,0,0,1
conference devoted,0,0,0,0,0,1,0,1
conference hall,0,1,0,0,0,0,0,1
conference halls,0,1,0,0,0,0,0,1
conference heard,0,1,0,0,0,0,0,1
conference held,0,0,0,0,0,1,0,1
conference leaders,0,1,0,0,0,0,0,1
conference misty,0,0,0,0,0,0,1,1
conference president,0,1,0,0,0,0,0,1
conference released,0,0,1,0,0,0,0,1
conference sanaa,0,1,0,0,0,0,0,1
conference sean,0,1,0,0,0,0,0,1
conference shelters,0,1,0,0,0,0,0,1
conference starting,0,1,0,0,0,0,0,1
conference upcoming,0,0,1,0,0,0,0,1
conference wrapped,0,1,0,0,0,0,0,1
conference's recent,0,0,0,0,1,0,0,1
confirm interior,0,0,0,0,0,1,0,1
confirmed dead,1,0,0,0,0,0,0,1
confirmed death,1,0,0,0,0,0,0,1
confirmed deaths,1,0,0,0,0,0,0,1
confirmed sunday,0,0,0,0,0,0,1,1
conflict antagonizing,0,0,0,1,0,0,0,1
conflict ukraine's,0,1,0,0,0,0,0,1
conflicting priorities,0,0,0,0,0,1,0,1
conflicts refugee,0,1,0,0,0,0,0,1
confronts inheriting,0,1,0,0,0,0,0,1
conger worries,0,1,0,0,0,0,0,1
congo deforestation,0,0,0,0,0,0,1,1
congo prediction,0,0,0,0,0,0,1,1
congress approved,0,1,0,0,0,0,0,1
congress broader,0,0,0,0,0,0,1,1
congress called,0,0,0,1,0,0,0,1
congress congress,0,1,0,0,0,0,0,1
congress passing,0,1,0,0,0,0,0,1
congress republicans,0,1,0,0,0,0,0,1
congress tasked,0,1,0,0,0,0,0,1
congressional investigation,0,0,0,0,1,0,0,1
congressional testimonies,0,0,0,0,0,0,1,1
congressman byron,1,0,0,0,0,0,0,1
congressman congressman,1,0,0,0,0,0,0,1
congresswoman teresa,1,0,0,0,0,0,0,1
conifer forests,0,0,0,0,0,1,0,1
conifer trees,0,0,0,0,0,1,0,1
conifers incompatible,0,0,0,0,0,1,0,1
conifers uphill,0,0,0,0,0,1,0,1
connect people,0,0,1,0,0,0,0,1
connect tornado,0,0,0,0,0,1,0,1
connected people,0,0,0,0,1,0,0,1
connecticut massachusetts,0,0,0,0,1,0,0,1
connectivity florida,1,0,0,0,0,0,0,1
conners feels,0,0,0,0,0,1,0,1
conners lives,0,0,0,0,0,1,0,1
connor giffin,1,0,0,0,0,0,0,1
connor ultimately,0,0,0,0,0,1,0,1
conocophillips called,0,0,0,0,0,1,0,1
conocophillips chairman,0,0,0,0,0,1,0,1
conocophillips plan,0,0,0,0,0,1,0,1
conscious behavior,0,0,0,1,0,0,0,1
conscious consumers,0,1,0,0,0,0,0,1
consecutive days,0,1,0,0,0,0,0,1
consecutive major,0,0,0,0,0,1,0,1
consecutive shocks,0,0,0,0,1,0,0,1
consent pitts,0,0,1,0,0,0,0,1
consequential climate,0,0,0,0,0,1,0,1
consequential shifts,0,0,0,0,0,1,0,1
conservancy explains,0,0,1,0,0,0,0,1
conservancy identified,0,0,1,0,0,0,0,1
conservation behavior,0,0,0,0,0,1,0,1
conservation deal,1,0,0,0,0,0,0,1
conservation finance,0,0,1,0,0,0,0,1
conservation goal,0,0,1,0,0,0,0,1
conservation plans,1,0,0,0,0,0,0,1
conservation programme's,0,0,1,0,0,0,0,1
conservation rules,0,0,0,0,0,1,0,1
conservation society,0,0,1,0,0,0,0,1
conservation's geological,0,0,0,1,0,0,0,1
conservation's landslide,0,0,0,1,0,0,0,1
conservationist struggling,0,0,0,0,0,0,1,1
conservative christian,0,0,0,0,0,1,0,1
conservative commentator,0,0,0,0,0,1,0,1
conservative energy,0,0,0,0,1,0,0,1
conservative government,0,1,0,0,0,0,0,1
conservative insiders,0,0,0,0,1,0,0,1
conservative leaning,0,0,0,0,1,0,0,1
conservative lots,0,1,0,0,0,0,0,1
conservative media,0,0,0,0,0,1,0,1
conservative organizations,0,0,0,0,1,0,0,1
conservative outrage,0,0,0,0,0,1,0,1
conservative plowed,0,0,1,0,0,0,0,1
conservative politicians,0,0,0,0,1,0,0,1
conservative pundit,0,0,0,0,0,1,0,1
conservative video,0,0,0,0,0,1,0,1
conservative women,0,0,0,0,1,0,0,1
conservatives including,0,0,0,0,0,1,0,1
conservatives opposed,0,0,0,1,0,0,0,1
conserve dangi,0,1,0,0,0,0,0,1
conserve electricity,0,0,0,0,1,0,0,1
conserve forests,0,1,0,0,0,0,0,1
conserve species,1,0,0,0,0,0,0,1
conserve water,1,0,0,0,0,0,0,1
conserving nature,0,0,1,0,0,0,0,1
consideration people,1,0,0,0,0,0,0,1
considered endangered,0,0,0,0,1,0,0,1
considered extreme,0,0,0,0,0,0,1,1
considered forever,0,0,0,0,1,0,0,1
considered gore,0,1,0,0,0,0,0,1
considered hostile,0,0,0,1,0,0,0,1
considered tornado,0,0,0,0,0,0,1,1
considered toxic,0,0,0,0,1,0,0,1
consistent ally,0,0,1,0,0,0,0,1
consistently california,0,0,0,0,0,1,0,1
consistently called,0,0,1,0,0,0,0,1
consistently cheered,0,0,1,0,0,0,0,1
consistently cold,0,0,0,1,0,0,0,1
consistently frigid,0,0,1,0,0,0,0,1
consortium collaborated,0,0,1,0,0,0,0,1
conspiracy theorist,0,0,0,0,0,1,0,1
conspiracy theorists,0,0,0,0,0,1,0,1
constant reminder,0,1,0,0,0,0,0,1
constantly continuously,0,0,0,0,0,1,0,1
construct pipelines,0,0,0,0,0,1,0,1
constructing infrastructure,0,0,0,1,0,0,0,1
constructing seawallsor,0,0,1,0,0,0,0,1
construction appropriations,0,1,0,0,0,0,0,1
construction company,0,0,0,0,1,0,0,1
construction including,0,1,0,0,0,0,0,1
construction jobs,0,0,0,0,0,1,0,1
construction project,0,1,0,0,0,0,0,1
construction site,0,1,0,0,0,0,0,1
construction workers,0,0,0,0,0,1,0,1
consultation period,0,0,0,1,0,0,0,1
consultation support,0,0,0,1,0,0,0,1
consulted droz,0,0,0,0,1,0,0,1
consulting alisa,0,0,1,0,0,0,0,1
consumer advocacy,0,0,0,1,0,0,0,1
consumer boykoff,0,0,0,1,0,0,0,1
consumer demand,0,0,0,0,1,0,0,1
consumer energy,0,0,0,0,0,1,0,1
consumer level,0,0,0,1,0,0,0,1
consumer research,0,1,0,0,0,0,0,1
consumers bills,0,0,1,0,0,0,0,1
consumers chicken,0,1,0,0,0,0,0,1
consumers connect,0,1,0,0,0,0,0,1
consumers investors,0,0,0,1,0,0,0,1
consumers pay,1,0,0,0,0,0,0,1
consumers payments,0,0,1,0,0,0,0,1
contained dead,0,0,1,0,0,0,0,1
container resources,1,0,0,0,0,0,0,1
container wall,0,0,0,1,0,0,0,1
containers bags,1,0,0,0,0,0,0,1
containers carpenter,1,0,0,0,0,0,0,1
contaminants including,0,0,0,0,1,0,0,1
contaminating water,0,0,0,0,0,1,0,1
contemporary amperex,0,1,0,0,0,0,0,1
contemporary styles,0,1,0,0,0,0,0,1
content requirements,0,0,0,0,0,1,0,1
contentions issues,0,0,1,0,0,0,0,1
contentious issue,0,1,0,0,0,0,0,1
contentious talks,0,0,1,0,0,0,0,1
context weather,0,1,0,0,0,0,0,1
contiguous united,0,0,0,1,0,0,0,1
continent frannie,0,1,0,0,0,0,0,1
continent shifting,0,1,0,0,0,0,0,1
continent tanzania,0,0,0,0,0,1,0,1
continental shelf,0,0,0,0,0,1,0,1
continental u.s,1,0,0,0,0,0,0,1
continental united,0,0,1,0,0,0,0,1
continents.our team,0,1,0,0,0,0,0,1
continually updates,0,0,0,1,0,0,0,1
continue alongside,0,0,0,0,1,0,0,1
continue burning,0,0,1,0,0,0,0,1
continue fighting,0,1,0,0,0,0,0,1
continue playing,0,1,0,0,0,0,0,1
continue safe,0,1,0,0,0,0,0,1
continue title,0,0,1,0,0,0,0,1
continued sale,0,0,0,0,0,1,0,1
continued sharif,0,1,0,0,0,0,0,1
continued violence,0,0,1,0,0,0,0,1
continues cbs,0,0,1,0,0,0,0,1
continues worldwide,0,0,1,0,0,0,0,1
continuing rise,1,0,0,0,0,0,0,1
continuing unabated,0,0,0,0,1,0,0,1
continuously delaying,0,1,0,0,0,0,0,1
continuously plant,0,0,0,0,0,1,0,1
contract claim,0,0,0,0,0,1,0,1
contract term,1,0,0,0,0,0,0,1
contradictions caribbean,0,0,0,1,0,0,0,1
contradictory push,0,0,0,0,1,0,0,1
contradicts money,0,0,1,0,0,0,0,1
contributed roughly,0,1,0,0,0,0,0,1
contributing ca,0,0,0,0,0,1,0,1
contributing factor,0,0,0,0,0,0,1,1
contributing factors,0,0,0,0,0,0,1,1
contribution limits,1,0,0,0,0,0,0,1
control basin,0,0,0,0,1,0,0,1
control board,0,0,0,1,0,0,0,1
control congress,0,1,0,0,0,0,0,1
control drazan,1,0,0,0,0,0,0,1
control institution,0,0,0,1,0,0,0,1
control march,0,0,0,0,0,1,0,1
control methods,0,0,1,0,0,0,0,1
control scientists,0,0,0,0,0,1,0,1
control system,0,1,0,0,0,0,0,1
control water,0,0,0,0,0,1,0,1
controls executive,0,0,0,0,1,0,0,1
controls improve,0,0,0,0,1,0,0,1
controversial project,0,0,0,0,0,1,0,1
controversy started,0,0,0,1,0,0,0,1
convective flash,0,0,0,0,1,0,0,1
convened ahead,0,1,0,0,0,0,0,1
convenes npr's,0,1,0,0,0,0,0,1
convenient political,0,0,1,0,0,0,0,1
convention lists,0,0,1,0,0,0,0,1
conventional documentation,1,0,0,0,0,0,0,1
conventional hybrids,0,0,0,0,1,0,0,1
conventional methods,0,0,0,1,0,0,0,1
conventional newsroom,0,0,1,0,0,0,0,1
convert water,1,0,0,0,0,0,0,1
converts cow,0,1,0,0,0,0,0,1
conveyor belts,0,0,0,0,0,1,0,1
convince families,0,1,0,0,0,0,0,1
convince president,0,0,0,0,0,1,0,1
convincing women,1,0,0,0,0,0,0,1
coo kevin,1,0,0,0,0,0,0,1
cook cold,1,0,0,0,0,0,0,1
cook inlet,0,0,0,0,0,1,0,1
cook means,0,0,0,1,0,0,0,1
cook university,0,1,0,0,0,0,0,1
cooke manages,1,0,0,0,0,0,0,1
cooked pumpkin,0,1,0,0,0,0,0,1
cooking bathing,0,0,0,0,0,1,0,1
cooking energy,0,1,0,0,0,0,0,1
cooking fumes,0,0,0,0,1,0,0,1
cooking gas,0,1,0,0,0,0,0,1
cooking temperatures,0,0,0,0,1,0,0,1
cooking utensils,0,0,1,0,0,0,0,1
cooking vessel,0,0,0,0,1,0,0,1
cooks meals,0,0,0,1,0,0,0,1
cooktop market,0,0,0,0,1,0,0,1
cool air,0,0,0,0,0,0,1,1
cool engineering,0,0,0,1,0,0,0,1
cool nutrient,0,0,1,0,0,0,0,1
cool pumps,0,0,0,0,0,1,0,1
cool schmidt,0,0,0,0,1,0,0,1
cool season,0,0,0,0,0,0,1,1
cool summer,0,0,1,0,0,0,0,1
cool water,0,0,1,0,0,0,0,1
cool yeah,0,1,0,0,0,0,0,1
cooler habitat,0,0,1,0,0,0,0,1
cooler months,0,0,0,0,0,1,0,1
cooler pacific,0,1,0,0,0,0,0,1
cooler slack,0,0,0,1,0,0,0,1
cooler times,0,0,0,0,1,0,0,1
coolest science,0,0,0,0,0,1,0,1
cooling centers,0,0,0,1,0,0,0,1
cooling kircher,0,0,0,0,0,0,1,1
cooling systems,1,0,0,0,0,0,0,1
cooper ericksen,0,0,0,0,1,0,0,1
cooper's hawk,1,0,0,0,0,0,0,1
cooperation agreement,0,0,0,0,0,1,0,1
cooperation lula,0,1,0,0,0,0,0,1
coordinate emergency,0,0,0,0,1,0,0,1
coordinate projects,0,0,0,1,0,0,0,1
coordinated approach,0,0,0,0,1,0,0,1
coordinated effort,0,0,1,0,0,0,0,1
coordinating ministry,0,0,0,0,1,0,0,1
coordinating scientists,0,0,0,0,0,1,0,1
coordinator czajkowski,0,0,0,1,0,0,0,1
coordinator's office,0,0,0,0,1,0,0,1
cop hosted,0,1,0,0,0,0,0,1
cop president,0,0,0,1,0,0,0,1
cop presidents,0,0,0,1,0,0,0,1
cop singh,0,0,0,1,0,0,0,1
cop summit,0,0,0,1,0,0,0,1
cop27 conference,0,1,0,0,0,0,0,1
cop27 gehad,0,1,0,0,0,0,0,1
cop27 offers,0,1,0,0,0,0,0,1
cop27 roberts,0,1,0,0,0,0,0,1
cop27 summit,0,1,0,0,0,0,0,1
cop27 talks,0,1,0,0,0,0,0,1
cop27 unesco,0,1,0,0,0,0,0,1
copley joins,0,0,0,0,0,0,1,1
cops short,0,0,0,0,0,1,0,1
copy edited,0,0,0,0,0,0,1,1
coral bleaches,0,1,0,0,0,0,0,1
coral coral,0,1,0,0,0,0,0,1
coral surveyed,0,1,0,0,0,0,0,1
coral's survival,0,1,0,0,0,0,0,1
corals left,0,1,0,0,0,0,0,1
corals pastels,0,1,0,0,0,0,0,1
córdova intended,0,0,0,1,0,0,0,1
córdova's relatives,0,0,0,1,0,0,0,1
córdova's video,0,0,0,1,0,0,0,1
core tenet,0,0,1,0,0,0,0,1
corey bridges,0,0,1,0,0,0,0,1
corn famers,1,0,0,0,0,0,0,1
corn farmer,0,1,0,0,0,0,0,1
corn flakes,0,0,1,0,0,0,0,1
corn millet,0,1,0,0,0,0,0,1
corn oats,0,1,0,0,0,0,0,1
corn plants,1,0,0,0,0,0,0,1
corn rice,0,1,0,0,0,0,0,1
corn's fluctuating,1,0,0,0,0,0,0,1
corner tiny,0,0,0,1,0,0,0,1
corner volunteers,1,0,0,0,0,0,0,1
coronavirus pandemic,1,0,0,0,0,0,0,1
corporate boards,0,0,0,0,0,0,1,1
corporate food,0,1,0,0,0,0,0,1
corporate governance,0,0,0,0,0,0,1,1
corporate influence,0,0,1,0,0,0,0,1
corporate leaders,0,0,0,1,0,0,0,1
corporate maneuvers,1,0,0,0,0,0,0,1
corporate parent,0,0,1,0,0,0,0,1
corporate priority,0,0,1,0,0,0,0,1
corporate propaganda,0,0,1,0,0,0,0,1
corporation deployed,0,1,0,0,0,0,0,1
corporation expressed,0,0,0,0,1,0,0,1
corporation peddled,1,0,0,0,0,0,0,1
corporation told,1,0,0,0,0,0,0,1
corps base,0,1,0,0,0,0,0,1
corps covering,0,0,1,0,0,0,0,1
corps installation,0,1,0,0,0,0,0,1
correct joyner,0,0,0,0,0,0,1,1
correct lula,0,1,0,0,0,0,0,1
correct yeah,1,0,0,0,0,0,0,1
correspondent eleanor,0,0,0,1,0,0,0,1
correspondent emily,0,0,0,0,1,0,0,1
correspondent geoff,0,0,0,0,0,1,0,1
correspondent jeff,0,0,0,1,0,0,0,1
correspondent kirk,0,0,0,0,1,0,0,1
correspondent understands,0,1,0,0,0,0,0,1
corrugated metal,0,1,0,0,0,0,0,1
cortez afp,0,0,0,0,0,1,0,1
cortez ap,0,0,0,0,0,1,0,1
cosmetic products,0,0,0,0,0,0,1,1
cost efficiencies,1,0,0,0,0,0,0,1
cost electricity,0,0,0,0,1,0,0,1
cost savings,0,0,0,0,0,0,1,1
cost tens,0,1,0,0,0,0,0,1
cost yellen,0,1,0,0,0,0,0,1
cost.our current,1,0,0,0,0,0,0,1
costa rica,1,0,0,0,0,0,0,1
costliest extreme,1,0,0,0,0,0,0,1
costly lightbody,1,0,0,0,0,0,0,1
costly modifications,0,0,0,1,0,0,0,1
costly storm,0,0,0,1,0,0,0,1
costs cities,0,0,0,1,0,0,0,1
costs due,0,1,0,0,0,0,0,1
costs means,0,1,0,0,0,0,0,1
costs money,0,0,1,0,0,0,0,1
costs prices,0,1,0,0,0,0,0,1
costs starting,0,0,0,1,0,0,0,1
costume features,1,0,0,0,0,0,0,1
cotton buds,0,0,0,1,0,0,0,1
cotton crops,0,1,0,0,0,0,0,1
cotton fields,1,0,0,0,0,0,0,1
cotton shirt,1,0,0,0,0,0,0,1
cottontail rabbits,1,0,0,0,0,0,0,1
council alec,0,0,0,0,1,0,0,1
council race,0,1,0,0,0,0,0,1
council's global,0,0,0,1,0,0,0,1
counsel jack,0,0,0,1,0,0,0,1
counseling center,0,0,0,1,0,0,0,1
count update,0,0,0,0,0,1,0,1
counted equally,0,0,0,0,1,0,0,1
counter china,0,1,0,0,0,0,0,1
counteract natural,0,1,0,0,0,0,0,1
counterparts oysters,0,0,0,0,0,0,1,1
counties evacuations,0,0,0,1,0,0,0,1
counties flagler,0,1,0,0,0,0,0,1
counties friday,0,1,0,0,0,0,0,1
counties including,0,0,0,0,1,0,0,1
counties stretching,0,0,0,1,0,0,0,1
countless human,0,0,0,0,1,0,0,1
countless migrants,1,0,0,0,0,0,0,1
countless people,0,0,0,0,1,0,0,1
countries acknowledge,0,0,0,1,0,0,0,1
countries affected,0,1,0,0,0,0,0,1
countries assess,0,0,0,0,0,1,0,1
countries attended,0,1,0,0,0,0,0,1
countries blocked,0,0,1,0,0,0,0,1
countries claire,0,1,0,0,0,0,0,1
countries connor,0,0,0,0,0,1,0,1
countries control,0,0,0,0,0,1,0,1
countries cope,0,1,0,0,0,0,0,1
countries cut,1,0,0,0,0,0,0,1
countries development,0,1,0,0,0,0,0,1
countries facing,0,1,0,0,0,0,0,1
countries hope,0,0,0,0,1,0,0,1
countries implement,0,1,0,0,0,0,0,1
countries investment,0,1,0,0,0,0,0,1
countries investors,1,0,0,0,0,0,0,1
countries involved,0,1,0,0,0,0,0,1
countries kyle,0,0,0,0,0,1,0,1
countries low,0,0,0,0,0,1,0,1
countries manish,0,0,1,0,0,0,0,1
countries meet,0,1,0,0,0,0,0,1
countries move,0,1,0,0,0,0,0,1
countries people,0,1,0,0,0,0,0,1
countries peter,0,1,0,0,0,0,0,1
countries plenty,0,1,0,0,0,0,0,1
countries provide,0,0,1,0,0,0,0,1
countries receive,0,1,0,0,0,0,0,1
countries received,0,1,0,0,0,0,0,1
countries respond,0,1,0,0,0,0,0,1
countries responsible,0,1,0,0,0,0,0,1
countries sayed,0,1,0,0,0,0,0,1
countries set,0,1,0,0,0,0,0,1
countries spy,0,0,0,0,1,0,0,1
countries stick,0,1,0,0,0,0,0,1
countries tap,0,1,0,0,0,0,0,1
countries transition,0,0,0,0,0,1,0,1
countries walking,0,0,1,0,0,0,0,1
countries wealthy,0,1,0,0,0,0,0,1
country answering,0,0,0,0,1,0,0,1
country anymore,0,1,0,0,0,0,0,1
country bettina,0,0,1,0,0,0,0,1
country borders,0,0,0,0,0,1,0,1
country continues,0,0,0,0,1,0,0,1
country criticized,0,1,0,0,0,0,0,1
country czajkowski,0,0,0,1,0,0,0,1
country elects,1,0,0,0,0,0,0,1
country executive,0,0,1,0,0,0,0,1
country hindered,1,0,0,0,0,0,0,1
country hosting,0,0,0,1,0,0,0,1
country india,0,1,0,0,0,0,0,1
country lauren,0,1,0,0,0,0,0,1
country legally,0,1,0,0,0,0,0,1
country major,0,0,0,0,0,0,1,1
country plans,0,0,0,0,1,0,0,1
country recently,1,0,0,0,0,0,0,1
country road,0,0,0,0,1,0,0,1
country supplying,0,0,0,0,0,1,0,1
country swell,0,0,0,0,0,1,0,1
country terry,0,0,1,0,0,0,0,1
country trailer,0,0,1,0,0,0,0,1
country's annual,0,0,0,0,1,0,0,1
country's coal,0,0,0,0,0,1,0,1
country's economic,0,0,1,0,0,0,0,1
country's economy,0,0,0,1,0,0,0,1
country's energy,0,0,0,0,1,0,0,1
country's financial,0,0,0,0,0,1,0,1
country's flood,0,0,0,0,0,1,0,1
country's future,0,1,0,0,0,0,0,1
country's goals,0,1,0,0,0,0,0,1
country's largest,0,0,0,0,0,1,0,1
country's main,0,0,0,1,0,0,0,1
country's military,0,0,1,0,0,0,0,1
country's north,0,0,0,0,0,1,0,1
country's peak,0,0,0,0,0,1,0,1
country's power,0,0,1,0,0,0,0,1
country's premier,0,1,0,0,0,0,0,1
country's pride,0,1,0,0,0,0,0,1
country's public,0,0,0,0,1,0,0,1
country's renewables,0,0,0,0,1,0,0,1
country's roads,0,0,0,1,0,0,0,1
country's strictest,0,0,0,1,0,0,0,1
country's transition,0,1,0,0,0,0,0,1
country's vast,0,0,0,0,1,0,0,1
county adjacent,0,0,0,0,0,1,0,1
county adopted,0,0,0,0,1,0,0,1
county affects,0,1,0,0,0,0,0,1
county ala,0,0,0,1,0,0,0,1
county authorities,0,1,0,0,0,0,0,1
county beaches,0,0,0,0,1,0,0,1
county commission,0,1,0,0,0,0,0,1
county commissioners,0,0,0,0,1,0,0,1
county communications,0,0,0,0,0,1,0,1
county corbett,0,0,0,0,1,0,0,1
county decided,1,0,0,0,0,0,0,1
county department,0,0,0,0,1,0,0,1
county failed,0,0,0,0,0,0,1,1
county flooding,0,0,0,0,0,1,0,1
county governments,1,0,0,0,0,0,0,1
county growth,1,0,0,0,0,0,0,1
county houser,0,0,0,0,1,0,0,1
county includes,0,0,0,0,1,0,0,1
county level,0,0,0,0,1,0,0,1
county medical,0,0,0,0,1,0,0,1
county mo,1,0,0,0,0,0,0,1
county north,0,1,0,0,0,0,0,1
county offering,0,1,0,0,0,0,0,1
county population,1,0,0,0,0,0,0,1
county powderly,0,1,0,0,0,0,0,1
county recently,0,0,0,0,0,1,0,1
county rejected,0,0,0,0,1,0,0,1
county remains,0,0,0,1,0,0,0,1
county resources,0,0,0,0,0,1,0,1
county rising,0,0,0,1,0,0,0,1
county ryan,0,0,0,0,1,0,0,1
county san,0,0,0,0,0,1,0,1
county saturday,0,0,0,0,0,0,1,1
county supervisor,0,0,0,0,1,0,0,1
county talk,0,0,0,0,0,1,0,1
county texas,0,1,0,0,0,0,0,1
county ultimately,0,0,0,0,1,0,0,1
county's actions,0,0,0,0,1,0,0,1
county's board,0,0,0,0,1,0,0,1
county's cogswell,0,0,0,0,1,0,0,1
county's emergency,0,1,0,0,0,0,0,1
county's spent,0,0,0,1,0,0,0,1
couple creeks,1,0,0,0,0,0,0,1
couple explanations,0,0,0,0,0,0,1,1
couple facilities,1,0,0,0,0,0,0,1
couple friends,0,1,0,0,0,0,0,1
courier journal,1,0,0,0,0,0,0,1
coursework pinaki,0,0,0,0,1,0,0,1
court filings,0,0,1,0,0,0,0,1
court heard,0,0,0,0,0,1,0,1
court hoping,0,0,1,0,0,0,0,1
court judge,0,0,1,0,0,0,0,1
court jurisdiction,0,0,0,0,1,0,0,1
court overturned,1,0,0,0,0,0,0,1
court packed,0,1,0,0,0,0,0,1
court process,0,0,0,0,1,0,0,1
court wrote,0,0,0,1,0,0,0,1
court's conservatives,0,0,0,0,0,1,0,1
court's decision,0,0,1,0,0,0,0,1
courts arguing,0,0,0,1,0,0,0,1
courts athletic,0,1,0,0,0,0,0,1
cover disposal,0,0,0,1,0,0,0,1
cover florida,0,0,1,0,0,0,0,1
cover greenland,0,1,0,0,0,0,0,1
cover homes,0,0,0,0,1,0,0,1
cover plastic,0,0,0,1,0,0,0,1
coverage aimed,0,0,1,0,0,0,0,1
coverage ray,0,0,1,0,0,0,0,1
covered region,0,0,0,0,0,1,0,1
covered roads,0,0,0,1,0,0,0,1
covered sources,0,1,0,0,0,0,0,1
covered united,0,0,0,0,0,1,0,1
covering barack,1,0,0,0,0,0,0,1
covering florida's,0,1,0,0,0,0,0,1
covering khan's,0,0,0,0,1,0,0,1
covers aviation,0,0,1,0,0,0,0,1
covid era,0,0,0,0,0,1,0,1
covid hit,0,0,0,0,0,1,0,1
covid measures,0,1,0,0,0,0,0,1
covid pandemic,0,0,1,0,0,0,0,1
cowboy boots,0,1,0,0,0,0,0,1
cox automotive,0,0,0,0,1,0,0,1
cox nodded,0,0,0,0,1,0,0,1
cox talking,0,0,0,0,1,0,0,1
cox's house,0,0,0,1,0,0,0,1
cpsc chair,0,0,0,0,1,0,0,1
cpsc missed,0,0,0,0,1,0,0,1
cpsc quickly,0,0,0,1,0,0,0,1
cr ph,0,0,0,1,0,0,0,1
crabs barnacles,1,0,0,0,0,0,0,1
cracking earlier,0,0,1,0,0,0,0,1
craft programs,1,0,0,0,0,0,0,1
craft similar,0,1,0,0,0,0,0,1
craters dug,1,0,0,0,0,0,0,1
crawford county,0,0,0,0,0,0,1,1
crazy michael,0,1,0,0,0,0,0,1
crazy uncalculated,0,1,0,0,0,0,0,1
crazy villalpando,0,1,0,0,0,0,0,1
crazy warm,0,0,0,1,0,0,0,1
crazy wild,0,0,0,0,1,0,0,1
create absolute,0,1,0,0,0,0,0,1
create ammonia,0,1,0,0,0,0,0,1
create benefits,1,0,0,0,0,0,0,1
create blended,0,1,0,0,0,0,0,1
create clouds,0,0,0,0,0,0,1,1
create distance,1,0,0,0,0,0,0,1
create habitats,0,0,1,0,0,0,0,1
create heavy,0,0,0,1,0,0,0,1
create local,0,0,0,1,0,0,0,1
create marine,0,0,0,0,0,1,0,1
create pasture,0,1,0,0,0,0,0,1
create safeguards,0,0,0,0,1,0,0,1
create unsustainable,1,0,0,0,0,0,0,1
create windfalls,0,0,0,0,0,1,0,1
created corporate,0,0,1,0,0,0,0,1
created errors,0,0,0,0,1,0,0,1
created rain,0,0,0,0,0,1,0,1
created shell,0,0,1,0,0,0,0,1
created supply,0,0,0,0,0,1,0,1
creates fewer,0,0,1,0,0,0,0,1
creates obstacles,0,0,0,0,1,0,0,1
creating bio,0,1,0,0,0,0,0,1
creating carbon,0,1,0,0,0,0,0,1
creating drier,1,0,0,0,0,0,0,1
creating free,0,0,0,0,1,0,0,1
creating literal,0,0,0,1,0,0,0,1
creating outbreaks,0,0,0,0,0,1,0,1
creating positive,0,0,0,1,0,0,0,1
creating win,0,0,0,0,1,0,0,1
creations reflect,0,1,0,0,0,0,0,1
creator scott,0,0,0,0,0,0,1,1
creatures.lauren sommer,0,0,0,0,0,1,0,1
credibility issues,0,0,0,0,1,0,0,1
credible meaningful,0,1,0,0,0,0,0,1
credible people,0,0,0,0,1,0,0,1
credit nasa,0,1,0,0,0,0,0,1
credit's actual,0,1,0,0,0,0,0,1
creek bed,0,0,0,0,0,1,0,1
creek channel,0,0,0,0,1,0,0,1
creek fire,0,0,0,0,0,0,1,1
creek floodwaters,0,0,0,0,1,0,0,1
creek joint,0,0,0,0,1,0,0,1
creek restoration,0,0,0,0,1,0,0,1
creek rushed,0,1,0,0,0,0,0,1
creek stringed,0,1,0,0,0,0,0,1
creeks farmers,0,0,0,0,0,1,0,1
creeks streams,0,0,0,1,0,0,0,1
creepy alien,0,0,0,0,1,0,0,1
crestline population,0,0,0,0,0,1,0,1
crew approached,0,1,0,0,0,0,0,1
crew meltdown,0,0,1,0,0,0,0,1
crews digging,0,0,0,0,0,0,1,1
crews restored,0,0,0,0,0,0,1,1
crews struggled,0,0,0,1,0,0,0,1
cricket flour,0,0,0,0,0,1,0,1
cricket's call,1,0,0,0,0,0,0,1
crime bills,1,0,0,0,0,0,0,1
criminal proceeding,0,0,0,0,1,0,0,1
criminal prosecution,0,1,0,0,0,0,0,1
crises preserving,0,0,1,0,0,0,0,1
crisis caused,0,1,0,0,0,0,0,1
crisis communications,0,0,0,1,0,0,0,1
crisis dawn,0,0,0,0,0,1,0,1
crisis happened,0,0,0,0,0,1,0,1
crisis hobbs,0,0,0,0,1,0,0,1
crisis hudson,0,1,0,0,0,0,0,1
crisis music,0,1,0,0,0,0,0,1
crisis npr's,0,0,0,0,1,0,0,1
crisis renews,1,0,0,0,0,0,0,1
crisis requires,0,0,0,0,0,1,0,1
crisis shrinking,0,0,0,1,0,0,0,1
crisis southern,1,0,0,0,0,0,0,1
crisis specific,0,0,0,0,1,0,0,1
crisis started,0,0,0,0,1,0,0,1
criterion benchmarks,0,1,0,0,0,0,0,1
critical actions,0,1,0,0,0,0,0,1
critical components,0,0,0,0,1,0,0,1
critical concern,1,0,0,0,0,0,0,1
critical condition,0,0,0,0,0,0,1,1
critical coverage,0,0,1,0,0,0,0,1
critical decade,0,0,0,1,0,0,0,1
critical ecosystems,0,0,0,0,0,1,0,1
critical education,0,0,0,0,0,1,0,1
critical financing,0,0,1,0,0,0,0,1
critical improvements,0,0,0,1,0,0,0,1
critical infrastructure,1,0,0,0,0,0,0,1
critical minerals,0,0,0,0,0,1,0,1
critical piece,0,0,0,1,0,0,0,1
critical predators,0,0,1,0,0,0,0,1
critical priorities,0,1,0,0,0,0,0,1
critical protection,0,1,0,0,0,0,0,1
critical risk,0,1,0,0,0,0,0,1
critical role,1,0,0,0,0,0,0,1
critical sector,0,0,0,0,0,1,0,1
critical services,0,0,0,1,0,0,0,1
critical step,0,0,0,0,0,0,1,1
critical time,0,0,1,0,0,0,0,1
criticism harjeet,0,0,0,1,0,0,0,1
criticisms decades,0,0,0,1,0,0,0,1
criticized government,0,0,0,0,1,0,0,1
critics argue,0,0,1,0,0,0,0,1
critters enjoying,1,0,0,0,0,0,0,1
critters typify,0,0,1,0,0,0,0,1
crocker chief,1,0,0,0,0,0,0,1
cronin harvest,0,0,0,1,0,0,0,1
cronin reports,0,0,0,1,0,0,0,1
crop called,1,0,0,0,0,0,0,1
crop failed,0,1,0,0,0,0,0,1
crop guayule,1,0,0,0,0,0,0,1
crop market,0,1,0,0,0,0,0,1
crop nutrition,1,0,0,0,0,0,0,1
crops atchison,1,0,0,0,0,0,0,1
crops destroyed,0,1,0,0,0,0,0,1
crops ensuring,0,1,0,0,0,0,0,1
crops farming,0,1,0,0,0,0,0,1
crops michael,1,0,0,0,0,0,0,1
crops produced,0,1,0,0,0,0,0,1
cross eu,0,1,0,0,0,0,0,1
cross international,0,1,0,0,0,0,0,1
cross supply,0,1,0,0,0,0,0,1
crossing appealing,0,0,1,0,0,0,0,1
crossing borders,0,1,0,0,0,0,0,1
crossing commemorating,0,0,0,1,0,0,0,1
crossing movement,0,0,1,0,0,0,0,1
crossing oceans,0,1,0,0,0,0,0,1
crosstalk inside,0,0,0,0,0,1,0,1
crosswhite announced,0,0,1,0,0,0,0,1
crowd cheered,0,0,0,0,0,1,0,1
crowded coast,1,0,0,0,0,0,0,1
crowded forests,0,0,1,0,0,0,0,1
crucial community,0,1,0,0,0,0,0,1
crucial crevasses,0,0,0,0,1,0,0,1
crucial fertilizer,1,0,0,0,0,0,0,1
crucial guidance,0,0,0,0,0,1,0,1
crucial military,0,1,0,0,0,0,0,1
crucial moisture,0,0,0,0,0,1,0,1
crucial question,1,0,0,0,0,0,0,1
crucial role,0,1,0,0,0,0,0,1
crude producing,0,0,0,1,0,0,0,1
crude production,0,0,0,0,0,1,0,1
crunches caused,0,0,0,1,0,0,0,1
crunching data,0,0,0,0,0,1,0,1
crunchy patch,0,1,0,0,0,0,0,1
cruz attempted,0,0,0,1,0,0,0,1
cruz professor,0,0,0,1,0,0,0,1
crying toddler,1,0,0,0,0,0,0,1
crying writhing,1,0,0,0,0,0,0,1
cryptocurrency promoter,0,0,0,0,0,1,0,1
cucumbers peppers,0,0,0,1,0,0,0,1
culinary consulting,0,1,0,0,0,0,0,1
culpeper cited,0,0,0,0,1,0,0,1
cultivate food,0,1,0,0,0,0,0,1
cultivated beef,0,1,0,0,0,0,0,1
cultivated food,0,1,0,0,0,0,0,1
cultivated opposition,0,0,0,0,1,0,0,1
cultivating alternative,0,1,0,0,0,0,0,1
cultivating grains,0,1,0,0,0,0,0,1
cultivating meat,0,1,0,0,0,0,0,1
cultivation.kirk siegler,1,0,0,0,0,0,0,1
cultural agency,0,1,0,0,0,0,0,1
cultural conversation,0,0,0,0,0,0,1,1
cultural damage,0,1,0,0,0,0,0,1
cultural heritage,0,1,0,0,0,0,0,1
cultural inheritance,0,0,0,0,0,1,0,1
cultural institutions,0,1,0,0,0,0,0,1
cultural landscape,0,1,0,0,0,0,0,1
cultural mixing,0,1,0,0,0,0,0,1
cultural organization,0,0,0,0,0,1,0,1
cultural recovery,0,1,0,0,0,0,0,1
cultural sites,1,0,0,0,0,0,0,1
cultural structures,0,0,0,0,1,0,0,1
cultural territorial,0,1,0,0,0,0,0,1
cultural traditions,0,0,1,0,0,0,0,1
culturally lost,0,0,0,1,0,0,0,1
culture replaces,1,0,0,0,0,0,0,1
culture reporter,0,1,0,0,0,0,0,1
culture takes,0,0,1,0,0,0,0,1
cultured media,0,1,0,0,0,0,0,1
cultures diets,0,0,0,0,0,1,0,1
culturing animal,0,1,0,0,0,0,0,1
cumulative budget,0,0,0,0,0,0,1,1
cumulative climate,0,1,0,0,0,0,0,1
cumulative emitter,0,1,0,0,0,0,0,1
cup boykoff,0,0,0,1,0,0,0,1
curb climate,0,0,0,0,0,0,1,1
curb future,0,0,0,0,1,0,0,1
curb noise,0,0,1,0,0,0,0,1
curbing global,0,1,0,0,0,0,0,1
curiosity seekers,0,1,0,0,0,0,0,1
curly parsley,0,0,0,0,0,1,0,1
current annual,0,0,0,0,1,0,0,1
current childhood,0,0,0,0,1,0,0,1
current climate,0,0,0,0,0,1,0,1
current demand,1,0,0,0,0,0,0,1
current education,0,0,0,0,1,0,0,1
current efforts,0,0,0,0,0,1,0,1
current emissions,0,0,0,0,0,1,0,1
current events,0,0,0,0,0,1,0,1
current federal,1,0,0,0,0,0,0,1
current fight,0,0,0,0,1,0,0,1
current funding,0,1,0,0,0,0,0,1
current ice,1,0,0,0,0,0,0,1
current levels,0,0,0,0,1,0,0,1
current managing,0,0,0,1,0,0,0,1
current mission,1,0,0,0,0,0,0,1
current pace,0,1,0,0,0,0,0,1
current pledges,1,0,0,0,0,0,0,1
current projections,1,0,0,0,0,0,0,1
current record,0,0,0,0,1,0,0,1
current situation,0,0,0,0,0,0,1,1
current supply,0,0,0,0,0,1,0,1
current thinking,1,0,0,0,0,0,0,1
current totals,0,0,0,1,0,0,0,1
current trends,1,0,0,0,0,0,0,1
current window,0,0,0,1,0,0,0,1
curricula ryan,0,1,0,0,0,0,0,1
curried pumpkin,0,1,0,0,0,0,0,1
curtain fell,0,0,0,0,0,0,1,1
customer service,0,0,1,0,0,0,0,1
customers pay,0,0,0,0,1,0,0,1
customers remained,0,0,0,0,1,0,0,1
cut air,0,1,0,0,0,0,0,1
cut earlier,1,0,0,0,0,0,0,1
cut farmers,0,0,0,0,1,0,0,1
cut global,0,1,0,0,0,0,0,1
cut heat,0,0,0,0,1,0,0,1
cut nitrogen,0,0,0,0,0,1,0,1
cut people,0,0,0,0,0,1,0,1
cut supplies,0,0,0,1,0,0,0,1
cutbacks california,0,0,0,0,0,1,0,1
cute furry,0,0,1,0,0,0,0,1
cutlery annually,0,0,0,1,0,0,0,1
cutlery balloon,0,0,0,1,0,0,0,1
cutlery campaign,0,0,0,1,0,0,0,1
cuts artificial,0,0,0,1,0,0,0,1
cuts inside,1,0,0,0,0,0,0,1
cutting carbon,0,0,1,0,0,0,0,1
cutting climate,0,1,0,0,0,0,0,1
cutting fossil,0,0,0,0,1,0,0,1
cutting jobs,0,0,0,0,0,1,0,1
cycle climate,0,1,0,0,0,0,0,1
cycle hampering,0,0,0,0,0,0,1,1
cycle kirk,1,0,0,0,0,0,0,1
cyclone bhola,0,0,0,0,0,1,0,1
cyclone hit,0,0,0,1,0,0,0,1
cyclone sitrang,0,0,0,0,0,1,0,1
cyclonic envelope,0,1,0,0,0,0,0,1
cynthia campbell,0,0,0,1,0,0,0,1
czerpak walks,0,1,0,0,0,0,0,1
d.c afp,1,0,0,0,0,0,0,1
d.c auto,0,0,0,0,1,0,0,1
d.c circuit,0,1,0,0,0,0,0,1
d.c climate,1,0,0,0,0,0,0,1
d.c follow,0,1,0,0,0,0,0,1
d.c protesters,0,0,0,0,0,1,0,1
d.c ruled,0,1,0,0,0,0,0,1
d.c u.s,0,1,0,0,0,0,0,1
dad's mother,0,0,0,0,0,1,0,1
daddy day,0,0,0,0,0,0,1,1
dado dado,1,0,0,0,0,0,0,1
dado diaa,1,0,0,0,0,0,0,1
dado region,1,0,0,0,0,0,0,1
daily activities,0,0,0,0,0,1,0,1
daily catch,0,1,0,0,0,0,0,1
daily intake,0,1,0,0,0,0,0,1
daily items,0,0,0,1,0,0,0,1
daily line,0,0,1,0,0,0,0,1
daily news,0,0,0,0,0,0,1,1
daily newspapers,0,1,0,0,0,0,0,1
daily record,0,0,0,0,1,0,0,1
daily science,1,0,0,0,0,0,0,1
daily temperature,0,0,0,1,0,0,0,1
daily top,0,0,0,0,0,1,0,1
daimler truck,0,0,1,0,0,0,0,1
daisy yellow,0,0,0,0,0,0,1,1
dakota iowa,0,0,0,0,1,0,0,1
dalan animal,0,0,0,1,0,0,0,1
dalhousie university,0,0,0,0,1,0,0,1
dam owned,1,0,0,0,0,0,0,1
damage aboard,1,0,0,0,0,0,0,1
damage airplanes,0,0,0,0,1,0,0,1
damage assessments,0,1,0,0,0,0,0,1
damage cain,0,1,0,0,0,0,0,1
damage claims,0,1,0,0,0,0,0,1
damage cleetus,0,1,0,0,0,0,0,1
damage climate,0,1,0,0,0,0,0,1
damage compensation,0,1,0,0,0,0,0,1
damage deputy,1,0,0,0,0,0,0,1
damage experts,0,0,0,0,0,1,0,1
damage funding,0,1,0,0,0,0,0,1
damage guilanpour,0,1,0,0,0,0,0,1
damage issue,0,1,0,0,0,0,0,1
damage maria,0,1,0,0,0,0,0,1
damage negotiators,0,1,0,0,0,0,0,1
damage obligations,0,1,0,0,0,0,0,1
damage payments,0,1,0,0,0,0,0,1
damage potentially,0,0,0,1,0,0,0,1
damage saturday,0,1,0,0,0,0,0,1
damage scientists,1,0,0,0,0,0,0,1
damage sean,1,0,0,0,0,0,0,1
damage suffered,0,1,0,0,0,0,0,1
damage weather,0,0,0,1,0,0,0,1
damage yeah,0,0,0,1,0,0,0,1
damage.martí drought,0,0,0,0,1,0,0,1
damaged equipment,0,1,0,0,0,0,0,1
damaged guatemalan,1,0,0,0,0,0,0,1
damaged instruments,0,1,0,0,0,0,0,1
damaged piers,0,1,0,0,0,0,0,1
damaged reefs,0,1,0,0,0,0,0,1
damaged roof,0,1,0,0,0,0,0,1
damaged structures,0,0,0,0,0,1,0,1
damages speaking,0,0,0,0,1,0,0,1
damaging disasters,0,0,0,0,1,0,0,1
damaging effects,0,0,0,1,0,0,0,1
damaging waves,0,1,0,0,0,0,0,1
damaging winds,0,0,0,1,0,0,0,1
dame cathedral,0,0,0,0,0,1,0,1
dan cohan,0,0,0,0,1,0,0,1
dan jung,0,1,0,0,0,0,0,1
dan lamontagne,1,0,0,0,0,0,0,1
dan lashof,0,1,0,0,0,0,0,1
dan pickering,0,0,0,0,1,0,0,1
dan shugar,0,0,0,1,0,0,0,1
dan sullivan,0,0,0,0,0,1,0,1
dana fisher,0,1,0,0,0,0,0,1
dana hunnes,0,1,0,0,0,0,0,1
dance floor,0,1,0,0,0,0,0,1
dance troupe,0,0,0,0,1,0,0,1
dancer top,0,1,0,0,0,0,0,1
dancer tyrone,0,1,0,0,0,0,0,1
dancing bees,0,0,0,0,0,1,0,1
danger anymore,0,0,1,0,0,0,0,1
danger investors,0,1,0,0,0,0,0,1
danger plibersek,0,1,0,0,0,0,0,1
dangerous acceleration,1,0,0,0,0,0,0,1
dangerous air,0,0,0,1,0,0,0,1
dangerous effects,0,0,0,0,0,1,0,1
dangerous game,0,0,0,0,0,1,0,1
dangerous mines,0,0,0,0,1,0,0,1
dangerous mudslides,0,0,0,1,0,0,0,1
dangerous pattern,0,0,0,0,0,1,0,1
dangerous precedent,0,0,0,1,0,0,0,1
dangerous situation,0,0,0,0,0,1,0,1
dangerous storm,0,0,0,0,1,0,0,1
dangerous thoko,0,0,0,0,0,1,0,1
dangerous threat,1,0,0,0,0,0,0,1
dangerous water,0,0,0,0,1,0,0,1
dangerous waters,0,0,0,0,1,0,0,1
dangerous weather,0,1,0,0,0,0,0,1
dangerous wind,0,0,0,0,1,0,0,1
dangerously close,0,1,0,0,0,0,0,1
dangerously hot,0,1,0,0,0,0,0,1
dangerously soft,1,0,0,0,0,0,0,1
daniel bausch,0,0,0,0,0,1,0,1
daniel estrin,0,1,0,0,0,0,0,1
daniel hemel,0,0,0,0,1,0,0,1
daniel hokanson,1,0,0,0,0,0,0,1
daniel lippitt,0,0,0,0,1,0,0,1
daniel montes,0,0,0,1,0,0,0,1
daniel parra,1,0,0,0,0,0,0,1
daniel tait,0,0,1,0,0,0,0,1
danielle touma,1,0,0,0,0,0,0,1
danny depinte,0,0,1,0,0,0,0,1
dantas afp,0,0,1,0,0,0,0,1
dar es,0,0,1,0,0,0,0,1
dardar hopes,1,0,0,0,0,0,0,1
dark asphalt,0,0,0,1,0,0,0,1
dark matter,0,0,0,0,0,1,0,1
dark money,0,0,0,0,1,0,0,1
dark skinned,0,0,0,0,1,0,0,1
darned difference,0,0,0,0,1,0,0,1
darrah bach,1,0,0,0,0,0,0,1
data alongside,0,0,0,1,0,0,0,1
data bushmeat,0,0,0,0,0,1,0,1
data center,0,0,0,0,1,0,0,1
data centers,0,0,0,0,1,0,0,1
data nonprofit,1,0,0,0,0,0,0,1
data organization,0,0,0,0,1,0,0,1
data originally,1,0,0,0,0,0,0,1
data published,1,0,0,0,0,0,0,1
data ranks,0,0,0,1,0,0,0,1
data realities,0,0,0,0,1,0,0,1
data reporter,0,0,0,0,1,0,0,1
data scientist,1,0,0,0,0,0,0,1
data specifically,0,0,0,1,0,0,0,1
data tells,0,0,0,1,0,0,0,1
data tools,0,1,0,0,0,0,0,1
data weather,0,0,0,0,0,0,1,1
date deliveries,0,0,0,0,1,0,0,1
daughter benazir,1,0,0,0,0,0,0,1
daughter crawled,0,0,0,0,0,0,1,1
daughter recalls,0,0,0,0,1,0,0,1
daughter stuck,0,1,0,0,0,0,0,1
daughter's school,0,0,1,0,0,0,0,1
daunting challenges,0,0,0,0,1,0,0,1
daunting doshi's,0,1,0,0,0,0,0,1
daunting task,0,0,0,0,1,0,0,1
david folkenflik,0,0,1,0,0,0,0,1
david freedman,0,0,0,0,0,1,0,1
david goldman,1,0,0,0,0,0,0,1
david kaplan,0,1,0,0,0,0,0,1
david kay,0,1,0,0,0,0,0,1
david king,0,1,0,0,0,0,0,1
david malpass,1,0,0,0,0,0,0,1
david mcnew,0,0,0,1,0,0,0,1
david odisho,0,0,0,0,1,0,0,1
david paterson,0,0,0,0,0,1,0,1
david roth,0,0,0,1,0,0,0,1
david rounce,0,0,0,1,0,0,0,1
davis bought,0,0,0,1,0,0,0,1
davis handed,0,1,0,0,0,0,0,1
davis paid,0,0,0,1,0,0,0,1
davis plans,0,0,0,1,0,0,0,1
davis prime,0,1,0,0,0,0,0,1
davis worries,0,0,0,1,0,0,0,1
davos switzerland,0,0,0,0,0,1,0,1
day ap,0,0,0,0,0,0,1,1
day banks,0,0,0,0,0,1,0,1
day climate,0,0,0,0,0,0,1,1
day davis,0,0,0,1,0,0,0,1
day displace,0,0,0,0,1,0,0,1
day enjoyed,0,0,0,0,0,1,0,1
day ever.but,0,0,0,0,1,0,0,1
day february,0,1,0,0,0,0,0,1
day femilon,0,0,0,0,0,1,0,1
day gas,1,0,0,0,0,0,0,1
day holiday,0,1,0,0,0,0,0,1
day kirk,0,0,0,0,1,0,0,1
day mission,0,1,0,0,0,0,0,1
day models,1,0,0,0,0,0,0,1
day moratorium,0,1,0,0,0,0,0,1
day pass,0,0,1,0,0,0,0,1
day proponents,0,0,0,0,0,1,0,1
day records,0,0,0,0,0,1,0,1
day respite,0,0,0,0,1,0,0,1
day saint,0,0,0,0,1,0,0,1
day slack's,0,0,0,1,0,0,0,1
day steven,0,1,0,0,0,0,0,1
day suffering,0,0,0,1,0,0,0,1
day sunday,0,1,0,0,0,0,0,1
day thursday,1,0,0,0,0,0,0,1
day u.n,0,0,0,0,0,1,0,1
day walk,0,1,0,0,0,0,0,1
day western,0,0,0,0,0,1,0,1
day's classes,1,0,0,0,0,0,0,1
day's news,0,0,0,0,0,1,0,1
days ago,0,0,0,0,1,0,0,1
days causing,0,0,0,1,0,0,0,1
days combined,0,0,0,0,1,0,0,1
days everyday,0,0,0,0,1,0,0,1
days forecasters,0,1,0,0,0,0,0,1
days haoua,0,0,1,0,0,0,0,1
days helping,1,0,0,0,0,0,0,1
days krill,0,0,0,0,0,0,1,1
days liane,0,1,0,0,0,0,0,1
days marked,0,1,0,0,0,0,0,1
days matrix,0,0,1,0,0,0,0,1
days mose,0,0,0,0,1,0,0,1
days national,1,0,0,0,0,0,0,1
days pirani,0,1,0,0,0,0,0,1
days potentially,0,0,0,0,0,1,0,1
days temperatures,0,0,0,0,1,0,0,1
days thankfully,1,0,0,0,0,0,0,1
days walking,0,0,0,1,0,0,0,1
days yeah,0,0,0,1,0,0,0,1
de anda,0,0,0,0,0,1,0,1
de bonds,0,1,0,0,0,0,0,1
de haan,1,0,0,0,0,0,0,1
de lemos,0,0,0,0,1,0,0,1
de perlas,1,0,0,0,0,0,0,1
dead coral,0,1,0,0,0,0,0,1
dead fir,0,0,1,0,0,0,0,1
dead fish,0,0,0,0,1,0,0,1
dead flying,0,0,1,0,0,0,0,1
dead included,0,0,0,0,0,0,1,1
dead inside,0,0,0,0,0,0,1,1
dead livestock,0,0,0,0,0,1,0,1
dead mankani,1,0,0,0,0,0,0,1
dead plants,0,1,0,0,0,0,0,1
dead return,0,0,0,0,0,1,0,1
dead sea's,0,1,0,0,0,0,0,1
dead stalks,0,0,0,0,0,1,0,1
deadliest natural,1,0,0,0,0,0,0,1
deadlines looming,0,0,0,1,0,0,0,1
deadliness david,0,0,0,0,1,0,0,1
deadly bacteria,0,0,0,1,0,0,0,1
deadly blackouts,0,0,0,0,1,0,0,1
deadly disaster,0,0,0,0,1,0,0,1
deadly earthquake,0,1,0,0,0,0,0,1
deadly events,0,1,0,0,0,0,0,1
deadly fungus,0,0,0,0,0,1,0,1
deadly history,1,0,0,0,0,0,0,1
deadly mudslides,0,0,0,1,0,0,0,1
deadly winter,1,0,0,0,0,0,0,1
deal adhiguna,0,0,0,0,1,0,0,1
deal approved,1,0,0,0,0,0,0,1
deal indonesia's,0,0,0,0,1,0,0,1
deal unveiled,0,1,0,0,0,0,0,1
dealership lots,0,0,0,0,1,0,0,1
dear student,0,0,0,0,1,0,0,1
death decisions,0,0,0,0,1,0,0,1
death sentence,0,1,0,0,0,0,0,1
death throes,1,0,0,0,0,0,0,1
death wildlife,0,0,1,0,0,0,0,1
deaths continued,0,0,0,0,0,0,1,1
deaths drought,0,0,1,0,0,0,0,1
deaths heavy,0,0,0,0,0,1,0,1
deaths including,0,0,0,0,0,0,1,1
deaths worldwide,0,0,0,0,1,0,0,1
debate unfolding,0,0,0,0,1,0,0,1
debbie elliott,0,0,0,0,0,1,0,1
debra roberts,0,1,0,0,0,0,0,1
debris blocked,0,0,0,1,0,0,0,1
debris destroyed,1,0,0,0,0,0,0,1
debris flying,0,0,0,0,0,1,0,1
debris hurtling,0,1,0,0,0,0,0,1
debris jeffrey,0,0,0,0,0,0,1,1
debris nets,0,0,0,1,0,0,0,1
debris utility,0,0,0,0,0,0,1,1
debt service,1,0,0,0,0,0,0,1
decade called,0,1,0,0,0,0,0,1
decade carbon,1,0,0,0,0,0,0,1
decade developing,0,1,0,0,0,0,0,1
decade methane,0,1,0,0,0,0,0,1
decade plibersek,0,1,0,0,0,0,0,1
decade supported,0,1,0,0,0,0,0,1
decade supran,0,0,0,1,0,0,0,1
decade window,0,0,0,1,0,0,0,1
decade wow,0,0,0,0,1,0,0,1
decade.the backbone,0,1,0,0,0,0,0,1
decades ahead,0,0,0,0,1,0,0,1
decades alex,0,0,0,1,0,0,0,1
decades centuries,0,1,0,0,0,0,0,1
decades climate,0,0,0,0,0,1,0,1
decades concentrations,1,0,0,0,0,0,0,1
decades countries,0,0,0,0,0,1,0,1
decades denying,0,0,0,1,0,0,0,1
decades derocher,0,0,1,0,0,0,0,1
decades jake,0,0,0,0,1,0,0,1
decades kirk,0,0,0,0,1,0,0,1
decades private,0,0,0,1,0,0,0,1
decades researchers,0,0,0,0,0,1,0,1
decades starting,0,0,0,0,0,0,1,1
decades studying,0,1,0,0,0,0,0,1
decades tracey,0,1,0,0,0,0,0,1
decades water,0,0,0,0,0,1,0,1
decarbonization efforts,0,0,0,0,1,0,0,1
decarbonization goals,0,0,0,1,0,0,0,1
decarbonization reducing,0,0,0,1,0,0,0,1
decarbonization scenario,0,0,0,1,0,0,0,1
decarbonize quicker,0,0,0,0,0,1,0,1
decarbonize society,0,1,0,0,0,0,0,1
decarbonized energy,0,1,0,0,0,0,0,1
deceived investors,0,0,0,1,0,0,0,1
december january,0,0,0,0,0,0,1,1
december president,0,0,0,1,0,0,0,1
decent life,0,0,0,0,0,0,1,1
decent living,0,0,0,0,0,0,1,1
decent shot,0,0,1,0,0,0,0,1
decentralized nature,0,0,0,0,0,1,0,1
deceptive story,0,0,0,1,0,0,0,1
decided step,0,1,0,0,0,0,0,1
decimated half,0,1,0,0,0,0,0,1
decimated lettuce,0,0,0,0,0,1,0,1
decision left,0,1,0,0,0,0,0,1
decision white,0,0,0,0,0,1,0,1
decisions including,0,0,0,1,0,0,0,1
decisions indisputably,0,0,0,1,0,0,0,1
decisive decade,0,1,0,0,0,0,0,1
deck tourists,0,1,0,0,0,0,0,1
declared broad,0,0,0,0,0,0,1,1
declared disaster,0,0,0,1,0,0,0,1
declared safe,0,1,0,0,0,0,0,1
decline questions,0,0,1,0,0,0,0,1
decline yeah,0,1,0,0,0,0,0,1
decline.to talk,0,0,1,0,0,0,0,1
declined npr,0,0,0,0,1,0,0,1
declining birth,0,1,0,0,0,0,0,1
declining funding,0,0,0,0,0,0,1,1
declining infant,0,1,0,0,0,0,0,1
declining sea,0,0,1,0,0,0,0,1
decoupled urban,0,0,0,0,1,0,0,1
decrease americans,1,0,0,0,0,0,0,1
decreased likelihood,0,1,0,0,0,0,0,1
dedicated activists,0,0,0,1,0,0,0,1
deemed insensitive,1,0,0,0,0,0,0,1
deemed worth,1,0,0,0,0,0,0,1
deep anger,0,0,0,1,0,0,0,1
deep concepts,1,0,0,0,0,0,0,1
deep connection,0,1,0,0,0,0,0,1
deep cuts,0,0,1,0,0,0,0,1
deep love,0,1,0,0,0,0,0,1
deep political,0,0,0,1,0,0,0,1
deep south,0,0,0,0,0,0,1,1
deep ties,0,0,0,0,1,0,0,1
deep underneath,1,0,0,0,0,0,0,1
deep water,0,0,0,0,0,1,0,1
deepening low,0,0,0,0,1,0,0,1
deeper cup,0,0,0,0,0,0,1,1
deeper issues,0,0,0,0,0,1,0,1
deeply concerned,1,0,0,0,0,0,0,1
deeply connected,0,0,0,0,0,1,0,1
deeply familiar,1,0,0,0,0,0,0,1
deeply red,0,0,1,0,0,0,0,1
deer crafted,0,1,0,0,0,0,0,1
deer populations,0,0,0,0,0,1,0,1
defamation league,0,0,0,0,0,1,0,1
default jervois,1,0,0,0,0,0,0,1
defeat alabama,0,0,1,0,0,0,0,1
defeating democrats,1,0,0,0,0,0,0,1
defeating solar,0,0,0,0,1,0,0,1
defense company,0,0,0,1,0,0,0,1
defense department's,0,0,0,0,1,0,0,1
defense focusing,0,0,0,0,1,0,0,1
defense issues,0,0,0,1,0,0,0,1
defense minister,0,0,0,1,0,0,0,1
defense stuff,0,1,0,0,0,0,0,1
define climate,1,0,0,0,0,0,0,1
defines tornadoes,0,0,0,0,0,1,0,1
deforestation carl,0,0,0,0,0,0,1,1
deforestation dramatically,0,0,0,0,0,0,1,1
deforestation reduces,0,0,0,0,0,0,1,1
deforestation surge,0,0,0,0,0,0,1,1
defra statistics,0,0,0,1,0,0,0,1
defra told,0,0,0,1,0,0,0,1
defra's plans,0,0,0,1,0,0,0,1
defunct nord,0,0,1,0,0,0,0,1
defunct sunshine,0,0,1,0,0,0,0,1
degree rise,0,0,0,1,0,0,0,1
degrees called,0,0,0,1,0,0,0,1
degrees centigrade,0,1,0,0,0,0,0,1
degrees cooler,1,0,0,0,0,0,0,1
degrees empire,0,0,0,0,1,0,0,1
degrees hotter,0,0,0,1,0,0,0,1
degrees methane,0,1,0,0,0,0,0,1
degrees saturday,0,0,0,0,1,0,0,1
degrees warmer,0,0,0,1,0,0,0,1
degrove wrote,1,0,0,0,0,0,0,1
delaware sought,0,0,0,1,0,0,0,1
delaware told,1,0,0,0,0,0,0,1
delaware's college,1,0,0,0,0,0,0,1
delay action,0,0,0,0,0,1,0,1
delay emissions,0,0,1,0,0,0,0,1
delay federal,0,0,0,1,0,0,0,1
delay locks,0,0,0,0,1,0,0,1
delay putting,0,1,0,0,0,0,0,1
delay rehman,0,1,0,0,0,0,0,1
delayed adopting,0,0,1,0,0,0,0,1
delayed federal,0,1,0,0,0,0,0,1
delegates expect,0,0,1,0,0,0,0,1
delegating legislative,1,0,0,0,0,0,0,1
delemont switzerland,0,0,0,1,0,0,0,1
delicious tastes,0,1,0,0,0,0,0,1
delirium massive,0,0,0,0,0,1,0,1
deliver financial,0,1,0,0,0,0,0,1
deliver food,0,1,0,0,0,0,0,1
deliver power,0,0,0,1,0,0,0,1
deliver water,0,0,0,0,0,1,0,1
deliver yeah,0,1,0,0,0,0,0,1
delivered humanitarian,1,0,0,0,0,0,0,1
delivers moments,0,0,1,0,0,0,0,1
delivers public,0,1,0,0,0,0,0,1
delivery efforts,1,0,0,0,0,0,0,1
delivery kit,1,0,0,0,0,0,0,1
delivery system,0,1,0,0,0,0,0,1
delivery tank,0,0,0,0,1,0,0,1
delivery truck,0,0,0,0,0,1,0,1
delta region,0,1,0,0,0,0,0,1
deluge reporter,0,0,0,0,0,1,0,1
demand action.in,0,0,0,1,0,0,0,1
demand change,0,0,0,0,1,0,0,1
demand drastic,0,0,0,0,1,0,0,1
demand peak,0,1,0,0,0,0,0,1
demand porter,0,0,0,0,1,0,0,1
demand water,0,0,0,1,0,0,0,1
demanding unsuccessfully,0,0,0,0,0,1,0,1
demands federal,0,0,1,0,0,0,0,1
demands tied,0,0,0,0,0,0,1,1
demeaning losers,0,0,0,0,1,0,0,1
democrat announced,0,0,0,1,0,0,0,1
democrat kyrsten,0,1,0,0,0,0,0,1
democrat released,0,0,0,0,1,0,0,1
democrat tina,1,0,0,0,0,0,0,1
democrat's climate,0,0,0,0,0,1,0,1
democratic chancellor,0,0,1,0,0,0,0,1
democratic governor,0,0,0,0,1,0,0,1
democratic incumbents,0,1,0,0,0,0,0,1
democratic party,0,0,1,0,0,0,0,1
democratic representative,0,0,0,0,0,1,0,1
democrats continued,1,0,0,0,0,0,0,1
democrats embrace,0,0,1,0,0,0,0,1
democrats lose,0,1,0,0,0,0,0,1
democrats passed,0,0,1,0,0,0,0,1
democrats secured,0,0,0,0,0,0,1,1
demographers predict,0,0,0,0,1,0,0,1
demographic dividends,0,1,0,0,0,0,0,1
demolishing houses,0,1,0,0,0,0,0,1
demonstration pumping,0,1,0,0,0,0,0,1
demonstrations happened,0,0,0,0,0,1,0,1
demonstrations jeff,0,1,0,0,0,0,0,1
denia escutia,0,0,0,0,0,0,1,1
denies matrix,0,0,1,0,0,0,0,1
dense city,0,0,0,1,0,0,0,1
dense inland,0,0,0,0,0,1,0,1
dense population,0,0,0,0,0,1,0,1
dense traffic,0,0,0,0,0,1,0,1
densely populated,0,0,0,0,0,1,0,1
dented emissions,1,0,0,0,0,0,0,1
dented grey,0,1,0,0,0,0,0,1
denver phoenix,0,0,0,1,0,0,0,1
denver public,0,1,0,0,0,0,0,1
denver sorensen,0,1,0,0,0,0,0,1
depart quietly,0,0,0,0,1,0,0,1
department called,0,0,0,1,0,0,0,1
department director,0,1,0,0,0,0,0,1
department initially,0,0,0,0,0,1,0,1
department initiative,0,1,0,0,0,0,0,1
department offers,0,0,0,0,0,1,0,1
department official,0,0,0,0,1,0,0,1
department radio,0,1,0,0,0,0,0,1
department spokesperson,0,0,0,1,0,0,0,1
department stores,0,0,0,0,0,1,0,1
department told,0,0,0,0,0,1,0,1
department typically,0,0,0,0,1,0,0,1
department's announcement,0,0,0,0,1,0,0,1
department's commitment,0,0,0,1,0,0,0,1
departments benton,0,0,0,0,1,0,0,1
depaul university,0,0,0,1,0,0,0,1
depend integrally,0,1,0,0,0,0,0,1
depends partly,0,1,0,0,0,0,0,1
depicting worst,0,0,0,0,0,0,1,1
depleted groundwater,0,0,0,0,1,0,0,1
deploy technologies,0,0,1,0,0,0,0,1
deploying phony,0,0,1,0,0,0,0,1
deposited money,0,1,0,0,0,0,0,1
deposited sediment,0,1,0,0,0,0,0,1
deposits called,0,0,0,0,1,0,0,1
deposits run,0,1,0,0,0,0,0,1
depth research,0,0,0,1,0,0,0,1
deputy assistant,1,0,0,0,0,0,0,1
deputy defense,0,0,0,1,0,0,0,1
deputy technical,0,0,0,0,1,0,0,1
deregulated energy,0,0,0,0,1,0,0,1
derek maiden,0,0,0,0,1,0,0,1
des migrants,0,1,0,0,0,0,0,1
des plaines,0,0,0,0,1,0,0,1
desalinated drinking,0,1,0,0,0,0,0,1
desalination plants,0,0,0,1,0,0,0,1
desalination water,0,1,0,0,0,0,0,1
desalted water,0,0,0,1,0,0,0,1
desantis agreed,0,1,0,0,0,0,0,1
desantis political,0,0,0,1,0,0,0,1
desantis ultimately,0,0,1,0,0,0,0,1
desantis visited,1,0,0,0,0,0,0,1
describe situations,0,0,0,1,0,0,0,1
describes themself,1,0,0,0,0,0,0,1
desert expanses,0,0,0,1,0,0,0,1
desert gorsuch,0,0,0,0,0,1,0,1
desert housing,0,0,0,0,1,0,0,1
desert lies,0,0,0,0,1,0,0,1
desert lots,0,0,0,0,1,0,0,1
desert rubber,1,0,0,0,0,0,0,1
desert southwest,1,0,0,0,0,0,0,1
desert traveling,1,0,0,0,0,0,0,1
design guidelines,0,0,0,1,0,0,0,1
designate marine,0,0,0,0,1,0,0,1
designation degrove,1,0,0,0,0,0,0,1
designed armored,0,0,0,1,0,0,0,1
designed community,0,1,0,0,0,0,0,1
designer visual,0,1,0,0,0,0,0,1
designers touted,0,0,0,0,1,0,0,1
designing building,0,0,0,0,0,1,0,1
designing communities,0,0,0,0,0,1,0,1
desk common,0,0,0,1,0,0,0,1
desk lauren,0,0,0,1,0,0,0,1
desk talk,0,1,0,0,0,0,0,1
desk teamed,1,0,0,0,0,0,0,1
desktop computer,0,0,0,0,0,1,0,1
desperate searching,0,0,1,0,0,0,0,1
desperately waiting,0,0,0,0,0,0,1,1
desperation lund,1,0,0,0,0,0,0,1
destabilize sending,0,1,0,0,0,0,0,1
destroy habitats,0,0,1,0,0,0,0,1
destroyed cain,0,1,0,0,0,0,0,1
destroyed destroyed,0,1,0,0,0,0,0,1
destroyed john,0,1,0,0,0,0,0,1
destroyed roads,1,0,0,0,0,0,0,1
destroyed victoria,1,0,0,0,0,0,0,1
destroying instruments,0,1,0,0,0,0,0,1
destroying neighborhoods,0,1,0,0,0,0,0,1
destruction left,1,0,0,0,0,0,0,1
destructive earthquakes,0,1,0,0,0,0,0,1
destructive hail,1,0,0,0,0,0,0,1
destructive wildfires,1,0,0,0,0,0,0,1
detailed list,0,0,1,0,0,0,0,1
detailed map,0,1,0,0,0,0,0,1
detailed requests,0,0,1,0,0,0,0,1
details online,0,1,0,0,0,0,0,1
details reeder,0,1,0,0,0,0,0,1
detain mother,0,1,0,0,0,0,0,1
detainee population,0,0,0,0,1,0,0,1
detect methane,0,1,0,0,0,0,0,1
detergent bottles,1,0,0,0,0,0,0,1
determination habeck,0,0,1,0,0,0,0,1
determine average,0,0,0,1,0,0,0,1
determined contributions,0,1,0,0,0,0,0,1
detrimental hot,0,0,0,1,0,0,0,1
deutz director,0,0,1,0,0,0,0,1
devastate bees,0,0,0,1,0,0,0,1
devastate crops,0,0,0,0,0,1,0,1
devastated coastal,1,0,0,0,0,0,0,1
devastated communities,0,0,0,0,0,0,1,1
devastated rolling,0,0,0,0,0,1,0,1
devastating effects,0,0,0,1,0,0,0,1
devastating landslide,0,0,0,1,0,0,0,1
devastating news,0,0,0,0,0,1,0,1
devastating portrayals,0,0,1,0,0,0,0,1
devastating war,0,1,0,0,0,0,0,1
devastating wildfires,0,0,0,1,0,0,0,1
devastation throws,0,0,0,1,0,0,0,1
develop common,0,0,0,0,1,0,0,1
develop controls,0,0,0,0,1,0,0,1
develop products,0,0,0,1,0,0,0,1
develop workforce,0,0,0,0,0,1,0,1
developed economies,0,1,0,0,0,0,0,1
developed marco,1,0,0,0,0,0,0,1
developed reflex,0,0,0,1,0,0,0,1
developed resilience,0,0,1,0,0,0,0,1
developed shorelines,0,1,0,0,0,0,0,1
developers disliked,1,0,0,0,0,0,0,1
developers paid,1,0,0,0,0,0,0,1
developers pay,1,0,0,0,0,0,0,1
developing actual,0,0,0,0,1,0,0,1
developing asthma,0,0,0,0,1,0,0,1
developing cleaner,0,0,0,1,0,0,0,1
developing comprehensive,0,1,0,0,0,0,0,1
developing country,0,1,0,0,0,0,0,1
developing groundbreaking,0,0,1,0,0,0,0,1
developing labeling,0,1,0,0,0,0,0,1
developing means,0,1,0,0,0,0,0,1
developing nation,0,0,0,0,1,0,0,1
developing refrigerant,0,0,0,0,0,0,1,1
development calls,0,0,0,0,0,1,0,1
development droz,0,0,0,0,1,0,0,1
development encroaching,0,0,1,0,0,0,0,1
development experts,0,1,0,0,0,0,0,1
development gaesser,0,0,0,0,1,0,0,1
development goals,0,1,0,0,0,0,0,1
development grosso,1,0,0,0,0,0,0,1
development half,0,1,0,0,0,0,0,1
development industry,1,0,0,0,0,0,0,1
development job,0,0,0,0,0,1,0,1
development organization,0,0,0,0,1,0,0,1
development permits,0,0,0,0,0,1,0,1
development phase,0,1,0,0,0,0,0,1
development pressure,1,0,0,0,0,0,0,1
development projects,0,0,0,0,0,1,0,1
development seth,0,0,0,0,1,0,0,1
development site,0,0,0,0,0,1,0,1
development surveys,0,0,0,0,1,0,0,1
development susan,0,0,0,0,1,0,0,1
development xcel,0,1,0,0,0,0,0,1
developments paving,1,0,0,0,0,0,0,1
develops diagnostic,0,0,0,0,0,1,0,1
deven upadhyay,1,0,0,0,0,0,0,1
dfc committed,0,1,0,0,0,0,0,1
dfc government,0,1,0,0,0,0,0,1
dfc support,0,1,0,0,0,0,0,1
dhabi npr's,0,0,0,1,0,0,0,1
dhabi's outskirts,0,0,0,1,0,0,0,1
dhabi's sovereign,0,0,0,1,0,0,0,1
dhaka barua,0,0,0,0,0,1,0,1
dhaka fatima,0,0,0,0,0,1,0,1
dhaka majida,0,0,0,0,0,1,0,1
dhaka salam,0,0,0,0,0,1,0,1
dhaka university,0,0,0,0,0,1,0,1
dhaka's flood,0,0,0,0,0,1,0,1
di ammonium,1,0,0,0,0,0,0,1
diablo canyon,0,0,0,1,0,0,0,1
diagnose unhealthy,0,0,1,0,0,0,0,1
diagnostic tests,0,0,0,0,0,1,0,1
dialogue npr's,0,1,0,0,0,0,0,1
dialogue reviewing,0,0,0,0,0,1,0,1
diamond flooded,0,1,0,0,0,0,0,1
diamond shaped,0,0,0,0,0,1,0,1
diarrhea zinat,1,0,0,0,0,0,0,1
diaspora explore,0,0,0,1,0,0,0,1
dicaro research,0,0,0,0,0,1,0,1
dice loaded,0,0,0,0,0,1,0,1
dichek ap,0,0,0,0,1,0,0,1
die alpha,1,0,0,0,0,0,0,1
die globally,0,0,0,0,1,0,0,1
die gora,0,0,1,0,0,0,0,1
die leaving,0,0,0,1,0,0,0,1
died ashley,0,0,0,0,0,0,1,1
died husein,0,1,0,0,0,0,0,1
died troy,0,0,0,1,0,0,0,1
died wednesday,0,0,0,0,1,0,0,1
diego álvarez,0,0,0,0,0,1,0,1
diego based,1,0,0,0,0,0,0,1
diego counties,0,0,0,0,1,0,0,1
diego meredith,0,1,0,0,0,0,0,1
diego office,0,0,0,0,1,0,0,1
diego's scripps,0,0,0,1,0,0,0,1
diesel fleet,0,0,0,0,1,0,0,1
diesel truck,0,1,0,0,0,0,0,1
diesel vehicles,0,0,1,0,0,0,0,1
dieye's friends,0,0,0,0,1,0,0,1
dieye's warnings,0,0,0,0,1,0,0,1
diffenbaugh study,0,0,0,1,0,0,0,1
difference lauren,0,0,0,1,0,0,0,1
difficult abdo,0,1,0,0,0,0,0,1
difficult include,0,0,0,0,0,1,0,1
difficult pill,1,0,0,0,0,0,0,1
difficult position,1,0,0,0,0,0,0,1
difficult question,0,1,0,0,0,0,0,1
difficult questions,0,0,0,0,0,1,0,1
difficult situations,0,0,0,0,1,0,0,1
difficult tumiwa,0,0,0,0,1,0,0,1
dig tunnels,0,1,0,0,0,0,0,1
digit percentage,0,0,0,0,0,1,0,1
digital attention,0,0,0,0,0,1,0,1
digital blackboard,0,0,0,1,0,0,0,1
digital jail,0,0,0,0,0,1,0,1
digital platforms,0,0,1,0,0,0,0,1
digital tech,0,0,1,0,0,0,0,1
digitize stuff,0,1,0,0,0,0,0,1
digitized portions,0,1,0,0,0,0,0,1
dil afrose,0,0,0,0,0,1,0,1
dilkins windsor,0,0,0,0,0,1,0,1
dillen added,0,0,0,0,0,1,0,1
diminish atkinson,0,0,1,0,0,0,0,1
diminish sorensen,0,1,0,0,0,0,0,1
diminishing sea,1,0,0,0,0,0,0,1
diminishing stocks,1,0,0,0,0,0,0,1
dining hall,0,1,0,0,0,0,0,1
dinner goats,1,0,0,0,0,0,0,1
dior speaking,0,1,0,0,0,0,0,1
dioxide accumulating,0,0,0,0,0,1,0,1
dioxide emitted,0,0,0,1,0,0,0,1
dioxide equivalent,0,0,0,0,1,0,0,1
dioxide specifically,0,0,0,0,1,0,0,1
diplomatically loss,0,0,0,0,1,0,0,1
diplomats campaigners,0,1,0,0,0,0,0,1
dire people,0,1,0,0,0,0,0,1
dire situation,0,0,0,0,0,1,0,1
dire straits,0,1,0,0,0,0,0,1
direct agencies,1,0,0,0,0,0,0,1
direct funding,0,0,0,1,0,0,0,1
direct hit,0,1,0,0,0,0,0,1
direct lines,0,0,0,0,1,0,0,1
direct payments,0,1,0,0,0,0,0,1
direct revenues,0,1,0,0,0,0,0,1
direct supervisor,0,0,0,0,1,0,0,1
direct threat,0,1,0,0,0,0,0,1
directly address,0,0,0,0,0,1,0,1
directly alongside,0,0,0,0,0,1,0,1
directly connect,0,0,0,0,0,1,0,1
directly infect,0,0,0,0,0,1,0,1
directly influence,1,0,0,0,0,0,0,1
directly interact,0,1,0,0,0,0,0,1
directly providing,0,0,0,1,0,0,0,1
directly undermine,0,0,0,0,0,1,0,1
director athan,0,0,0,0,0,1,0,1
director edina,0,0,0,0,1,0,0,1
director focused,0,0,1,0,0,0,0,1
director kim,0,0,0,1,0,0,0,1
director martha,1,0,0,0,0,0,0,1
director nick,0,0,0,0,0,1,0,1
director partnered,0,1,0,0,0,0,0,1
director rick,0,0,1,0,0,0,0,1
director robert,0,0,0,0,0,1,0,1
director shaye,1,0,0,0,0,0,0,1
director stands,0,1,0,0,0,0,0,1
dirt floors,0,0,0,0,0,1,0,1
dirt patches,0,0,0,1,0,0,0,1
dirt plots,0,0,0,1,0,0,0,1
dirt road,1,0,0,0,0,0,0,1
dirty combustible,1,0,0,0,0,0,0,1
dirty job,0,0,0,0,1,0,0,1
dirty trucks,0,0,0,0,0,1,0,1
disabilities included,0,0,0,0,1,0,0,1
disadvantaged communities,0,0,0,1,0,0,0,1
disappear national,0,0,1,0,0,0,0,1
disappearing brine,0,0,0,0,1,0,0,1
disappearing coral,0,1,0,0,0,0,0,1
disappearing ice,0,0,0,0,0,1,0,1
disappearing languages,0,0,0,1,0,0,0,1
disappearing polar,0,0,1,0,0,0,0,1
disappearing snow,0,1,0,0,0,0,0,1
disaster agency,1,0,0,0,0,0,0,1
disaster airlift,0,0,0,0,0,1,0,1
disaster bolendra,0,1,0,0,0,0,0,1
disaster create,0,0,0,0,0,1,0,1
disaster crunch,0,0,0,0,1,0,0,1
disaster declaration,0,0,0,0,0,1,0,1
disaster declarations,0,1,0,0,0,0,0,1
disaster figuring,0,1,0,0,0,0,0,1
disaster geography,0,0,0,0,0,1,0,1
disaster geologist,0,1,0,0,0,0,0,1
disaster killed,0,1,0,0,0,0,0,1
disaster picturing,0,0,0,0,0,0,1,1
disaster preparedness,1,0,0,0,0,0,0,1
disaster prone,1,0,0,0,0,0,0,1
disaster ravaged,0,1,0,0,0,0,0,1
disaster recreational,0,1,0,0,0,0,0,1
disaster requires,0,0,0,1,0,0,0,1
disaster responses,0,0,0,0,0,0,1,1
disaster workers,0,0,0,0,0,1,0,1
disasters al,0,0,0,1,0,0,0,1
disasters cathy,0,0,0,0,0,0,1,1
disasters displace,0,1,0,0,0,0,0,1
disasters european,0,0,0,1,0,0,0,1
disasters floods,0,0,0,0,1,0,0,1
disasters guterres,0,1,0,0,0,0,0,1
disasters leaders,0,1,0,0,0,0,0,1
disasters pakistan,0,1,0,0,0,0,0,1
disasters pleas,0,1,0,0,0,0,0,1
disasters ripping,0,0,0,0,0,1,0,1
disasters strike,1,0,0,0,0,0,0,1
disasters worldwide,1,0,0,0,0,0,0,1
discarded oyster,1,0,0,0,0,0,0,1
disciplined analysis,0,0,0,1,0,0,0,1
discombobulating lin's,0,1,0,0,0,0,0,1
discuss creating,0,1,0,0,0,0,0,1
discuss local,0,0,0,1,0,0,0,1
discuss national,0,0,0,0,0,1,0,1
discuss ventilation,0,0,0,0,1,0,0,1
discussed bills,0,0,0,0,1,0,0,1
discussed earlier,0,0,0,1,0,0,0,1
discussion lawmakers,0,0,0,0,0,0,1,1
disease american,0,0,0,1,0,0,0,1
disease pesticides,0,0,0,1,0,0,0,1
disease prevention,0,0,0,0,0,1,0,1
disease samples,0,0,0,0,0,1,0,1
disease specialist,0,0,0,0,1,0,0,1
disgraced lobbyist,0,0,0,0,1,0,0,1
disheartening mariah,0,1,0,0,0,0,0,1
disinformation campaign,0,0,0,1,0,0,0,1
disinformation researcher,0,0,0,0,0,1,0,1
disintegrate snow,0,1,0,0,0,0,0,1
disobedience fisher,0,1,0,0,0,0,0,1
disobedience peaceful,0,1,0,0,0,0,0,1
disparity leaves,0,1,0,0,0,0,0,1
dispatch connor,1,0,0,0,0,0,0,1
dispatched ambulances,1,0,0,0,0,0,0,1
dispersed encampments,0,1,0,0,0,0,0,1
displace native,0,0,1,0,0,0,0,1
displaced children,1,0,0,0,0,0,0,1
displaced people,0,1,0,0,0,0,0,1
displaced trees,0,1,0,0,0,0,0,1
displaced women,1,0,0,0,0,0,0,1
displacement exacerbates,0,0,0,0,1,0,0,1
disposable metal,0,0,0,1,0,0,0,1
disposal costs,0,0,0,1,0,0,0,1
disproportionate damage,0,0,0,0,0,1,0,1
disproportionate effects,0,0,0,0,0,1,0,1
disproportionate health,0,1,0,0,0,0,0,1
disproportionately affecting,0,0,1,0,0,0,0,1
disproportionately bearing,0,1,0,0,0,0,0,1
disproportionately devastating,0,0,0,1,0,0,0,1
disproportionately impacted,0,0,0,1,0,0,0,1
disproportionately suffering,0,0,1,0,0,0,0,1
disrupted food,0,1,0,0,0,0,0,1
disrupted global,0,1,0,0,0,0,0,1
disrupted utility,0,0,0,0,0,1,0,1
disrupting daily,0,0,0,0,0,1,0,1
disrupting streams,0,1,0,0,0,0,0,1
disruption yeah,0,0,0,0,1,0,0,1
disruptions officials,1,0,0,0,0,0,0,1
disruptions yellen,1,0,0,0,0,0,0,1
disruptive acts,0,1,0,0,0,0,0,1
disruptive protests,0,0,1,0,0,0,0,1
disruptive steps,0,0,0,1,0,0,0,1
distance compared,0,0,0,0,0,1,0,1
distance oregon,1,0,0,0,0,0,0,1
distance travel,0,0,0,0,1,0,0,1
distant world,0,1,0,0,0,0,0,1
distinct issues,1,0,0,0,0,0,0,1
distinct possibility,0,0,0,0,0,1,0,1
distressed families,0,0,0,0,1,0,0,1
distressing redundancy,0,1,0,0,0,0,0,1
distribute benefits,0,0,0,1,0,0,0,1
distributed china,0,1,0,0,0,0,0,1
distributed meaning,0,0,0,1,0,0,0,1
distributing cold,0,0,0,0,1,0,0,1
distribution centers,0,0,0,0,1,0,0,1
distribution quality,0,0,1,0,0,0,0,1
district attorney,0,1,0,0,0,0,0,1
district promised,0,1,0,0,0,0,0,1
district supplies,0,0,0,1,0,0,0,1
district wide,0,1,0,0,0,0,0,1
distrust people,0,0,0,0,1,0,0,1
distrust ryan,0,0,0,0,1,0,0,1
ditch cars,0,0,1,0,0,0,0,1
dive sala,0,1,0,0,0,0,0,1
dive teams,0,1,0,0,0,0,0,1
diverse ecosystems,1,0,0,0,0,0,0,1
diverse forests,1,0,0,0,0,0,0,1
diversity cbd,0,0,1,0,0,0,0,1
diversity fifty,0,0,1,0,0,0,0,1
diversity remember,0,0,1,0,0,0,0,1
diverted water,0,0,0,0,1,0,0,1
diverting pumpkins,0,1,0,0,0,0,0,1
diverting water,0,0,0,0,0,1,0,1
divided government,0,0,0,0,1,0,0,1
division noaa's,0,0,0,1,0,0,0,1
djawou bou,1,0,0,0,0,0,0,1
dmitriew wrote,0,0,1,0,0,0,0,1
dmytro kuleba,0,0,0,1,0,0,0,1
dock onshore,1,0,0,0,0,0,0,1
doctor waiting,0,0,1,0,0,0,0,1
doctor's visit,0,0,0,1,0,0,0,1
document recognizes,0,0,1,0,0,0,0,1
document released,0,1,0,0,0,0,0,1
document urban,0,0,0,1,0,0,0,1
documentary films,0,1,0,0,0,0,0,1
documentation local,1,0,0,0,0,0,0,1
documented record,1,0,0,0,0,0,0,1
documenting progress,0,1,0,0,0,0,0,1
documents including,0,0,1,0,0,0,0,1
documents indigenous,0,0,1,0,0,0,0,1
documents obtained,0,0,1,0,0,0,0,1
documents quilts,0,1,0,0,0,0,0,1
documents ran,0,0,0,0,0,1,0,1
doe proposed,0,0,0,0,1,0,0,1
doe's national,0,0,0,1,0,0,0,1
dogs resumed,1,0,0,0,0,0,0,1
doj operates,0,0,0,1,0,0,0,1
doll mankani,1,0,0,0,0,0,0,1
dollar disasters,0,0,0,1,0,0,0,1
dollar pieces,0,0,0,0,0,0,1,1
dollar project,0,0,0,1,0,0,0,1
dollars compared,0,1,0,0,0,0,0,1
dollars promoting,0,0,1,0,0,0,0,1
dollars spent,0,0,0,0,1,0,0,1
dollars worth,0,0,0,0,1,0,0,1
dollars yearly,0,1,0,0,0,0,0,1
dolomites france's,0,1,0,0,0,0,0,1
dolphins sperm,0,0,0,0,0,1,0,1
domestic development,1,0,0,0,0,0,0,1
domestic investment,0,1,0,0,0,0,0,1
domestic oil,1,0,0,0,0,0,0,1
domestic yaks,0,1,0,0,0,0,0,1
dominance democrats,1,0,0,0,0,0,0,1
dominant producers,0,0,0,0,0,1,0,1
dominated election,0,1,0,0,0,0,0,1
dominated headlines,0,0,0,0,0,1,0,1
dominion energy,0,0,1,0,0,0,0,1
dominique crenn,0,1,0,0,0,0,0,1
domino effect,0,0,0,0,0,0,1,1
domonoske joins,0,0,0,0,1,0,0,1
domonoske reports,0,0,1,0,0,0,0,1
don lemon,0,1,0,0,0,0,0,1
don myer,0,1,0,0,0,0,0,1
donald dardar,1,0,0,0,0,0,0,1
donate blood,0,0,0,0,1,0,0,1
donated tent,0,1,0,0,0,0,0,1
donation drop,0,0,0,0,0,1,0,1
donevan christine,0,0,0,1,0,0,0,1
donevan matt,0,1,0,0,0,0,0,1
donevan noah,0,1,0,0,0,0,0,1
donna howard,0,0,0,0,1,0,0,1
door neighbor,0,0,0,0,0,1,0,1
door requesting,0,0,1,0,0,0,0,1
door slack's,0,0,0,1,0,0,0,1
doors conners,0,0,0,0,0,1,0,1
dora mathews,0,0,1,0,0,0,0,1
doreen sandoval,1,0,0,0,0,0,0,1
dorian destroyed,0,1,0,0,0,0,0,1
doshi rallied,0,1,0,0,0,0,0,1
doshi's advice,0,1,0,0,0,0,0,1
double counted,0,1,0,0,0,0,0,1
double counting,0,1,0,0,0,0,0,1
double digit,0,0,0,0,0,1,0,1
double fisting,0,0,0,0,1,0,0,1
double whammy,0,0,0,0,0,1,0,1
double wide,0,0,0,1,0,0,0,1
doubt brown,0,0,0,1,0,0,0,1
doug lewin,0,0,0,0,1,0,0,1
doug reeder,0,1,0,0,0,0,0,1
dough covered,0,0,0,0,1,0,0,1
douglas fir,0,0,0,0,0,1,0,1
douglas jerolmack,0,0,0,1,0,0,0,1
douglas magno,0,0,0,0,0,0,1,1
douglass martin,0,1,0,0,0,0,0,1
downfall caused,0,0,0,1,0,0,0,1
downpour hit,0,0,0,1,0,0,0,1
downpours guillermo,1,0,0,0,0,0,0,1
downstream effects,0,0,0,0,0,1,0,1
downstream explains,0,0,0,0,0,1,0,1
downstream saline,0,0,0,0,1,0,0,1
downstream water,0,0,0,0,0,1,0,1
downtown boston,0,0,0,0,0,1,0,1
downtown charleston,0,1,0,0,0,0,0,1
downtown houston,1,0,0,0,0,0,0,1
downtown ottawa,0,0,0,0,1,0,0,1
downtowns college,1,0,0,0,0,0,0,1
dozen boys,0,1,0,0,0,0,0,1
dozen cars,0,0,0,0,1,0,0,1
dozen conservative,0,0,0,0,1,0,0,1
dozen counties,0,0,0,0,0,1,0,1
dozen dead,0,0,0,0,1,0,0,1
dozen demonstrators,0,1,0,0,0,0,0,1
dozen eastern,0,0,0,0,1,0,0,1
dozen indonesian,0,0,0,0,1,0,0,1
dozen interviews,0,0,1,0,0,0,0,1
dozen leaks,1,0,0,0,0,0,0,1
dozen military,0,1,0,0,0,0,0,1
dozen reported,1,0,0,0,0,0,0,1
dozen shelters,0,1,0,0,0,0,0,1
dps students,0,1,0,0,0,0,0,1
dr brian,0,0,0,0,1,0,0,1
dr daniel,0,0,0,0,0,1,0,1
dr david,0,0,0,0,0,1,0,1
dr hoesung,0,0,0,0,0,1,0,1
dr kelsey,0,1,0,0,0,0,0,1
dr king,0,0,0,1,0,0,0,1
dr lee,0,0,0,0,0,1,0,1
dr rosalyn,0,1,0,0,0,0,0,1
dr tedros,0,0,0,0,0,1,0,1
draft document,0,1,0,0,0,0,0,1
draft earlier,0,0,1,0,0,0,0,1
draft framework,0,0,1,0,0,0,0,1
draft legislation,0,0,0,0,1,0,0,1
draft petitions,0,0,0,0,1,0,0,1
draft plan,0,1,0,0,0,0,0,1
draft regulations,1,0,0,0,0,0,0,1
draft version,0,1,0,0,0,0,0,1
drag belong,1,0,0,0,0,0,0,1
dragging people,0,1,0,0,0,0,0,1
dragonflies hover,0,1,0,0,0,0,0,1
drainage pipes,0,1,0,0,0,0,0,1
drainage systems,1,0,0,0,0,0,0,1
drained lake,0,0,0,0,0,1,0,1
drained reservoirs,0,0,0,0,0,1,0,1
draining overnight,0,1,0,0,0,0,0,1
drama u.s,0,0,0,0,1,0,0,1
dramatic cuts,0,0,1,0,0,0,0,1
dramatic housing,0,0,0,0,1,0,0,1
dramatic increase,0,0,0,0,0,1,0,1
dramatic progress,0,1,0,0,0,0,0,1
dramatic purposes,0,0,1,0,0,0,0,1
dramatic recovery,0,0,1,0,0,0,0,1
dramatic shift,1,0,0,0,0,0,0,1
dramatic topics,0,0,1,0,0,0,0,1
dramatic warming,0,0,1,0,0,0,0,1
dramatically curtailed,0,0,0,1,0,0,0,1
dramatically cut,0,1,0,0,0,0,0,1
dramatically decreased,0,0,0,0,0,0,1,1
dramatically increase,0,0,0,0,1,0,0,1
dramatically increased,0,0,0,1,0,0,0,1
dramatically reduce,0,0,0,1,0,0,0,1
dramaturgical challenges,0,0,1,0,0,0,0,1
drastic alternatives,0,1,0,0,0,0,0,1
drastically reduce,0,0,0,0,0,0,1,1
draw firm,0,0,0,0,0,1,0,1
drawing criticism,0,0,0,1,0,0,0,1
drawn scorn,0,0,0,0,0,1,0,1
draws heavily,0,1,0,0,0,0,0,1
dream skating,0,0,0,0,1,0,0,1
dreamer connecticut,0,0,0,0,1,0,0,1
dredge hurley,0,1,0,0,0,0,0,1
drenched california,0,0,0,1,0,0,0,1
dress includes,1,0,0,0,0,0,0,1
dress's body,1,0,0,0,0,0,0,1
drew dilkins,0,0,0,0,0,1,0,1
drew ire,0,0,0,0,0,1,0,1
drexel university,0,0,0,1,0,0,0,1
dried cow,0,0,0,0,0,1,0,1
dried lakebed,0,0,0,0,1,0,0,1
drier ashley,0,0,0,0,0,1,0,1
drier conditions,0,0,0,0,0,1,0,1
drier edges,0,0,0,0,0,1,0,1
drier future,0,0,1,0,0,0,0,1
drier putting,0,0,0,0,0,1,0,1
drier reality,0,0,0,0,1,0,0,1
drier times,0,0,0,0,0,1,0,1
drier weather,0,0,0,0,0,0,1,1
drier world,1,0,0,0,0,0,0,1
drill offshore,0,0,0,0,0,1,0,1
drill oil,0,0,0,0,0,1,0,1
drilling ban,1,0,0,0,0,0,0,1
drilling pads,0,0,0,0,0,1,0,1
drilling plan,0,0,0,0,0,1,0,1
drilling rigs,0,0,0,1,0,0,0,1
drilling sites,0,0,0,0,0,1,0,1
drink coffee,0,0,0,1,0,0,0,1
drink peatlands,0,0,1,0,0,0,0,1
drinking cooking,0,0,0,0,0,1,0,1
drinking riverboats,0,0,0,0,0,1,0,1
drip irrigation,0,0,0,0,0,1,0,1
drive economic,0,0,0,0,1,0,0,1
drive forward,0,0,0,1,0,0,0,1
drive major,0,1,0,0,0,0,0,1
drive northeast,0,0,0,0,1,0,0,1
drive short,0,0,0,1,0,0,0,1
drive traffic,0,0,0,0,1,0,0,1
driven climate,0,0,0,1,0,0,0,1
driven disaster,0,1,0,0,0,0,0,1
driven flood,0,1,0,0,0,0,0,1
driven floods,0,1,0,0,0,0,0,1
driven global,0,1,0,0,0,0,0,1
driven weather,0,1,0,0,0,0,0,1
driver harold,0,0,0,1,0,0,0,1
driver heads,0,0,0,0,0,1,0,1
driver transporting,1,0,0,0,0,0,0,1
driver's life,0,1,0,0,0,0,0,1
drivers enduringly,0,0,0,0,1,0,0,1
drives climate,0,0,0,0,1,0,0,1
drives water,0,0,0,0,0,1,0,1
driveway fill,0,0,0,1,0,0,0,1
driveway saturday,0,1,0,0,0,0,0,1
driveway shoveler,0,0,0,0,0,1,0,1
driveways fill,0,0,0,1,0,0,0,1
driving behavior,0,0,0,0,1,0,0,1
driving development,0,0,0,0,1,0,0,1
driving emissions,0,0,0,1,0,0,0,1
driving force,0,0,0,0,1,0,0,1
driving global,0,1,0,0,0,0,0,1
driving habits,0,1,0,0,0,0,0,1
driving home,0,0,0,1,0,0,0,1
driving miles,0,0,0,1,0,0,0,1
drop significantly,1,0,0,0,0,0,0,1
drop thumb,0,1,0,0,0,0,0,1
drop willow's,0,0,0,0,0,1,0,1
droplets dust,0,0,0,0,0,1,0,1
dropped rain,0,1,0,0,0,0,0,1
dropping populations,0,1,0,0,0,0,0,1
dropping snow,0,0,0,0,1,0,0,1
drops low,0,0,0,1,0,0,0,1
drought alex,0,0,0,1,0,0,0,1
drought brought,0,0,0,0,0,1,0,1
drought california,1,0,0,0,0,0,0,1
drought climate,0,0,0,1,0,0,0,1
drought drained,0,0,0,0,0,1,0,1
drought emergency.martí,0,0,0,0,1,0,0,1
drought ensuring,0,1,0,0,0,0,0,1
drought exacerbated,0,0,0,0,0,1,0,1
drought flood,0,0,0,0,0,0,1,1
drought free,0,0,0,0,0,1,0,1
drought impacts,0,0,0,0,1,0,0,1
drought levels,0,0,0,0,0,1,0,1
drought management,0,0,0,0,1,0,0,1
drought matt,0,0,0,0,0,1,0,1
drought means,0,0,0,1,0,0,0,1
drought mindset,0,0,0,0,0,1,0,1
drought mired,0,0,0,1,0,0,0,1
drought mitigation,0,0,1,0,0,0,0,1
drought monitor,0,0,0,0,0,1,0,1
drought monitor's,0,0,0,0,0,1,0,1
drought parched,0,0,0,1,0,0,0,1
drought reduced,0,0,0,0,0,0,1,1
drought resiliency,0,0,0,1,0,0,0,1
drought resistant,0,0,1,0,0,0,0,1
drought seemingly,0,0,0,0,1,0,0,1
drought stricken,0,0,0,1,0,0,0,1
drought warnings,0,0,0,0,0,1,0,1
droughts andrew,0,0,0,0,0,1,0,1
droughts flooding,0,0,0,0,0,1,0,1
droughts groundwater,0,0,0,0,0,1,0,1
droz calls,0,0,0,0,1,0,0,1
droz cultivated,0,0,0,0,1,0,0,1
droz helped,0,0,0,0,1,0,0,1
droz raises,0,0,0,0,1,0,0,1
droz shared,0,0,0,0,1,0,0,1
droz's website,0,0,0,0,1,0,0,1
drum beats,0,0,0,1,0,0,0,1
dry cleaners,0,1,0,0,0,0,0,1
dry climate,0,0,0,0,1,0,0,1
dry ground,0,0,1,0,0,0,0,1
dry inside,1,0,0,0,0,0,0,1
dry patch,0,1,0,0,0,0,0,1
dry season,0,0,0,0,0,1,0,1
dry spell,0,0,1,0,0,0,0,1
dry stay,0,0,0,1,0,0,0,1
dry times,0,0,0,0,0,1,0,1
dry weather,0,1,0,0,0,0,0,1
du plessis,0,0,1,0,0,0,0,1
duarte ceo,0,1,0,0,0,0,0,1
dubai environmental,0,0,0,1,0,0,0,1
dubai highlighting,0,0,0,1,0,0,0,1
dubai nov,0,0,0,0,0,1,0,1
dubai's expo,0,0,0,1,0,0,0,1
dubai's real,0,0,0,1,0,0,0,1
dubbed stovegate,0,0,0,1,0,0,0,1
dubious articles,0,0,0,0,1,0,0,1
ducey proposed,0,0,0,1,0,0,0,1
duck session,0,1,0,0,0,0,0,1
duke energy,0,0,1,0,0,0,0,1
duke spokesperson,0,0,1,0,0,0,0,1
dulcimer developed,0,1,0,0,0,0,0,1
dulcimer line,0,1,0,0,0,0,0,1
dulcimer museum,0,1,0,0,0,0,0,1
dull blade,0,0,0,0,0,1,0,1
dumoulin smith,0,0,1,0,0,0,0,1
dumped rain,0,1,0,0,0,0,0,1
dumped torrential,1,0,0,0,0,0,0,1
dumping feet,0,1,0,0,0,0,0,1
dumping heavy,0,1,0,0,0,0,0,1
dumping massive,0,0,0,1,0,0,0,1
duncan callaway,0,0,0,0,0,0,1,1
dung directly,0,1,0,0,0,0,0,1
dunn ran,0,0,1,0,0,0,0,1
dunn's defeat,0,0,1,0,0,0,0,1
durable harder,0,0,0,0,1,0,0,1
duration convective,0,0,0,0,1,0,0,1
dust pollution,0,0,0,0,1,0,0,1
dust soot,1,0,0,0,0,0,0,1
duty engines,0,0,1,0,0,0,0,1
duty sales,0,0,1,0,0,0,0,1
duty truck,0,0,1,0,0,0,0,1
dwellings civic,0,0,0,0,1,0,0,1
dwindling hurricanes,0,0,0,0,0,1,0,1
dying empire,0,1,0,0,0,0,0,1
dying scientists,0,0,0,0,1,0,0,1
dying trees,0,0,1,0,0,0,0,1
dylan sloan,0,0,1,0,0,0,0,1
dynamics inside,1,0,0,0,0,0,0,1
dynamite hoping,0,0,0,0,1,0,0,1
e3g indonesia,0,0,0,0,1,0,0,1
earlier days,0,1,0,0,0,0,0,1
earlier declared,0,0,0,0,0,0,1,1
earlier generations,0,0,0,0,0,0,1,1
earlier husein,0,1,0,0,0,0,0,1
earlier monday,1,0,0,0,0,0,0,1
earlier online,0,0,0,0,0,1,0,1
earlier storms,0,0,0,0,0,1,0,1
earlier tuesday,0,1,0,0,0,0,0,1
earliest instances,0,0,0,0,0,1,0,1
earliest people,1,0,0,0,0,0,0,1
earnings profits,0,1,0,0,0,0,0,1
earth approaches,0,1,0,0,0,0,0,1
earth called,0,0,0,0,0,1,0,1
earth climate,0,1,0,0,0,0,0,1
earth continues,0,0,1,0,0,0,0,1
earth depends,0,0,1,0,0,0,0,1
earth elements,0,0,0,1,0,0,0,1
earth kenya,0,1,0,0,0,0,0,1
earth lingers,0,1,0,0,0,0,0,1
earth metals,0,0,0,0,0,1,0,1
earth minerals,0,1,0,0,0,0,0,1
earth observatory,0,0,0,0,1,0,0,1
earth warms,1,0,0,0,0,0,0,1
earth's changing,0,0,0,0,0,1,0,1
earth's climate,0,0,0,0,0,1,0,1
earth's ice,1,0,0,0,0,0,0,1
earth's seas,0,0,0,0,0,1,0,1
earth's system,0,0,1,0,0,0,0,1
earth's temperature,0,1,0,0,0,0,0,1
earthen mounds,1,0,0,0,0,0,0,1
earthen water,1,0,0,0,0,0,0,1
earthjustice welcomed,0,0,0,0,0,1,0,1
earthquake meeting,0,1,0,0,0,0,0,1
earthquake passed,1,0,0,0,0,0,0,1
earthquake shook,0,1,0,0,0,0,0,1
earthquake swayam,0,1,0,0,0,0,0,1
earthquakes centered,0,1,0,0,0,0,0,1
earthquakes occur,1,0,0,0,0,0,0,1
earthquakes puerto,1,0,0,0,0,0,0,1
earths production,0,0,0,1,0,0,0,1
ease california's,0,0,0,0,1,0,0,1
ease drought,0,0,0,0,1,0,0,1
easier sell,0,0,0,0,1,0,0,1
easiest punching,0,0,0,0,0,1,0,1
easily accomplished,0,0,1,0,0,0,0,1
easily address,0,0,0,0,1,0,0,1
easily miss,0,0,1,0,0,0,0,1
easily online,0,0,0,0,1,0,0,1
easing winter,0,0,0,1,0,0,0,1
east african,0,1,0,0,0,0,0,1
east bay,0,0,0,1,0,0,0,1
east el,1,0,0,0,0,0,0,1
east gov,0,0,0,1,0,0,0,1
east leading,0,0,0,0,0,1,0,1
east palestine,0,0,0,0,0,0,1,1
east pit,0,1,0,0,0,0,0,1
east rare,0,0,0,0,1,0,0,1
east syria,0,1,0,0,0,0,0,1
east triggering,0,0,0,0,0,1,0,1
east yard,0,0,0,0,0,1,0,1
eastern europe,0,0,0,0,0,1,0,1
eastern georgia,0,0,0,0,0,1,0,1
eastern india,0,0,0,0,1,0,0,1
eastern kentuckians,0,1,0,0,0,0,0,1
eastern kentucky's,0,1,0,0,0,0,0,1
eastern kenya,0,1,0,0,0,0,0,1
eastern larger,0,0,0,0,1,0,0,1
eastern mississippi,0,0,0,0,0,1,0,1
eastern sierra,0,0,0,0,1,0,0,1
eastern texas,0,0,0,0,0,1,0,1
eastern tropical,0,0,0,0,0,0,1,1
eastern u.s,1,0,0,0,0,0,0,1
eastern ukraine,0,1,0,0,0,0,0,1
eastward gensini,0,0,0,0,0,1,0,1
easy cheese,0,0,0,1,0,0,0,1
easy compared,0,0,0,0,0,1,0,1
easy fix,0,1,0,0,0,0,0,1
easy question,0,0,0,1,0,0,0,1
easy sell,1,0,0,0,0,0,0,1
eat honey,0,0,0,1,0,0,0,1
eat live,0,0,0,0,0,1,0,1
eat people,0,1,0,0,0,0,0,1
eat turnips,0,0,0,0,0,1,0,1
eaten raw,0,0,0,0,0,1,0,1
eating animals,0,1,0,0,0,0,0,1
eating bugs,0,0,0,0,0,1,0,1
eating dinner,0,1,0,0,0,0,0,1
eating meat,0,0,0,1,0,0,0,1
eating worms,0,0,0,0,0,1,0,1
ebola burial,0,0,0,0,0,1,0,1
echo chamber,0,0,1,0,0,0,0,1
echo chambers,0,0,0,0,1,0,0,1
echo park,0,0,0,0,1,0,0,1
echoed yellen,0,1,0,0,0,0,0,1
eco thriller,0,0,0,0,0,0,1,1
ecological connectivity,0,0,1,0,0,0,0,1
ecological footprint,0,0,0,1,0,0,0,1
ecological knowledge,0,0,0,0,0,1,0,1
ecological reserves,1,0,0,0,0,0,0,1
ecological strategies,0,0,1,0,0,0,0,1
ecologist evan,0,0,1,0,0,0,0,1
ecologist helene,0,0,1,0,0,0,0,1
ecologist steve,0,0,1,0,0,0,0,1
economic benefits,0,1,0,0,0,0,0,1
economic boom,0,0,0,0,1,0,0,1
economic calculus,0,0,1,0,0,0,0,1
economic conditions,0,1,0,0,0,0,0,1
economic consequences,0,1,0,0,0,0,0,1
economic empowerment,0,1,0,0,0,0,0,1
economic environmental,0,1,0,0,0,0,0,1
economic fallout,0,0,0,0,1,0,0,1
economic forum's,0,0,0,0,0,1,0,1
economic incentives,0,0,0,0,0,0,1,1
economic indicators,0,0,0,0,0,1,0,1
economic influence,0,0,0,0,0,1,0,1
economic issue,0,0,0,0,0,1,0,1
economic losses,0,0,0,0,1,0,0,1
economic opportunities,0,0,0,0,0,1,0,1
economic pain,0,0,0,0,1,0,0,1
economic policy,0,1,0,0,0,0,0,1
economic pressure,0,0,0,0,1,0,0,1
economic question,0,1,0,0,0,0,0,1
economic relief,0,0,0,0,0,1,0,1
economic research,0,0,0,0,0,1,0,1
economic strain,1,0,0,0,0,0,0,1
economic trade,0,0,0,1,0,0,0,1
economical anymore,0,0,0,0,0,1,0,1
economically advantageous,0,0,0,1,0,0,0,1
economically benefited,0,0,1,0,0,0,0,1
economically recycled,1,0,0,0,0,0,0,1
economically tillis,0,1,0,0,0,0,0,1
economics analysis,1,0,0,0,0,0,0,1
economics continue,1,0,0,0,0,0,0,1
economies continue,0,0,0,0,1,0,0,1
economies scientists,0,1,0,0,0,0,0,1
economists caveat,0,0,0,0,0,1,0,1
economists worry,0,1,0,0,0,0,0,1
economy allowing,0,0,0,1,0,0,0,1
economy bernard,0,0,0,0,1,0,0,1
economy built,0,0,0,0,0,1,0,1
economy contributing,0,0,0,0,0,1,0,1
economy earlier,0,0,1,0,0,0,0,1
economy forward,0,1,0,0,0,0,0,1
economy including,0,1,0,0,0,0,0,1
economy initiative,1,0,0,0,0,0,0,1
economy randolph,0,1,0,0,0,0,0,1
economy wide,0,0,1,0,0,0,0,1
ecosystem bleaching,0,1,0,0,0,0,0,1
ecosystem studies,0,0,1,0,0,0,0,1
ecosystem tree,0,0,0,0,0,0,1,1
ecosystems analysts,0,0,0,0,1,0,0,1
ecosystems averbeck,0,0,0,0,0,0,1,1
ecosystems created,0,1,0,0,0,0,0,1
ecosystems improving,0,0,0,0,0,1,0,1
ecosystems meyers,0,0,0,0,1,0,0,1
ecosystems upstream,0,0,0,0,0,1,0,1
ecuador's galapagos,0,0,1,0,0,0,0,1
ed white,1,0,0,0,0,0,0,1
eddie wilder,1,0,0,0,0,0,0,1
edelson afp,0,0,0,1,0,0,0,1
edge eastward,0,0,0,0,0,1,0,1
edina minn,0,0,0,0,1,0,0,1
edited image,0,0,1,0,0,0,0,1
edition deane,1,0,0,0,0,0,0,1
edition's steve,0,1,0,0,0,0,0,1
editor gisele,0,1,0,0,0,0,0,1
editor tom,0,0,1,0,0,0,0,1
editor's note,0,1,0,0,0,0,0,1
editorial coverage,0,0,0,1,0,0,0,1
editorial viewpoint,0,0,1,0,0,0,0,1
editors operating,0,0,1,0,0,0,0,1
edmund pettus,0,0,0,1,0,0,0,1
educate individuals,1,0,0,0,0,0,0,1
educate students,0,1,0,0,0,0,0,1
education aimed,0,0,1,0,0,0,0,1
education center,0,1,0,0,0,0,0,1
education council,0,0,0,0,1,0,0,1
education crisis,0,0,0,0,1,0,0,1
education family,0,1,0,0,0,0,0,1
education police,0,0,0,0,0,1,0,1
educational scientific,0,0,0,0,0,1,0,1
educator adds,0,0,0,0,1,0,0,1
educators craftspeople,0,1,0,0,0,0,0,1
ef scale,0,0,0,0,0,1,0,1
effect methane,1,0,0,0,0,0,0,1
effect related,0,0,0,0,0,0,1,1
effect wednesday,0,1,0,0,0,0,0,1
effective messengers,0,1,0,0,0,0,0,1
effective promotes,0,1,0,0,0,0,0,1
effective truck,0,0,1,0,0,0,0,1
effective vaccine,0,0,0,0,0,1,0,1
effectively banning,0,0,0,0,1,0,0,1
effectively derives,0,0,1,0,0,0,0,1
effects climate,0,0,0,1,0,0,0,1
effects jay,0,1,0,0,0,0,0,1
effervescent mind,0,1,0,0,0,0,0,1
efficiency heat,0,0,0,0,0,0,1,1
efficiency improve,0,0,0,0,1,0,0,1
efficiency projects.but,0,0,0,1,0,0,0,1
efficiency standards,0,0,0,0,1,0,0,1
efficient burner,0,0,0,0,1,0,0,1
efficient burners,0,0,0,1,0,0,0,1
efficient economy,0,0,0,0,0,0,1,1
efficient electric,0,0,0,0,0,0,1,1
efficient fixtures,0,0,0,0,0,1,0,1
efficient irrigation,0,0,0,0,0,1,0,1
efficient machines,0,0,0,0,0,0,1,1
efficient pathway,0,1,0,0,0,0,0,1
effort supported,1,0,0,0,0,0,0,1
efforts focused,0,0,0,0,1,0,0,1
efforts human,0,1,0,0,0,0,0,1
efforts people,1,0,0,0,0,0,0,1
efforts u.s,1,0,0,0,0,0,0,1
efforts underway,0,0,0,1,0,0,0,1
efforts yellen,1,0,0,0,0,0,0,1
eggs pliny,0,0,0,0,0,1,0,1
egypt alex,0,1,0,0,0,0,0,1
egypt climate,0,0,1,0,0,0,0,1
egypt frans,0,1,0,0,0,0,0,1
egypt global,0,1,0,0,0,0,0,1
egypt libya,0,1,0,0,0,0,0,1
egypt people,0,1,0,0,0,0,0,1
egypt peter,0,0,0,1,0,0,0,1
egypt's authoritarian,0,1,0,0,0,0,0,1
egypt's foreign,0,0,0,1,0,0,0,1
egypt's lead,0,1,0,0,0,0,0,1
egypt's record,0,1,0,0,0,0,0,1
egyptian british,0,1,0,0,0,0,0,1
egyptian government,0,1,0,0,0,0,0,1
egyptian officials,0,1,0,0,0,0,0,1
egyptian photographer,0,0,0,0,1,0,0,1
eighth grader,0,0,0,1,0,0,0,1
eileen white,0,0,0,1,0,0,0,1
el mofty,0,1,0,0,0,0,0,1
el salvadorans,1,0,0,0,0,0,0,1
el sisi,0,1,0,0,0,0,0,1
el sissi,0,1,0,0,0,0,0,1
elaborate plumbing,1,0,0,0,0,0,0,1
elder documented,0,0,0,0,0,1,0,1
elderly people,0,1,0,0,0,0,0,1
elderly villagers,1,0,0,0,0,0,0,1
elders smile,0,0,0,0,0,1,0,1
eleanor hey,0,1,0,0,0,0,0,1
elected leaders,0,0,0,1,0,0,0,1
elected officials,0,0,0,0,1,0,0,1
elected president,1,0,0,0,0,0,0,1
elected republican,0,0,0,0,1,0,0,1
election claiming,0,0,0,0,1,0,0,1
election coverage,0,1,0,0,0,0,0,1
election issues,0,1,0,0,0,0,0,1
election season,1,0,0,0,0,0,0,1
election seasons,0,0,1,0,0,0,0,1
electoral process,0,0,0,0,1,0,0,1
electric bass,0,1,0,0,0,0,0,1
electric battery,0,0,0,0,0,1,0,1
electric bills,0,0,0,0,1,0,0,1
electric burner,0,0,0,1,0,0,0,1
electric generators,0,0,0,0,1,0,0,1
electric heat,0,0,0,0,0,0,1,1
electric jeff,0,0,0,1,0,0,0,1
electric market,0,0,0,0,1,0,0,1
electric plans,0,0,0,0,1,0,0,1
electric read,0,0,0,1,0,0,0,1
electric reliability,0,0,0,0,1,0,0,1
electric system,0,0,0,1,0,0,0,1
electric truck,0,0,1,0,0,0,0,1
electric trucks,0,0,1,0,0,0,0,1
electricity bills,0,0,1,0,0,0,0,1
electricity cement,0,0,0,0,0,1,0,1
electricity customers,0,0,0,0,1,0,0,1
electricity demand,0,0,1,0,0,0,0,1
electricity fuel,0,0,0,0,1,0,0,1
electricity power,0,0,0,1,0,0,0,1
electricity prices,0,0,1,0,0,0,0,1
electricity produced,0,0,0,1,0,0,0,1
electricity production,0,0,0,0,1,0,0,1
electricity rates,0,0,1,0,0,0,0,1
electricity sources,0,1,0,0,0,0,0,1
electricity supply,0,0,0,1,0,0,0,1
electricity system,0,0,0,1,0,0,0,1
electricity that’s,0,0,0,1,0,0,0,1
electricity viana,0,0,0,1,0,0,0,1
electrification missik,0,0,0,0,1,0,0,1
electrifying buildings,0,0,0,0,1,0,0,1
electron corporation,0,0,0,0,1,0,0,1
electronic music,0,0,0,1,0,0,0,1
elects democratic,1,0,0,0,0,0,0,1
elegant solution,1,0,0,0,0,0,0,1
elephants rhinos,0,0,1,0,0,0,0,1
eleuthera remained,0,1,0,0,0,0,0,1
elevated political,0,0,0,0,0,1,0,1
elevated train,0,0,0,1,0,0,0,1
elevation conifers,0,0,0,0,0,1,0,1
elevation warmer,0,0,0,0,0,1,0,1
elevations matt,0,0,0,0,0,1,0,1
elfin skittish,0,0,1,0,0,0,0,1
eli imadali,0,1,0,0,0,0,0,1
eliane hall,0,1,0,0,0,0,0,1
eliminate emissions,0,1,0,0,0,0,0,1
eliminate heat,0,0,0,0,1,0,0,1
eliminate natural,0,1,0,0,0,0,0,1
eliminate poverty,0,1,0,0,0,0,0,1
eliminating avoidable,0,0,0,1,0,0,0,1
elise joshi,0,0,0,0,0,1,0,1
elk river,0,1,0,0,0,0,0,1
elle kurancid,0,0,0,0,1,0,0,1
ellen hanak,0,0,0,0,0,1,0,1
ellen klas,0,0,1,0,0,0,0,1
ellen macarthur,1,0,0,0,0,0,0,1
eller retired,0,0,0,0,1,0,0,1
elliott management,0,0,0,0,1,0,0,1
elliott reported,0,0,0,0,0,1,0,1
elusive treaty,0,0,0,0,1,0,0,1
elysia garcia,0,0,0,0,1,0,0,1
em perry,0,0,0,0,1,0,0,1
ema lawsuit,0,0,1,0,0,0,0,1
ema led,0,0,1,0,0,0,0,1
ema president,0,0,1,0,0,0,0,1
ema truck,0,0,1,0,0,0,0,1
email amtrak,1,0,0,0,0,0,0,1
email ema,0,0,1,0,0,0,0,1
email interview,0,0,0,1,0,0,0,1
email maue,0,0,0,1,0,0,0,1
email newsletter,0,0,1,0,0,0,0,1
email ryan,0,0,0,0,1,0,0,1
emailing shortwave,0,0,0,0,0,1,0,1
emails obtained,0,0,1,0,0,0,0,1
embassy shouted,0,1,0,0,0,0,0,1
embed equality,0,0,0,0,0,1,0,1
embrace republican,0,0,1,0,0,0,0,1
embracing plastic,1,0,0,0,0,0,0,1
embracing thinner,0,0,1,0,0,0,0,1
emergencies programme,0,0,0,0,0,1,0,1
emergency assistance,0,0,0,0,0,1,0,1
emergency backup,0,0,0,0,1,0,0,1
emergency climate,0,0,0,0,0,1,0,1
emergency declaration,0,0,0,0,0,1,0,1
emergency department,0,0,0,0,1,0,0,1
emergency due,0,0,0,0,0,1,0,1
emergency earlier,0,0,0,0,0,1,0,1
emergency manager,0,1,0,0,0,0,0,1
emergency negotiations,0,0,0,0,0,1,0,1
emergency plan,0,0,0,1,0,0,0,1
emergency plans,0,0,0,1,0,0,0,1
emergency rescues,1,0,0,0,0,0,0,1
emergency responder,0,1,0,0,0,0,0,1
emergency shelters,0,0,0,0,1,0,0,1
emergency spokesperson,0,0,0,1,0,0,0,1
emergency tied,0,0,0,0,0,1,0,1
emergency warming,0,0,0,0,1,0,0,1
emergency warning,0,0,0,0,0,1,0,1
emergency.martí hayley,0,0,0,0,1,0,0,1
emerging industry,0,1,0,0,0,0,0,1
emerging technology,0,0,0,0,1,0,0,1
emeryville calif,0,1,0,0,0,0,0,1
emily hey,0,0,0,0,1,0,0,1
emily olson,0,0,0,0,0,1,0,1
emily russell,0,0,0,0,1,0,0,1
emirates hard,0,0,0,1,0,0,0,1
emirates late,0,0,0,1,0,0,0,1
emirates leader,0,0,0,0,0,1,0,1
emirates wam,0,0,0,1,0,0,0,1
emission estimates,0,1,0,0,0,0,0,1
emission free,0,0,0,0,1,0,0,1
emission medium,0,0,1,0,0,0,0,1
emission reduction,0,1,0,0,0,0,0,1
emission technologies,0,0,1,0,0,0,0,1
emission trucks,0,0,0,0,0,1,0,1
emission vehicle,0,0,1,0,0,0,0,1
emissions california,0,1,0,0,0,0,0,1
emissions compensate,0,1,0,0,0,0,0,1
emissions conference,0,1,0,0,0,0,0,1
emissions cuts,0,0,0,1,0,0,0,1
emissions dropped,0,1,0,0,0,0,0,1
emissions economy,0,0,1,0,0,0,0,1
emissions electric,0,0,0,0,0,1,0,1
emissions endanger,0,0,0,0,1,0,0,1
emissions estimates,0,1,0,0,0,0,0,1
emissions european,0,0,0,0,0,1,0,1
emissions fall,0,0,0,1,0,0,0,1
emissions future,0,0,1,0,0,0,0,1
emissions goals,0,0,0,1,0,0,0,1
emissions happen,0,1,0,0,0,0,0,1
emissions hotspots,0,1,0,0,0,0,0,1
emissions including,0,1,0,0,0,0,0,1
emissions increase,0,1,0,0,0,0,0,1
emissions individual,0,0,0,0,1,0,0,1
emissions influencemap,0,0,1,0,0,0,0,1
emissions investors,0,0,0,0,0,0,1,1
emissions levels,0,1,0,0,0,0,0,1
emissions limits,0,0,0,0,0,1,0,1
emissions mckibben,0,0,0,0,0,1,0,1
emissions methane,1,0,0,0,0,0,0,1
emissions newsom,0,0,0,0,0,1,0,1
emissions peak,0,0,0,0,0,1,0,1
emissions poland,0,0,0,0,0,1,0,1
emissions prime,0,1,0,0,0,0,0,1
emissions rapidly,0,0,0,0,0,1,0,1
emissions relative,0,1,0,0,0,0,0,1
emissions requirements,0,0,1,0,0,0,0,1
emissions research,1,0,0,0,0,0,0,1
emissions rising,0,1,0,0,0,0,0,1
emissions rose,0,0,0,1,0,0,0,1
emissions threatening,0,1,0,0,0,0,0,1
emissions today's,0,1,0,0,0,0,0,1
emissions tool,0,1,0,0,0,0,0,1
emit fewer,0,0,0,1,0,0,0,1
emits pollution,0,0,0,1,0,0,0,1
emitted harmful,0,0,0,0,1,0,0,1
emitting carbon,0,0,0,0,1,0,0,1
emitting greenhouse,0,1,0,0,0,0,0,1
emitting projects,1,0,0,0,0,0,0,1
emitting sites,0,1,0,0,0,0,0,1
emma ignaszewski,0,0,1,0,0,0,0,1
emomali rahmon,0,0,0,0,0,1,0,1
emotional response,0,1,0,0,0,0,0,1
emphasize talking,0,0,0,0,1,0,0,1
empire joughin,0,1,0,0,0,0,0,1
employee purchased,0,0,1,0,0,0,0,1
employees manufacturing,0,1,0,0,0,0,0,1
employees pull,0,0,0,0,0,1,0,1
employers added,0,0,0,0,0,1,0,1
empower women,0,1,0,0,0,0,0,1
empowering women,0,1,0,0,0,0,0,1
empty container,0,0,0,1,0,0,0,1
empty lots,0,0,0,0,1,0,0,1
empty space,0,0,0,1,0,0,0,1
empty stomachs,0,0,1,0,0,0,0,1
empty streets,0,0,0,1,0,0,0,1
empty talk,0,0,0,0,1,0,0,1
emulate maryland,1,0,0,0,0,0,0,1
enable indonesia,0,0,0,0,1,0,0,1
enables buildings,1,0,0,0,0,0,0,1
enabling developing,0,1,0,0,0,0,0,1
enact restrictions,1,0,0,0,0,0,0,1
enacted measures,0,0,0,1,0,0,0,1
enacting laws,1,0,0,0,0,0,0,1
encampment established,1,0,0,0,0,0,0,1
encampment's entrance,1,0,0,0,0,0,0,1
encampment's religious,1,0,0,0,0,0,0,1
enclave beginning,0,1,0,0,0,0,0,1
enclave city,0,1,0,0,0,0,0,1
encountered indigenous,0,0,0,0,0,1,0,1
encourage accountability,0,1,0,0,0,0,0,1
encourage clean,0,1,0,0,0,0,0,1
encourage firms,0,1,0,0,0,0,0,1
encourage hikers,0,1,0,0,0,0,0,1
encourage power,0,0,0,0,1,0,0,1
encouraged residents,0,1,0,0,0,0,0,1
encourages people,0,0,0,0,1,0,0,1
encouraging governments,0,1,0,0,0,0,0,1
encouraging hybrids,0,0,0,0,1,0,0,1
encouraging international,1,0,0,0,0,0,0,1
encouraging residents,0,0,0,1,0,0,0,1
encroaching desert,1,0,0,0,0,0,0,1
endangered glaciers,0,1,0,0,0,0,0,1
endangered listing,0,1,0,0,0,0,0,1
endangered performance,0,1,0,0,0,0,0,1
endangered status,0,1,0,0,0,0,0,1
endangered world,0,1,0,0,0,0,0,1
endless run,0,0,0,0,0,1,0,1
endless wilderness,0,0,0,0,0,1,0,1
enduringly popular,0,0,0,0,1,0,0,1
enemy fires,0,0,1,0,0,0,0,1
energetic events,0,1,0,0,0,0,0,1
energy advocates,0,0,0,0,1,0,0,1
energy alert,0,0,0,0,1,0,0,1
energy analysts,0,1,0,0,0,0,0,1
energy associate,0,0,1,0,0,0,0,1
energy burger,0,0,0,0,1,0,0,1
energy carrier,0,1,0,0,0,0,0,1
energy ceo,1,0,0,0,0,0,0,1
energy climate,0,0,1,0,0,0,0,1
energy colorado,0,1,0,0,0,0,0,1
energy company.ceraweek,0,0,0,0,0,1,0,1
energy concerns,0,0,0,0,1,0,0,1
energy conducted,0,0,0,0,1,0,0,1
energy conference,0,0,1,0,0,0,0,1
energy corp,0,0,0,0,1,0,0,1
energy correspondent,0,0,0,1,0,0,0,1
energy cost,1,0,0,0,0,0,0,1
energy costs.martí,0,0,0,0,0,1,0,1
energy demand,0,0,0,1,0,0,0,1
energy developed,0,1,0,0,0,0,0,1
energy district,0,1,0,0,0,0,0,1
energy doe,0,0,0,0,1,0,0,1
energy economics,0,0,0,0,1,0,0,1
energy efforts,0,0,0,1,0,0,0,1
energy environment,0,0,0,0,1,0,0,1
energy executives,0,0,0,0,1,0,0,1
energy experts,0,0,0,0,1,0,0,1
energy firm,0,0,0,0,0,1,0,1
energy future,0,0,1,0,0,0,0,1
energy heating,1,0,0,0,0,0,0,1
energy ignoring,0,0,0,0,1,0,0,1
energy infrastructure,0,1,0,0,0,0,0,1
energy initiatives,0,1,0,0,0,0,0,1
energy investment,0,1,0,0,0,0,0,1
energy investor,0,0,0,0,1,0,0,1
energy jennifer,0,0,0,1,0,0,0,1
energy lawyer,0,0,0,0,1,0,0,1
energy medium,0,1,0,0,0,0,0,1
energy nursing,0,0,1,0,0,0,0,1
energy partnerships,0,1,0,0,0,0,0,1
energy path,0,0,1,0,0,0,0,1
energy person,0,0,0,0,1,0,0,1
energy potential,0,0,0,1,0,0,0,1
energy prep,0,0,0,0,1,0,0,1
energy producers,0,0,0,0,1,0,0,1
energy production,0,0,0,0,1,0,0,1
energy products,0,1,0,0,0,0,0,1
energy program,0,0,0,1,0,0,0,1
energy required,1,0,0,0,0,0,0,1
energy research,0,0,0,0,1,0,0,1
energy revealing,0,1,0,0,0,0,0,1
energy revolution,0,1,0,0,0,0,0,1
energy security,0,0,0,0,0,1,0,1
energy sitting,0,1,0,0,0,0,0,1
energy star,0,0,0,0,0,0,1,1
energy story,0,0,1,0,0,0,0,1
energy study,0,0,0,0,0,0,1,1
energy targets,0,0,0,0,0,1,0,1
energy technologies,0,0,0,1,0,0,0,1
energy transitions,0,1,0,0,0,0,0,1
energy type,0,0,0,0,0,1,0,1
energy upside,0,1,0,0,0,0,0,1
energy widespread,0,0,0,1,0,0,0,1
energy's johnson,0,0,0,0,1,0,0,1
energy's office,0,0,1,0,0,0,0,1
energy's pacific,1,0,0,0,0,0,0,1
energy's petrosova,0,0,1,0,0,0,0,1
energy's plant,1,0,0,0,0,0,0,1
energy's puerto,0,0,0,1,0,0,0,1
energy's steam,1,0,0,0,0,0,0,1
enforce growth,1,0,0,0,0,0,0,1
enforce regulations,0,0,0,0,0,0,1,1
enforce rules,0,0,0,0,1,0,0,1
enforced rules,0,0,0,0,1,0,0,1
enforcement including,0,1,0,0,0,0,0,1
engaged authentically,1,0,0,0,0,0,0,1
engaging people,0,1,0,0,0,0,0,1
engineering company,0,0,0,1,0,0,0,1
engineering geologist,0,0,0,1,0,0,0,1
engineering innovations,0,0,0,1,0,0,0,1
engineering inspections,0,1,0,0,0,0,0,1
engineering solution,1,0,0,0,0,0,0,1
engineers ship,0,1,0,0,0,0,0,1
england banned,0,0,0,1,0,0,0,1
england dr,1,0,0,0,0,0,0,1
england forestry,1,0,0,0,0,0,0,1
england meet,1,0,0,0,0,0,0,1
england scotland's,0,0,0,1,0,0,0,1
england temperatures,0,0,0,0,1,0,0,1
england wales,0,0,0,1,0,0,0,1
england weather,0,0,0,0,1,0,0,1
england winters,0,0,0,1,0,0,0,1
england's ban,0,0,0,1,0,0,0,1
english computers,0,0,0,0,1,0,0,1
english speaking,0,0,0,0,1,0,0,1
engulfed entire,1,0,0,0,0,0,0,1
enhance precipitation,0,0,0,0,0,0,1,1
enhanced fujita,0,0,0,0,0,1,0,1
enhances storms,0,0,0,1,0,0,0,1
enja sæthren,0,1,0,0,0,0,0,1
enjoyed broad,0,0,0,0,0,1,0,1
enjoyed moth,0,0,0,0,0,1,0,1
enormous agricultural,1,0,0,0,0,0,0,1
enormous concern,0,0,0,0,1,0,0,1
enormous dam,1,0,0,0,0,0,0,1
enormous grunt,1,0,0,0,0,0,0,1
enormous increase,0,0,0,0,0,1,0,1
enormous landslide,0,1,0,0,0,0,0,1
enormous multi,0,1,0,0,0,0,0,1
enormous reach,0,0,1,0,0,0,0,1
enormous size,0,1,0,0,0,0,0,1
enormously successful,0,0,0,1,0,0,0,1
enrique lomnitz,0,0,0,0,0,1,0,1
ensuing damage,0,1,0,0,0,0,0,1
ensure money,0,1,0,0,0,0,0,1
ensure people,0,1,0,0,0,0,0,1
ensure safe,1,0,0,0,0,0,0,1
ensuring countries,0,1,0,0,0,0,0,1
ensuring food,0,1,0,0,0,0,0,1
ensuring infrastructure,0,1,0,0,0,0,0,1
enter lab,0,0,1,0,0,0,0,1
entered morocco,0,1,0,0,0,0,0,1
entered u.s,0,0,0,0,1,0,0,1
enterprises llc,0,0,0,0,1,0,0,1
entertainment industry,0,0,1,0,0,0,0,1
entertainment media,0,0,0,0,0,0,1,1
entertainment offerings,0,0,1,0,0,0,0,1
enthusiasts environmentalists,0,0,0,0,1,0,0,1
entice people,0,0,0,1,0,0,0,1
entire beaufort,0,0,0,0,0,1,0,1
entire communities,1,0,0,0,0,0,0,1
entire country,0,0,0,1,0,0,0,1
entire economy,0,0,1,0,0,0,0,1
entire fisheries,0,0,0,0,0,1,0,1
entire floors,0,0,0,0,1,0,0,1
entire food,0,0,0,0,0,1,0,1
entire globe,0,0,1,0,0,0,0,1
entire homes,0,1,0,0,0,0,0,1
entire house,1,0,0,0,0,0,0,1
entire landscape,0,1,0,0,0,0,0,1
entire life,1,0,0,0,0,0,0,1
entire neighborhood,0,0,0,1,0,0,0,1
entire network,0,0,0,1,0,0,0,1
entire operation,0,0,0,1,0,0,0,1
entire planet,1,0,0,0,0,0,0,1
entire route,0,0,0,1,0,0,0,1
entire societies,0,1,0,0,0,0,0,1
entire southwest,0,0,0,0,0,1,0,1
entire time,1,0,0,0,0,0,0,1
entrepreneurial ventures,0,1,0,0,0,0,0,1
entrepreneurs enabling,0,1,0,0,0,0,0,1
entrepreneurs setting,0,1,0,0,0,0,0,1
envelope meaning,0,1,0,0,0,0,0,1
environment benton,0,0,0,0,1,0,0,1
environment drier,0,0,0,0,0,0,1,1
environment expert,0,0,0,0,0,1,0,1
environment food,0,0,0,1,0,0,0,1
environment institute,0,0,0,1,0,0,0,1
environment journal,0,0,0,0,0,0,1,1
environment loses,0,0,0,0,0,1,0,1
environment paddy,0,0,0,1,0,0,0,1
environment plan,0,0,0,1,0,0,0,1
environment program,0,0,0,0,0,1,0,1
environment richer,0,0,1,0,0,0,0,1
environment scientists,0,0,0,1,0,0,0,1
environment secretary,0,0,0,1,0,0,0,1
environmental activism,0,1,0,0,0,0,0,1
environmental agency,0,0,1,0,0,0,0,1
environmental assessment,1,0,0,0,0,0,0,1
environmental benefit,0,1,0,0,0,0,0,1
environmental breaking,0,0,0,0,1,0,0,1
environmental campaigns,0,0,1,0,0,0,0,1
environmental concerns.but,0,0,1,0,0,0,0,1
environmental conditions,0,0,0,0,0,1,0,1
environmental content,0,0,0,0,0,1,0,1
environmental crisis,0,0,0,0,0,0,1,1
environmental czar,0,1,0,0,0,0,0,1
environmental data,0,0,0,0,1,0,0,1
environmental debate,0,0,0,0,1,0,0,1
environmental degradation,0,1,0,0,0,0,0,1
environmental destruction,0,1,0,0,0,0,0,1
environmental director,0,1,0,0,0,0,0,1
environmental disaster,0,0,0,0,0,0,1,1
environmental education,0,0,0,0,1,0,0,1
environmental engineer,0,1,0,0,0,0,0,1
environmental expense,0,0,1,0,0,0,0,1
environmental footprint,0,1,0,0,0,0,0,1
environmental group.choksi,0,0,0,1,0,0,0,1
environmental harm,0,0,0,0,1,0,0,1
environmental hazards,1,0,0,0,0,0,0,1
environmental impacts,0,0,0,0,1,0,0,1
environmental integrity,0,1,0,0,0,0,0,1
environmental issue,0,0,0,0,0,1,0,1
environmental issues,0,0,0,0,1,0,0,1
environmental journalists,1,0,0,0,0,0,0,1
environmental mismatch,0,0,0,0,0,1,0,1
environmental movement,0,1,0,0,0,0,0,1
environmental movements,0,0,0,1,0,0,0,1
environmental news,0,0,0,0,1,0,0,1
environmental nonprofit,0,0,0,0,0,1,0,1
environmental policy,0,1,0,0,0,0,0,1
environmental protections,0,0,0,0,0,1,0,1
environmental radical,0,1,0,0,0,0,0,1
environmental reality,0,0,0,0,1,0,0,1
environmental record,0,1,0,0,0,0,0,1
environmental regulation,0,0,0,1,0,0,0,1
environmental risks,0,0,0,0,1,0,0,1
environmental safeguards,1,0,0,0,0,0,0,1
environmental sustainability,1,0,0,0,0,0,0,1
environmentalism drag,1,0,0,0,0,0,0,1
environmentalist britt,0,0,1,0,0,0,0,1
environmentalists called,0,0,0,1,0,0,0,1
environmentalists hope,0,0,0,1,0,0,0,1
environmentalists lula,0,1,0,0,0,0,0,1
environmentally responsible,0,1,0,0,0,0,0,1
environments called,0,0,0,1,0,0,0,1
environments favorable,0,0,0,0,0,1,0,1
envoy xie,0,1,0,0,0,0,0,1
epa agree,0,0,0,1,0,0,0,1
epa assigned,0,0,0,0,1,0,0,1
epa declined,0,0,0,0,1,0,0,1
epa figures,0,0,0,0,1,0,0,1
epa ian,0,0,1,0,0,0,0,1
epa inspector,0,0,0,0,0,0,1,1
epa officials,0,0,0,0,0,1,0,1
epa proposed,0,0,0,1,0,0,0,1
epa recommends,0,0,0,0,1,0,0,1
epa released,0,0,0,0,0,1,0,1
epa sets,0,0,0,1,0,0,0,1
epa spokesperson,0,0,0,0,0,0,1,1
epa typically,0,0,0,0,0,1,0,1
epa's calculations,0,0,0,0,1,0,0,1
epa's choice,0,0,0,0,1,0,0,1
epa's office,0,0,0,0,1,0,0,1
epa's social,0,0,0,0,1,0,0,1
epidemic potential,0,0,0,0,0,1,0,1
episode evan,0,0,1,0,0,0,0,1
episode kwasi,0,0,1,0,0,0,0,1
episode npr,0,0,0,1,0,0,0,1
episode recently,0,0,0,0,0,0,1,1
episode set,0,0,0,0,0,0,1,1
equal tuvalu,0,1,0,0,0,0,0,1
equally passionate,0,1,0,0,0,0,0,1
equally stunning,0,0,0,0,1,0,0,1
equate emissions,0,0,0,0,1,0,0,1
equatorial pacific,0,0,0,1,0,0,0,1
equipment linked,0,0,0,0,1,0,0,1
equipment sales,0,0,0,0,0,0,1,1
equipment taxes,0,0,0,0,1,0,0,1
equitable peaceful,0,0,0,0,1,0,0,1
er blessed,0,0,0,0,0,1,0,1
er doctor,0,0,0,1,0,0,0,1
era border,0,0,1,0,0,0,0,1
era conspiracy,0,0,0,0,0,1,0,1
era funding,0,0,0,1,0,0,0,1
era policy,0,0,1,0,0,0,0,1
era restrictions,0,0,0,0,0,1,0,1
era rule,0,0,0,0,0,1,0,1
era windfall,0,0,0,0,0,0,1,1
erases tracts,1,0,0,0,0,0,0,1
erfoud fadel,1,0,0,0,0,0,0,1
eric compton,0,0,0,0,0,1,0,1
eric hey,0,0,0,1,0,0,0,1
eric letvin,1,0,0,0,0,0,0,1
eric rignot,0,0,0,0,1,0,0,1
eric zimpfer,0,0,0,0,1,0,0,1
erick thohir,0,0,0,0,1,0,0,1
erik franklin,0,1,0,0,0,0,0,1
erika gabrielli,0,0,0,1,0,0,0,1
erin hooley,0,0,0,0,0,0,1,1
erin pettit,0,0,0,0,1,0,0,1
ernie carpenter's,0,1,0,0,0,0,0,1
eroded rapidly,1,0,0,0,0,0,0,1
eroding indian,1,0,0,0,0,0,0,1
erosion helping,1,0,0,0,0,0,0,1
erratic rainfall,1,0,0,0,0,0,0,1
erratic weather,1,0,0,0,0,0,0,1
es salaam,0,0,1,0,0,0,0,1
esa listing,1,0,0,0,0,0,0,1
escaped drowning,0,1,0,0,0,0,0,1
escaped local,1,0,0,0,0,0,0,1
escaped unhurt,0,0,0,0,0,0,1,1
escutia woke,0,0,0,0,0,0,1,1
esg environmental,0,0,1,0,0,0,0,1
esg focused,0,0,1,0,0,0,0,1
esg money,0,0,1,0,0,0,0,1
espirito santo,0,1,0,0,0,0,0,1
essay portray,0,1,0,0,0,0,0,1
essential services,0,0,0,0,1,0,0,1
essential threat,0,0,1,0,0,0,0,1
essentially giant,0,0,0,0,0,1,0,1
essentially mandating,0,0,0,0,1,0,0,1
essentially nature,1,0,0,0,0,0,0,1
essentially proliferates,0,1,0,0,0,0,0,1
essentially remake,0,0,1,0,0,0,0,1
essentially trapped,0,0,1,0,0,0,0,1
essentially trick,0,0,1,0,0,0,0,1
established connection,0,1,0,0,0,0,0,1
established negotiators,0,1,0,0,0,0,0,1
established stops,1,0,0,0,0,0,0,1
establishing marine,0,0,0,0,1,0,0,1
estate agents,0,0,0,1,0,0,0,1
estate boom,0,0,0,1,0,0,0,1
estate deals,1,0,0,0,0,0,0,1
estate developers,1,0,0,0,0,0,0,1
estate development,1,0,0,0,0,0,0,1
estimate based,1,0,0,0,0,0,0,1
estimate languages,0,0,0,1,0,0,0,1
estimated cost,0,0,0,0,0,1,0,1
estimates cheating,0,1,0,0,0,0,0,1
estimates cited,1,0,0,0,0,0,0,1
estimates eliminating,0,1,0,0,0,0,0,1
estimates india's,0,1,0,0,0,0,0,1
estimates suggest,0,1,0,0,0,0,0,1
estimates wind,0,0,0,0,0,1,0,1
estrin npr,0,1,0,0,0,0,0,1
estrin recently,0,1,0,0,0,0,0,1
ethics nightmare,0,0,0,0,1,0,0,1
ethiopia kenya,1,0,0,0,0,0,0,1
ethnic minority,1,0,0,0,0,0,0,1
ethnicity nationality,0,0,0,0,1,0,0,1
eu borders,0,1,0,0,0,0,0,1
eu companies,0,0,0,0,0,1,0,1
eu economy,0,0,0,0,0,1,0,1
eu incentives,0,0,0,0,0,1,0,1
eu loses,0,0,0,0,0,1,0,1
eu meet,0,0,0,0,0,1,0,1
eu spokesperson,0,1,0,0,0,0,0,1
eu's concerns,0,0,0,0,0,1,0,1
eu's plan,0,0,0,0,0,1,0,1
eugene oregon,0,0,1,0,0,0,0,1
eunice's story,0,0,0,0,0,1,0,1
euro budget,0,0,0,1,0,0,0,1
europe california,0,0,0,0,1,0,0,1
europe declined,0,0,0,0,0,1,0,1
europe dieye,0,0,0,0,1,0,0,1
europe german,0,0,1,0,0,0,0,1
europe japan,0,1,0,0,0,0,0,1
europe nespresso,0,0,0,1,0,0,0,1
europe responsible,1,0,0,0,0,0,0,1
europe ricci,0,0,0,0,1,0,0,1
europe saint,0,0,0,0,1,0,0,1
europe told,0,0,0,0,1,0,0,1
europe.in participating,0,1,0,0,0,0,0,1
europe's largest,0,0,1,0,0,0,0,1
european climate,0,0,0,1,0,0,0,1
european contributor,0,0,0,1,0,0,0,1
european council,0,0,0,1,0,0,0,1
european countries,0,0,0,1,0,0,0,1
european enclave,0,1,0,0,0,0,0,1
european foods,0,0,0,0,0,1,0,1
european green,0,0,0,0,0,1,0,1
european investment,0,1,0,0,0,0,0,1
european lawmakers,0,0,0,0,1,0,0,1
european leaders,0,0,0,0,0,1,0,1
european wide,0,1,0,0,0,0,0,1
euros germany,0,1,0,0,0,0,0,1
ev ambitions,0,0,0,0,0,1,0,1
ev batteries,0,0,0,0,1,0,0,1
ev battery,0,1,0,0,0,0,0,1
ev buyers,0,0,0,0,0,1,0,1
ev manufacturing,0,0,0,0,0,1,0,1
eva tesfaye,1,0,0,0,0,0,0,1
evacuate suddenly,0,0,0,0,0,1,0,1
evacuated due,0,0,0,0,0,1,0,1
evacuated stunned,1,0,0,0,0,0,0,1
evacuation center,0,0,0,1,0,0,0,1
evacuation centers,1,0,0,0,0,0,0,1
evacuation warning,0,0,0,1,0,0,0,1
evacuations ahead,0,0,0,1,0,0,0,1
evade law,0,1,0,0,0,0,0,1
evan vucci,1,0,0,0,0,0,0,1
evaporate dead,0,1,0,0,0,0,0,1
eve storm,0,0,0,0,1,0,0,1
evening balloons,0,0,0,0,1,0,0,1
evening mankani,1,0,0,0,0,0,0,1
evening practice,0,1,0,0,0,0,0,1
evening practices,0,1,0,0,0,0,0,1
evening standing,0,1,0,0,0,0,0,1
evening taking,0,1,0,0,0,0,0,1
event arriving,0,1,0,0,0,0,0,1
event called,0,0,0,1,0,0,0,1
event npr,0,0,0,0,1,0,0,1
event reaching,0,1,0,0,0,0,0,1
events ahead,0,0,0,0,0,1,0,1
events due,0,0,0,0,1,0,0,1
events flash,0,0,0,0,1,0,0,1
events forcing,1,0,0,0,0,0,0,1
events fueled,0,0,0,0,0,1,0,1
events happening,0,0,0,0,0,1,0,1
events mixed,0,0,0,1,0,0,0,1
eventual mode,0,0,0,0,1,0,0,1
eventually break,0,0,0,0,1,0,0,1
eventually bringing,0,1,0,0,0,0,0,1
eventually decomposes,1,0,0,0,0,0,0,1
eventually established,0,0,1,0,0,0,0,1
eventually francis,0,0,0,1,0,0,0,1
eventually joined,0,0,0,0,1,0,0,1
eventually link,0,0,1,0,0,0,0,1
eventually parris,0,1,0,0,0,0,0,1
eventually run,0,0,0,0,1,0,0,1
everybody's entire,1,0,0,0,0,0,0,1
everybody's faced,0,0,0,0,1,0,0,1
everybody's future,0,1,0,0,0,0,0,1
everybody's home,0,1,0,0,0,0,0,1
everybody's mind,0,0,0,1,0,0,0,1
everyday lives,0,1,0,0,0,0,0,1
everything's growing,1,0,0,0,0,0,0,1
evidence accumulates,0,0,0,0,1,0,0,1
evidence investment,0,0,0,0,0,1,0,1
evolution roadmap,1,0,0,0,0,0,0,1
evs canada's,0,0,0,0,0,1,0,1
evs toyota,0,0,0,0,1,0,0,1
exacerbates income,0,0,0,0,1,0,0,1
exacerbating factors,0,0,0,1,0,0,0,1
exacerbating water,0,0,0,0,0,1,0,1
exact climate,0,1,0,0,0,0,0,1
exact formulation,0,1,0,0,0,0,0,1
exact sources,0,1,0,0,0,0,0,1
exact track,0,1,0,0,0,0,0,1
exact wording,0,0,1,0,0,0,0,1
exaggerated oversimplified,0,0,1,0,0,0,0,1
examine patients,1,0,0,0,0,0,0,1
examiner cain,0,1,0,0,0,0,0,1
examiner's office,0,0,0,0,1,0,0,1
examines damaged,0,1,0,0,0,0,0,1
exceptional biodiversity,0,1,0,0,0,0,0,1
exceptional moisture,1,0,0,0,0,0,0,1
exceptional rainfall,0,1,0,0,0,0,0,1
exceptionally effective,0,0,0,0,1,0,0,1
exceptionally low,0,0,0,0,1,0,0,1
excess colorado,1,0,0,0,0,0,0,1
excess heat,1,0,0,0,0,0,0,1
excess leaves,1,0,0,0,0,0,0,1
excessive rainfall,0,0,0,1,0,0,0,1
excessively damaging,0,0,0,0,1,0,0,1
exchange council,0,0,0,0,1,0,0,1
exchanges plowed,0,1,0,0,0,0,0,1
exciting discovery,1,0,0,0,0,0,0,1
exclude light,1,0,0,0,0,0,0,1
excoriated oil,1,0,0,0,0,0,0,1
executive acted,0,0,1,0,0,0,0,1
executive analyst,0,0,0,0,1,0,0,1
executive branch,0,0,0,0,0,1,0,1
executive cop,0,0,0,1,0,0,0,1
executive editor,0,0,1,0,0,0,0,1
executive function,0,0,0,0,1,0,0,1
executive pay,0,0,0,0,0,0,1,1
executives lead,0,0,0,1,0,0,0,1
executives ultimately,0,0,1,0,0,0,0,1
executives worry,0,0,0,0,1,0,0,1
exercising law,0,0,0,0,0,0,1,1
exhaust fan,0,0,0,0,1,0,0,1
exhausted city,0,0,0,1,0,0,0,1
exhibit called,0,0,0,1,0,0,0,1
exhibit carla,0,0,0,0,1,0,0,1
exhibit mixed,0,0,0,1,0,0,0,1
exhibit ron,0,0,0,1,0,0,0,1
exhibition focusing,0,1,0,0,0,0,0,1
exhibition touches,0,1,0,0,0,0,0,1
exhibition traces,0,1,0,0,0,0,0,1
exist anymore,1,0,0,0,0,0,0,1
existence depends,1,0,0,0,0,0,0,1
existential crisis,0,0,0,0,1,0,0,1
existing businesses,0,0,0,0,1,0,0,1
existing coastal,0,1,0,0,0,0,0,1
existing funds,0,1,0,0,0,0,0,1
existing homes,0,1,0,0,0,0,0,1
existing infrastructure,0,0,0,1,0,0,0,1
existing instruments,0,1,0,0,0,0,0,1
existing natural,0,0,1,0,0,0,0,1
existing provider,1,0,0,0,0,0,0,1
existing technology,0,0,0,0,1,0,0,1
existing water,0,0,0,1,0,0,0,1
exists.for npr,0,0,0,0,0,0,1,1
exotic climate,0,0,0,0,1,0,0,1
expand conservation,0,0,0,0,0,0,1,1
expand influence,0,0,0,1,0,0,0,1
expand local,0,1,0,0,0,0,0,1
expand neighborhoods,1,0,0,0,0,0,0,1
expand planned,0,0,0,0,1,0,0,1
expanding fossil,0,0,0,0,1,0,0,1
expanding hydrogen,0,0,0,1,0,0,0,1
expanding oceans,0,1,0,0,0,0,0,1
expanding turf,0,0,0,0,1,0,0,1
expanses power,0,0,0,1,0,0,0,1
expect people,0,0,0,0,1,0,0,1
expected combined,0,1,0,0,0,0,0,1
expected deliverables,0,0,0,0,1,0,0,1
expected humans,0,0,1,0,0,0,0,1
expected late,0,0,0,0,1,0,0,1
expected monday,1,0,0,0,0,0,0,1
expected overnight,0,0,0,0,1,0,0,1
expected reemergence,1,0,0,0,0,0,0,1
expected sunday,0,0,0,1,0,0,0,1
expected tension,0,0,1,0,0,0,0,1
expecting miracles,0,1,0,0,0,0,0,1
expel migrants,0,1,0,0,0,0,0,1
expensive electric,0,0,0,1,0,0,0,1
expensive electricity,0,0,1,0,0,0,0,1
expensive updating,0,0,0,1,0,0,0,1
experience climate,0,0,0,0,0,1,0,1
experience dieye,0,0,0,0,1,0,0,1
experience highs,0,0,0,0,1,0,0,1
experience irrevocable,0,1,0,0,0,0,0,1
experience kelsey,0,0,0,0,1,0,0,1
experience skills,0,0,0,0,0,1,0,1
experienced challenges,0,1,0,0,0,0,0,1
experienced driveway,0,0,0,0,0,1,0,1
experienced drought,1,0,0,0,0,0,0,1
experienced psychotic,0,0,0,0,1,0,0,1
experiences frustrations,0,1,0,0,0,0,0,1
experiencing dangerous,0,0,0,0,1,0,0,1
experiencing drought,0,0,1,0,0,0,0,1
experiencing extreme,1,0,0,0,0,0,0,1
experiencing grief,0,1,0,0,0,0,0,1
experiencing record,0,0,0,1,0,0,0,1
experiencing riverine,1,0,0,0,0,0,0,1
experiencing shortages,0,0,0,0,0,1,0,1
experiencing snowfall,0,0,0,0,0,1,0,1
experiencing water,0,0,0,0,0,1,0,1
experimental set,0,0,0,0,0,1,0,1
experimental setup,0,0,0,0,0,1,0,1
expert aboard,0,1,0,0,0,0,0,1
expert keith,0,0,0,1,0,0,0,1
expertly navigating,0,0,0,0,1,0,0,1
experts suggest,0,0,0,1,0,0,0,1
experts worry,0,0,0,1,0,0,0,1
explained alex,0,0,0,0,0,1,0,1
explained frances,0,0,0,0,0,0,1,1
explained governments,0,0,0,0,0,1,0,1
explains alphonso,0,0,0,1,0,0,0,1
explains basically,0,0,0,0,0,1,0,1
explains change,0,1,0,0,0,0,0,1
explains concord,0,0,0,1,0,0,0,1
explains dana,0,1,0,0,0,0,0,1
explains david,0,1,0,0,0,0,0,1
explains emily,0,1,0,0,0,0,0,1
explains forecasters,0,1,0,0,0,0,0,1
explains jennifer,0,0,0,1,0,0,0,1
explains kapnick,0,1,0,0,0,0,0,1
explains mankani,1,0,0,0,0,0,0,1
explains ning,0,0,0,0,1,0,0,1
explains partho,0,0,0,0,0,1,0,1
explains plummer,0,1,0,0,0,0,0,1
explains scientist,0,1,0,0,0,0,0,1
explains ted,0,1,0,0,0,0,0,1
explicitly simulated,0,0,0,0,0,1,0,1
explore love,0,0,0,1,0,0,0,1
explorer johann,0,1,0,0,0,0,0,1
exploring cleaner,0,0,0,0,1,0,0,1
expo city,0,0,0,1,0,0,0,1
export bans,1,0,0,0,0,0,0,1
export flows,0,1,0,0,0,0,0,1
export industries,0,0,0,0,0,1,0,1
exporting crude,0,1,0,0,0,0,0,1
expose fossil,0,1,0,0,0,0,0,1
exposed riverbed,0,1,0,0,0,0,0,1
exposed wiring,0,1,0,0,0,0,0,1
extend 4g,0,0,0,0,0,1,0,1
extend outward,0,1,0,0,0,0,0,1
extended family,1,0,0,0,0,0,0,1
extended producer,0,0,0,1,0,0,0,1
extending operations,0,0,0,1,0,0,0,1
extends north,0,1,0,0,0,0,0,1
extension sea,1,0,0,0,0,0,0,1
extension specialist,1,0,0,0,0,0,0,1
extension water,0,0,0,0,0,1,0,1
extensive archive,0,1,0,0,0,0,0,1
extensive flooding,0,0,0,1,0,0,0,1
extensive knowledge,0,0,0,0,0,1,0,1
extensive restoration,0,1,0,0,0,0,0,1
extent practicable,0,1,0,0,0,0,0,1
external civil,0,0,0,0,0,0,1,1
extinct ocean,0,0,0,0,0,0,1,1
extinct volcanoes,0,0,0,0,1,0,0,1
extinction crisis,1,0,0,0,0,0,0,1
extinction globally,0,0,1,0,0,0,0,1
extinction vortex,0,0,1,0,0,0,0,1
extra boost,0,0,0,0,0,1,0,1
extra carbon,0,1,0,0,0,0,0,1
extra close,0,0,1,0,0,0,0,1
extra expense,0,0,0,0,0,1,0,1
extra lake,0,0,0,0,1,0,0,1
extra meltwater,1,0,0,0,0,0,0,1
extra mile,0,1,0,0,0,0,0,1
extra moisture,1,0,0,0,0,0,0,1
extra money,0,1,0,0,0,0,0,1
extra police,0,1,0,0,0,0,0,1
extra precautions,0,0,0,0,0,1,0,1
extra produce,0,1,0,0,0,0,0,1
extra running,0,0,1,0,0,0,0,1
extra stress,0,0,0,0,0,1,0,1
extra water,0,0,0,1,0,0,0,1
extract cells,0,1,0,0,0,0,0,1
extract fossil,0,0,0,0,0,1,0,1
extractive development,0,0,0,0,0,1,0,1
extractive industries,0,1,0,0,0,0,0,1
extraordinary circumstances,0,0,0,1,0,0,0,1
extrapolations attempts,0,0,0,0,0,0,1,1
extrapolations audio,0,0,0,0,0,0,1,1
extrapolations creator,0,0,0,0,0,0,1,1
extrapolations unfolds,0,0,0,0,0,0,1,1
extreme amounts,0,0,0,0,0,1,0,1
extreme atmospheric,0,0,0,0,0,0,1,1
extreme boosting,1,0,0,0,0,0,0,1
extreme cold,0,0,0,0,1,0,0,1
extreme conditions,0,0,0,0,1,0,0,1
extreme dry,0,0,0,0,0,1,0,1
extreme effects,0,1,0,0,0,0,0,1
extreme events,0,0,0,1,0,0,0,1
extreme flooding,0,0,0,0,0,0,1,1
extreme rain,1,0,0,0,0,0,0,1
extreme rainfall,0,0,0,1,0,0,0,1
extreme summer,1,0,0,0,0,0,0,1
extreme warming,0,0,0,0,0,1,0,1
extreme winter,0,0,0,0,1,0,0,1
extremely contentious,0,0,0,0,0,1,0,1
extremely destructive,0,1,0,0,0,0,0,1
extremely devastating,0,1,0,0,0,0,0,1
extremely low,0,0,0,1,0,0,0,1
extremely misleading,0,0,0,0,1,0,0,1
extremely short,0,0,0,0,0,1,0,1
extremely vulnerable,0,1,0,0,0,0,0,1
extremely wet,0,0,0,0,0,1,0,1
extremely worried,0,1,0,0,0,0,0,1
exxon accurately,0,0,0,1,0,0,0,1
exxon scientists,0,0,0,1,0,0,0,1
exxon spearheaded,0,0,0,1,0,0,0,1
exxon's climate,0,0,0,1,0,0,0,1
exxon's research,0,0,0,1,0,0,0,1
exxonknew exxonmobil's,0,0,0,1,0,0,0,1
exxonmobil executives,0,0,0,1,0,0,0,1
exxonmobil produced,0,0,0,1,0,0,0,1
exxonmobil spokesman,0,0,0,1,0,0,0,1
exxonmobil won,0,0,0,1,0,0,0,1
exxonmobil's finances,0,0,0,1,0,0,0,1
exxonmobil's understanding,0,0,0,1,0,0,0,1
eyder brazilians,0,0,0,0,1,0,0,1
eye hail,1,0,0,0,0,0,0,1
eye opener,0,0,0,1,0,0,0,1
eye popping,0,0,0,1,0,0,0,1
eyebrows worldwide,0,1,0,0,0,0,0,1
eyes flare,0,1,0,0,0,0,0,1
faa regulations,0,0,1,0,0,0,0,1
fabby tumiwa,0,0,0,0,1,0,0,1
fabric scraps,1,0,0,0,0,0,0,1
fabrice cofffrini,0,0,0,0,0,1,0,1
facebook instagram,0,0,1,0,0,0,0,1
facebook live,1,0,0,0,0,0,0,1
faced attacks,0,0,1,0,0,0,0,1
faced challenges,0,1,0,0,0,0,0,1
faced criticism,0,0,0,1,0,0,0,1
faced steep,1,0,0,0,0,0,0,1
faceted climate,0,1,0,0,0,0,0,1
facilitating studying,0,0,0,1,0,0,0,1
facilities fall,0,1,0,0,0,0,0,1
facility aims,0,0,0,1,0,0,0,1
facility mankani,1,0,0,0,0,0,0,1
facility's glass,0,1,0,0,0,0,0,1
facing relocation,0,0,0,0,1,0,0,1
facing significant,0,0,0,0,1,0,0,1
facing urban,0,0,1,0,0,0,0,1
facing water,0,0,0,0,0,1,0,1
factories closed,0,1,0,0,0,0,0,1
factors contribute,0,1,0,0,0,0,0,1
factory looms,0,1,0,0,0,0,0,1
factually based,0,0,0,0,1,0,0,1
fadel senna,1,0,0,0,0,0,0,1
fahrenheit fairly,0,0,0,0,0,0,1,1
fahrenheit mark,0,0,0,1,0,0,0,1
fahrenheit robert,0,0,0,0,1,0,0,1
fahrenheit tying,0,0,0,0,1,0,0,1
fahrenheit warmer,0,0,0,0,0,1,0,1
failed cop,0,1,0,0,0,0,0,1
failed keystone,0,0,0,0,0,1,0,1
failed levees,0,0,0,0,0,0,1,1
failures food,1,0,0,0,0,0,0,1
failures played,0,0,0,0,1,0,0,1
faint hope,0,1,0,0,0,0,0,1
fair prices,0,1,0,0,0,0,0,1
fair share,0,1,0,0,0,0,0,1
fair supply,0,0,0,0,1,0,0,1
fair transition,0,1,0,0,0,0,0,1
fairly impressive,0,0,0,0,1,0,0,1
fairly unprecedented,1,0,0,0,0,0,0,1
faith commitment,0,1,0,0,0,0,0,1
fajardo bay,0,0,0,1,0,0,0,1
fake news,0,0,1,0,0,0,0,1
fall day,0,0,0,1,0,0,0,1
fall fire,1,0,0,0,0,0,0,1
fall hardest,0,0,1,0,0,0,0,1
fall harvest,0,1,0,0,0,0,0,1
fall jesse,0,0,1,0,0,0,0,1
fall occasionally,0,0,0,0,0,1,0,1
fall roughly,0,1,0,0,0,0,0,1
fall scholz,0,0,1,0,0,0,0,1
fall top,0,1,0,0,0,0,0,1
fallen leaves,1,0,0,0,0,0,0,1
fallen light,0,1,0,0,0,0,0,1
fallen palm,1,0,0,0,0,0,0,1
falling debris,0,0,0,1,0,0,0,1
falling harder,1,0,0,0,0,0,0,1
falling sonia,1,0,0,0,0,0,0,1
falling spaced,0,0,0,1,0,0,0,1
falling tree,0,0,0,0,0,0,1,1
fallon afp,0,0,0,0,0,1,0,1
fallout scenarios,0,0,0,0,1,0,0,1
fallowing half,1,0,0,0,0,0,0,1
falls convention,0,0,0,0,0,1,0,1
false hope,0,1,0,0,0,0,0,1
falsely alleged,0,0,0,0,0,1,0,1
falsely claimed,0,0,0,0,1,0,0,1
falsify multiple,0,1,0,0,0,0,0,1
famed reef,0,1,0,0,0,0,0,1
familiar blue,0,0,0,1,0,0,0,1
familiar story,0,0,0,0,0,1,0,1
familiar world,0,0,0,1,0,0,0,1
families clean,0,0,0,0,1,0,0,1
families families,0,0,0,1,0,0,0,1
families immediately,0,1,0,0,0,0,0,1
families lived,0,0,0,0,1,0,0,1
families living,0,0,0,1,0,0,0,1
families quality,0,1,0,0,0,0,0,1
families suggesting,0,1,0,0,0,0,0,1
family arrived,1,0,0,0,0,0,0,1
family bread,1,0,0,0,0,0,0,1
family emergency,0,0,0,1,0,0,0,1
family evacuated,0,1,0,0,0,0,0,1
family friday,0,1,0,0,0,0,0,1
family friend,0,0,0,0,0,0,1,1
family garden,0,0,0,0,1,0,0,1
family homes,0,1,0,0,0,0,0,1
family nowadays,1,0,0,0,0,0,0,1
family passed,1,0,0,0,0,0,0,1
family prepared,0,0,0,0,0,1,0,1
family reached,1,0,0,0,0,0,0,1
family reunions,1,0,0,0,0,0,0,1
family rode,0,0,0,0,0,0,1,1
family's astonishment,1,0,0,0,0,0,0,1
family's experiences,1,0,0,0,0,0,0,1
family's life,0,0,1,0,0,0,0,1
family's roots,0,1,0,0,0,0,0,1
famous salmon,1,0,0,0,0,0,0,1
famous ski,0,0,0,0,1,0,0,1
famous valentine's,0,0,0,1,0,0,0,1
fan box,0,0,0,0,0,1,0,1
fan laboratory,1,0,0,0,0,0,0,1
fanciful projections,0,0,0,0,0,1,0,1
fancy degree,0,1,0,0,0,0,0,1
fancy hotel,0,0,0,0,1,0,0,1
fancy phones,0,0,0,0,0,1,0,1
fantastic wet,0,0,0,0,0,1,0,1
fantastical suggestions,0,0,0,0,1,0,0,1
faraway supplies,0,0,0,0,0,1,0,1
farhana menon,1,0,0,0,0,0,0,1
farm bill.ximena,0,0,0,0,0,0,1,1
farm efficiently,0,1,0,0,0,0,0,1
farm family,0,0,0,0,1,0,0,1
farm fields,0,1,0,0,0,0,0,1
farm fields.that's,0,1,0,0,0,0,0,1
farm images,0,0,1,0,0,0,0,1
farm owners,0,0,0,0,0,1,0,1
farm raise,0,1,0,0,0,0,0,1
farm raised,0,0,0,0,0,0,1,1
farm subsidies,0,0,0,0,0,0,1,1
farm systems,0,0,1,0,0,0,0,1
farm workers,0,1,0,0,0,0,0,1
farmer owns,0,1,0,0,0,0,0,1
farmer producer,0,1,0,0,0,0,0,1
farmer suicides,0,1,0,0,0,0,0,1
farmers apply,0,0,0,0,0,0,1,1
farmers connor,0,0,0,0,0,1,0,1
farmers flores,0,0,0,0,0,0,1,1
farmers foresters,0,0,0,0,0,0,1,1
farmers hope,1,0,0,0,0,0,0,1
farmers lose,0,1,0,0,0,0,0,1
farmers mwenja,1,0,0,0,0,0,0,1
farmers operating,0,0,0,0,0,1,0,1
farmers wait,0,0,0,0,0,1,0,1
farmers waiting,0,1,0,0,0,0,0,1
farmers yield,0,1,0,0,0,0,0,1
farming costs,0,1,0,0,0,0,0,1
farming difficult,0,1,0,0,0,0,0,1
farming families,0,0,0,0,1,0,0,1
farming helping,0,1,0,0,0,0,0,1
farming industry,0,0,0,0,0,0,1,1
farming neighbors,0,1,0,0,0,0,0,1
farming practices,0,0,0,0,0,1,0,1
farming sustainable,1,0,0,0,0,0,0,1
farming technology,0,0,0,1,0,0,0,1
farming town,0,0,0,0,1,0,0,1
farming water,0,0,0,1,0,0,0,1
farmland droz,0,0,0,0,1,0,0,1
farmland houser,0,0,0,0,1,0,0,1
farmland ryan,0,0,0,0,1,0,0,1
farmland trust,0,0,0,1,0,0,0,1
farms gulp,1,0,0,0,0,0,0,1
farms mwenja,1,0,0,0,0,0,0,1
farms system,0,0,1,0,0,0,0,1
farms zoos,0,1,0,0,0,0,0,1
farther eastward,0,0,0,0,0,1,0,1
farther south,0,0,0,0,0,1,0,1
fast approaching,0,1,0,0,0,0,0,1
fast chargers,0,0,0,0,1,0,0,1
fast demand,0,0,0,0,1,0,0,1
fast food,0,1,0,0,0,0,0,1
fast indonesia's,0,0,0,0,1,0,0,1
fast power,0,0,0,1,0,0,0,1
fast running,0,1,0,0,0,0,0,1
fast scientists,1,0,0,0,0,0,0,1
fast track,1,0,0,0,0,0,0,1
faster tightening,0,0,0,0,0,1,0,1
fastest climate,0,0,0,1,0,0,0,1
fastest melting,0,1,0,0,0,0,0,1
fatalities cars,1,0,0,0,0,0,0,1
fatalities happened,0,0,0,1,0,0,0,1
fatality rates,0,0,0,0,0,1,0,1
father pascal,0,0,1,0,0,0,0,1
father trudge,0,0,0,0,0,1,0,1
fatigue seasickness,0,0,0,0,1,0,0,1
fats sugar,0,1,0,0,0,0,0,1
fatty acids,0,1,0,0,0,0,0,1
favorable coverage,0,0,1,0,0,0,0,1
favorable ruling,0,0,0,0,0,1,0,1
favorite food,0,0,1,0,0,0,0,1
favorite foods,0,1,0,0,0,0,0,1
favorite plants,0,0,0,1,0,0,0,1
faya ora,0,0,0,1,0,0,0,1
fbi found,0,0,0,1,0,0,0,1
fda commissioner,0,1,0,0,0,0,0,1
fda reviewed,0,1,0,0,0,0,0,1
fda spokesperson,0,1,0,0,0,0,0,1
fda's susan,0,1,0,0,0,0,0,1
fear massive,0,1,0,0,0,0,0,1
fear mongering,0,0,1,0,0,0,0,1
fear uncertainty,0,0,1,0,0,0,0,1
feared buried,0,1,0,0,0,0,0,1
fears accessing,0,1,0,0,0,0,0,1
fears people,0,0,0,0,1,0,0,1
featuring discussions,0,0,1,0,0,0,0,1
featuring restaurant,0,0,0,1,0,0,0,1
featuring shared,0,0,0,0,1,0,0,1
february economy,0,0,1,0,0,0,0,1
february march,0,0,0,0,0,1,0,1
february's deadly,0,0,0,0,1,0,0,1
fed feels,0,0,0,0,0,1,0,1
fed officials,0,0,0,0,0,1,0,1
fed omega,0,1,0,0,0,0,0,1
fed reservoirs,0,0,0,0,1,0,0,1
fedeli ontario's,0,0,0,0,0,1,0,1
federal aid.martí,0,0,0,0,0,1,0,1
federal bureau,0,0,0,0,1,0,0,1
federal canal,1,0,0,0,0,0,0,1
federal cash,0,0,1,0,0,0,0,1
federal clean,0,0,0,0,0,1,0,1
federal coffers,0,1,0,0,0,0,0,1
federal court,0,0,1,0,0,0,0,1
federal courts,0,0,0,1,0,0,0,1
federal data,0,0,0,1,0,0,0,1
federal development,0,1,0,0,0,0,0,1
federal disaster,0,0,0,0,1,0,0,1
federal environmental,0,0,0,1,0,0,0,1
federal forecasters,0,1,0,0,0,0,0,1
federal funds,1,0,0,0,0,0,0,1
federal grant,0,1,0,0,0,0,0,1
federal indian,0,0,0,0,0,1,0,1
federal infrastructure,0,0,0,0,1,0,0,1
federal judiciary,0,0,0,0,1,0,0,1
federal lands,0,0,0,0,0,1,0,1
federal level,0,0,0,0,1,0,0,1
federal officials,0,1,0,0,0,0,0,1
federal partners,0,0,1,0,0,0,0,1
federal policies,0,0,0,0,0,1,0,1
federal policymakers,0,0,1,0,0,0,0,1
federal pollution,0,0,0,0,0,1,0,1
federal rainfall,0,0,0,1,0,0,0,1
federal reconstruction,0,1,0,0,0,0,0,1
federal records,0,0,0,1,0,0,0,1
federal regulations,1,0,0,0,0,0,0,1
federal report,0,0,1,0,0,0,0,1
federal response,1,0,0,0,0,0,0,1
federal reviews,0,0,0,0,0,1,0,1
federal sources,0,0,0,1,0,0,0,1
federal study,0,0,0,1,0,0,0,1
federal tax,0,0,1,0,0,0,0,1
federal university,0,0,0,0,0,0,1,1
federalist society,0,0,0,0,1,0,0,1
federally subsidized,1,0,0,0,0,0,0,1
federation told,0,0,1,0,0,0,0,1
fedouach afp,0,0,0,0,0,1,0,1
feed crops,0,0,0,0,1,0,0,1
feed energy,0,0,0,0,1,0,0,1
feed jennifer,0,1,0,0,0,0,0,1
feed pumpkins,0,1,0,0,0,0,0,1
feeding operations,0,1,0,0,0,0,0,1
feeds electricity,1,0,0,0,0,0,0,1
feel climate,1,0,0,0,0,0,0,1
feel comfortable,0,0,0,1,0,0,0,1
feel eerie,0,0,0,0,1,0,0,1
feel highlights,0,0,1,0,0,0,0,1
feel president,0,1,0,0,0,0,0,1
feel super,0,1,0,0,0,0,0,1
feelings rosenweig,0,1,0,0,0,0,0,1
feels betrayed,0,1,0,0,0,0,0,1
feels hopeless,0,1,0,0,0,0,0,1
feels overwhelmed,0,1,0,0,0,0,0,1
feels overwhelming,0,0,0,0,1,0,0,1
feels proud,0,1,0,0,0,0,0,1
feels recorded,0,0,0,0,1,0,0,1
feels super,0,0,1,0,0,0,0,1
fees support,0,0,0,0,1,0,0,1
feet atop,0,0,0,0,0,1,0,1
feet due,0,1,0,0,0,0,0,1
feet growing,0,0,0,0,1,0,0,1
feet mint,0,1,0,0,0,0,0,1
feet touched,0,0,0,0,0,0,1,1
feet upslope,0,0,0,0,0,1,0,1
feet wobbled,1,0,0,0,0,0,0,1
feet woo,0,0,0,0,0,1,0,1
félix national,0,1,0,0,0,0,0,1
fell ill,0,0,1,0,0,0,0,1
fell milam,0,0,0,0,0,0,1,1
fellow activists,0,1,0,0,0,0,0,1
fellow conservatives,0,0,0,0,0,1,0,1
fellow leaders,0,1,0,0,0,0,0,1
fellow midwife,1,0,0,0,0,0,0,1
fellow organizer,0,1,0,0,0,0,0,1
felton grove,0,0,0,1,0,0,0,1
fema director,0,0,0,0,0,1,0,1
fema launched,1,0,0,0,0,0,0,1
fema managed,1,0,0,0,0,0,0,1
fema officials,1,0,0,0,0,0,0,1
fema rolls,0,1,0,0,0,0,0,1
fema's deputy,1,0,0,0,0,0,0,1
fema's initial,1,0,0,0,0,0,0,1
female bears,0,0,1,0,0,0,0,1
female education,0,1,0,0,0,0,0,1
femilon regalado,0,0,0,0,0,1,0,1
fence await,0,1,0,0,0,0,0,1
fence lined,0,1,0,0,0,0,0,1
fence mangling,0,1,0,0,0,0,0,1
fences edge,0,0,0,1,0,0,0,1
fences guarded,0,1,0,0,0,0,0,1
fences shortly,0,1,0,0,0,0,0,1
ferdinand marcos,1,0,0,0,0,0,0,1
fernando lópez,1,0,0,0,0,0,0,1
fernando salas,0,0,0,1,0,0,0,1
ferried food,1,0,0,0,0,0,0,1
ferris helped,0,0,0,0,1,0,0,1
ferry forty,1,0,0,0,0,0,0,1
ferry section,1,0,0,0,0,0,0,1
ferry service,1,0,0,0,0,0,0,1
fertile farm,0,1,0,0,0,0,0,1
fertilizer producers,1,0,0,0,0,0,0,1
fertilizer program,1,0,0,0,0,0,0,1
festival michael,0,1,0,0,0,0,0,1
fetal bovine,0,1,0,0,0,0,0,1
fetal heart,1,0,0,0,0,0,0,1
fetal heartbeats,1,0,0,0,0,0,0,1
fetch firewood,0,0,1,0,0,0,0,1
fever chills,0,0,0,0,0,1,0,1
fever virus,0,0,0,0,0,1,0,1
fewer centralized,0,0,0,1,0,0,0,1
fewer corn,0,0,1,0,0,0,0,1
fewer drilling,0,0,0,0,0,1,0,1
fewer emissions,0,0,1,0,0,0,0,1
fewer kids,0,0,0,0,1,0,0,1
fewer people,0,0,0,0,0,1,0,1
fewer pollutants,0,0,0,1,0,0,0,1
fewer trees,0,0,0,1,0,0,0,1
fi foods,0,1,0,0,0,0,0,1
fi yi,0,1,0,0,0,0,0,1
fiat chrysler,0,0,0,0,0,1,0,1
fiction rooted,0,0,0,0,0,0,1,1
fiction valeti,0,1,0,0,0,0,0,1
fiction writer,0,0,0,0,0,1,0,1
fictional tv,0,0,0,0,0,0,1,1
fiddle leaf,0,1,0,0,0,0,0,1
fiddle players,0,1,0,0,0,0,0,1
fiduciary duty,0,0,1,0,0,0,0,1
field cloudy,0,0,0,0,0,1,0,1
field day,0,0,1,0,0,0,0,1
field fox,0,0,0,0,0,0,1,1
field recordings,0,0,0,1,0,0,0,1
field recreational,0,1,0,0,0,0,0,1
field research,0,0,1,0,0,0,0,1
field teams,1,0,0,0,0,0,0,1
field's lighting,0,1,0,0,0,0,0,1
field's worth,0,1,0,0,0,0,0,1
fielding questions,0,0,0,0,1,0,0,1
fields climate,0,1,0,0,0,0,0,1
fields ousmane,0,1,0,0,0,0,0,1
fields planting,0,1,0,0,0,0,0,1
fields ricci,0,1,0,0,0,0,0,1
fields.that's pushing,0,1,0,0,0,0,0,1
fierce storms,0,0,0,0,0,0,1,1
fierce winds,0,0,0,0,1,0,0,1
fifty countries,0,1,0,0,0,0,0,1
fifty percent,0,0,1,0,0,0,0,1
fig tree,0,1,0,0,0,0,0,1
fight hurricanes,1,0,0,0,0,0,0,1
fight soviet,0,0,0,1,0,0,0,1
fighting climate,0,0,0,0,1,0,0,1
fighting solar,0,0,0,0,1,0,0,1
fighting vehicle,0,0,0,1,0,0,0,1
fighting vehicles,0,0,0,1,0,0,0,1
figures zeke,0,0,0,1,0,0,0,1
file hide,0,0,1,0,0,0,0,1
filings pitts,0,0,1,0,0,0,0,1
filipinos planned,1,0,0,0,0,0,0,1
fill aquifers,0,0,0,0,0,1,0,1
fill cracks,0,0,0,1,0,0,0,1
filled cheap,1,0,0,0,0,0,0,1
filling supercells,0,0,0,0,0,1,0,1
film department,0,1,0,0,0,0,0,1
film pristine,0,1,0,0,0,0,0,1
filter humming,0,0,0,1,0,0,0,1
filter pollutants,0,0,0,0,0,1,0,1
filter water,0,0,0,0,0,0,1,1
filtered brew,0,0,0,1,0,0,0,1
filtered coffee,0,0,0,1,0,0,0,1
filtration systems,0,0,0,0,0,1,0,1
final agreement,0,0,1,0,0,0,0,1
final approval,0,0,0,0,0,1,0,1
final brain,0,0,0,0,1,0,0,1
final burst,0,0,0,0,0,0,1,1
final episode,0,0,0,0,0,0,1,1
final hours,0,1,0,0,0,0,0,1
final lot,1,0,0,0,0,0,0,1
final nail,0,0,0,1,0,0,0,1
final negotiations,0,1,0,0,0,0,0,1
final option,0,0,0,1,0,0,0,1
final rule,0,1,0,0,0,0,0,1
final treaty,0,0,0,0,1,0,0,1
finalized protections,1,0,0,0,0,0,0,1
finally accomplished,0,0,0,0,0,1,0,1
finally addressing,0,1,0,0,0,0,0,1
finally arrived,0,1,0,0,0,0,0,1
finally broken,0,0,0,0,1,0,0,1
finally complete,0,1,0,0,0,0,0,1
finally contacted,0,1,0,0,0,0,0,1
finally gaining,0,0,1,0,0,0,0,1
finally outdated,0,0,0,1,0,0,0,1
finally reaching,0,0,0,1,0,0,0,1
finally stops,0,0,0,0,0,1,0,1
finally united,0,0,0,0,0,1,0,1
finance access,0,1,0,0,0,0,0,1
finance aid,0,1,0,0,0,0,0,1
finance biden,0,1,0,0,0,0,0,1
finance broadly,0,1,0,0,0,0,0,1
finance center,0,1,0,0,0,0,0,1
finance citi,0,0,0,0,0,1,0,1
finance climate,0,0,1,0,0,0,0,1
finance corp,0,1,0,0,0,0,0,1
finance guilanpour,0,1,0,0,0,0,0,1
finance laws,0,0,0,0,1,0,0,1
finance money,0,1,0,0,0,0,0,1
finance pie,0,1,0,0,0,0,0,1
finances angela,0,0,0,1,0,0,0,1
finances decades,0,0,0,1,0,0,0,1
financial aid,0,0,0,0,0,0,1,1
financial analysis,0,0,0,0,1,0,0,1
financial arrangements,0,1,0,0,0,0,0,1
financial assets,0,0,0,0,0,1,0,1
financial assistance,0,1,0,0,0,0,0,1
financial backers,0,0,1,0,0,0,0,1
financial benefits,0,0,0,1,0,0,0,1
financial books,0,0,1,0,0,0,0,1
financial commitments,0,0,1,0,0,0,0,1
financial connections,0,0,1,0,0,0,0,1
financial consulting,0,0,0,0,1,0,0,1
financial crisis,0,0,0,1,0,0,0,1
financial damage,0,1,0,0,0,0,0,1
financial experts,0,1,0,0,0,0,0,1
financial facility,0,1,0,0,0,0,0,1
financial grants,0,0,1,0,0,0,0,1
financial incentives,0,0,0,1,0,0,0,1
financial instruments,0,1,0,0,0,0,0,1
financial links,0,0,1,0,0,0,0,1
financial markets,0,1,0,0,0,0,0,1
financial mechanism,0,1,0,0,0,0,0,1
financial mechanisms,0,1,0,0,0,0,0,1
financial necessity,0,0,1,0,0,0,0,1
financial resources,0,0,0,0,1,0,0,1
financial sense,0,0,0,0,1,0,0,1
financial services,0,0,0,0,0,1,0,1
financial support,0,1,0,0,0,0,0,1
financial tools,0,0,0,0,1,0,0,1
financially incentivize,0,1,0,0,0,0,0,1
financially independent,0,1,0,0,0,0,0,1
financiers governments,0,0,0,0,0,1,0,1
financing activities,1,0,0,0,0,0,0,1
financing annually,1,0,0,0,0,0,0,1
financing commitments,0,1,0,0,0,0,0,1
financing conserving,0,0,1,0,0,0,0,1
financing deal,0,1,0,0,0,0,0,1
financing gap,0,0,1,0,0,0,0,1
financing package,0,0,1,0,0,0,0,1
financing projects,1,0,0,0,0,0,0,1
finding examples,0,0,0,0,1,0,0,1
finding snowplow,0,0,0,1,0,0,0,1
finding solutions,0,0,1,0,0,0,0,1
finding time,0,0,0,1,0,0,0,1
finding voice,0,1,0,0,0,0,0,1
findings clash,0,0,0,1,0,0,0,1
findings highlight,0,0,0,0,1,0,0,1
fine arts,0,1,0,0,0,0,0,1
fine compared,1,0,0,0,0,0,0,1
fine diaa,1,0,0,0,0,0,0,1
fine wine,0,0,0,0,0,0,1,1
fined lexington,1,0,0,0,0,0,0,1
finest farm,0,0,0,0,0,1,0,1
finger wagging,0,1,0,0,0,0,0,1
finish line,0,0,0,0,1,0,0,1
finished hiking,0,1,0,0,0,0,0,1
finishes sticking,0,0,1,0,0,0,0,1
finishing touches,0,0,0,0,1,0,0,1
finite quantities,0,0,0,1,0,0,0,1
finnish sculptor,0,1,0,0,0,0,0,1
fiona arrived,0,1,0,0,0,0,0,1
fiona brought,0,0,0,1,0,0,0,1
fiona destroyed,0,1,0,0,0,0,0,1
fiona flooded,0,1,0,0,0,0,0,1
fiona hit,1,0,0,0,0,0,0,1
fiona puerto,0,1,0,0,0,0,0,1
fiona vázquez,0,1,0,0,0,0,0,1
fir tree,0,0,1,0,0,0,0,1
fire amidst,0,1,0,0,0,0,0,1
fire burned,0,0,0,0,0,0,1,1
fire chasers.firefighter,0,0,1,0,0,0,0,1
fire destroyed,0,0,0,0,0,1,0,1
fire hose,0,0,0,1,0,0,0,1
fire intensity,0,0,0,0,0,1,0,1
fire prone,0,0,0,1,0,0,0,1
fire season,1,0,0,0,0,0,0,1
fire stations,0,0,0,1,0,0,0,1
fire suppression,0,0,0,0,0,1,0,1
fired electricity,0,0,0,0,1,0,0,1
fired plants,0,0,0,0,1,0,0,1
fired rubber,0,1,0,0,0,0,0,1
firefighter died,0,0,0,0,1,0,0,1
firefighter digging,0,0,1,0,0,0,0,1
firefighter luca,0,1,0,0,0,0,0,1
firefighter megan,0,0,1,0,0,0,0,1
firefighters charging,0,0,1,0,0,0,0,1
firefighters feel,0,0,1,0,0,0,0,1
firefighting improvements,0,0,0,0,0,1,0,1
fires fire,0,0,1,0,0,0,0,1
firewood hunting,1,0,0,0,0,0,0,1
firing beanbags,0,0,0,1,0,0,0,1
firm accenture,0,0,0,0,1,0,0,1
firm adnoc,0,0,0,1,0,0,0,1
firm based,0,0,1,0,0,0,0,1
firm believer,1,0,0,0,0,0,0,1
firm commitments,0,1,0,0,0,0,0,1
firm conclusions,0,0,0,0,0,1,0,1
firm conocophillips,0,0,0,0,0,1,0,1
firm continuing,0,0,1,0,0,0,0,1
firm created,0,0,0,0,1,0,0,1
firm dalan,0,0,0,1,0,0,0,1
firm elliott,0,0,0,0,1,0,0,1
firm eventually,0,0,1,0,0,0,0,1
firm foundation,0,0,0,0,0,0,1,1
firm global,0,0,0,1,0,0,0,1
firm helped,1,0,0,0,0,0,0,1
firm link,0,0,0,0,0,0,1,1
firm pumps,0,0,0,1,0,0,0,1
firm represented,0,0,1,0,0,0,0,1
firm rhodium,0,0,0,1,0,0,0,1
firm stoic,0,0,0,0,1,0,0,1
firm's conclusion,0,1,0,0,0,0,0,1
firm's consent,0,0,1,0,0,0,0,1
firm's records,0,0,1,0,0,0,0,1
firmageddon tree,0,0,1,0,0,0,0,1
firsthand accounts,0,1,0,0,0,0,0,1
fish dart,0,0,0,1,0,0,0,1
fish grow,0,1,0,0,0,0,0,1
fish islands,0,1,0,0,0,0,0,1
fish kills,0,0,0,1,0,0,0,1
fish move,0,0,0,0,0,1,0,1
fish shrimp,1,0,0,0,0,0,0,1
fish sticky,1,0,0,0,0,0,0,1
fisher hydrogeologist,0,0,0,1,0,0,0,1
fisher scientific,0,0,0,0,1,0,0,1
fisheries office,0,0,0,0,1,0,0,1
fisherman nasuri,0,0,1,0,0,0,0,1
fisherman noor,1,0,0,0,0,0,0,1
fisherman pushed,1,0,0,0,0,0,0,1
fisherman steering,1,0,0,0,0,0,0,1
fishermen held,1,0,0,0,0,0,0,1
fishermen quickly,1,0,0,0,0,0,0,1
fishermen zakariya,1,0,0,0,0,0,0,1
fishermen's cooperative,0,1,0,0,0,0,0,1
fishing grounds,0,1,0,0,0,0,0,1
fishing industry,0,0,0,0,1,0,0,1
fishing line,0,0,0,0,1,0,0,1
fishing nets,0,0,0,0,1,0,0,1
fishing saturday,0,0,0,0,1,0,0,1
fishing vessel,1,0,0,0,0,0,0,1
fisting beaver,0,0,0,0,1,0,0,1
fix antonio,0,0,0,0,1,0,0,1
fix climate,0,0,0,1,0,0,0,1
fix damage,0,1,0,0,0,0,0,1
fix people,0,1,0,0,0,0,0,1
fixing johnsen's,0,0,1,0,0,0,0,1
fla ap,1,0,0,0,0,0,0,1
fla nicole,0,1,0,0,0,0,0,1
fla rebecca,0,1,0,0,0,0,0,1
flag wilder's,1,0,0,0,0,0,0,1
flagler palm,0,1,0,0,0,0,0,1
flagstaff forecasters,0,0,0,0,1,0,0,1
flakes kernza,0,0,1,0,0,0,0,1
flare melilla,0,1,0,0,0,0,0,1
flaring methane,0,1,0,0,0,0,0,1
flash sort,0,0,1,0,0,0,0,1
flashiest goal,0,0,1,0,0,0,0,1
flashiest item,0,0,1,0,0,0,0,1
flat ceramic,0,0,0,0,1,0,0,1
flat piece,0,0,0,0,1,0,0,1
flat tire,0,0,0,1,0,0,0,1
flat underwater,0,0,0,0,1,0,0,1
flatbed boats,0,0,0,1,0,0,0,1
flattened businesses,1,0,0,0,0,0,0,1
flattened npr's,0,0,0,0,0,1,0,1
flavor.for npr,0,0,0,0,0,0,1,1
fleabag hotel,1,0,0,0,0,0,0,1
fled boko,0,0,1,0,0,0,0,1
flee europe,0,0,0,0,0,1,0,1
fleeing africa,0,1,0,0,0,0,0,1
fleets nationally,0,0,1,0,0,0,0,1
flightless bird,0,1,0,0,0,0,0,1
flightless seabird,1,0,0,0,0,0,0,1
flights coming,0,0,1,0,0,0,0,1
flimsy structures,0,1,0,0,0,0,0,1
floated east,1,0,0,0,0,0,0,1
floated sound,0,0,0,0,1,0,0,1
floated wednesday,0,1,0,0,0,0,0,1
floating algae,0,0,0,0,0,1,0,1
floating farm,0,0,0,0,0,1,0,1
flood activating,0,0,0,1,0,0,0,1
flood affected,1,0,0,0,0,0,0,1
flood alert,0,0,0,1,0,0,0,1
flood alerts,0,0,0,1,0,0,0,1
flood bay,0,0,0,1,0,0,0,1
flood bryce,1,0,0,0,0,0,0,1
flood buyout,0,0,0,0,1,0,0,1
flood concerns,0,0,0,0,0,1,0,1
flood controls,1,0,0,0,0,0,0,1
flood damaged,0,1,0,0,0,0,0,1
flood defenses,0,1,0,0,0,0,0,1
flood due,0,0,0,0,1,0,0,1
flood gates,0,1,0,0,0,0,0,1
flood heat,0,1,0,0,0,0,0,1
flood lake,1,0,0,0,0,0,0,1
flood level,0,1,0,0,0,0,0,1
flood levels,0,1,0,0,0,0,0,1
flood mitigation,1,0,0,0,0,0,0,1
flood plains,0,0,0,0,1,0,0,1
flood prep,0,0,0,1,0,0,0,1
flood prepared,1,0,0,0,0,0,0,1
flood proofing,0,1,0,0,0,0,0,1
flood protection,0,1,0,0,0,0,0,1
flood risks,1,0,0,0,0,0,0,1
flood scenario,0,0,0,0,0,0,1,1
flood shelter,0,0,0,0,0,1,0,1
flood stage,0,0,0,0,0,1,0,1
flood surge,0,1,0,0,0,0,0,1
flood threat,0,0,0,1,0,0,0,1
flooded akter,0,0,0,0,0,1,0,1
flooded coastal,1,0,0,0,0,0,0,1
flooded communities,0,0,0,0,1,0,0,1
flooded fields,0,0,0,0,0,1,0,1
flooded highway,1,0,0,0,0,0,0,1
flooded highways,0,0,0,1,0,0,0,1
flooded home,1,0,0,0,0,0,0,1
flooded property,1,0,0,0,0,0,0,1
flooded rivers,0,0,0,0,0,1,0,1
flooded road,0,0,0,1,0,0,0,1
flooded social,0,0,0,0,0,1,0,1
flooded streets,0,0,0,1,0,0,0,1
flooding dangerous,0,0,0,1,0,0,0,1
flooding depending,1,0,0,0,0,0,0,1
flooding diaa,1,0,0,0,0,0,0,1
flooding fires,0,0,1,0,0,0,0,1
flooding flights,0,0,0,1,0,0,0,1
flooding friday,0,1,0,0,0,0,0,1
flooding hazard,1,0,0,0,0,0,0,1
flooding heavy,1,0,0,0,0,0,0,1
flooding historically,0,0,0,0,0,1,0,1
flooding hoboken,0,0,0,1,0,0,0,1
flooding hurricane,0,1,0,0,0,0,0,1
flooding inland,1,0,0,0,0,0,0,1
flooding killed,0,0,0,0,0,1,0,1
flooding killing,0,1,0,0,0,0,0,1
flooding knock,0,0,0,0,1,0,0,1
flooding left,1,0,0,0,0,0,0,1
flooding margaret,0,0,0,0,1,0,0,1
flooding means,0,1,0,0,0,0,0,1
flooding neighborhoods,0,0,0,0,1,0,0,1
flooding people,0,1,0,0,0,0,0,1
flooding posed,1,0,0,0,0,0,0,1
flooding power,0,0,0,1,0,0,0,1
flooding proactive,1,0,0,0,0,0,0,1
flooding resiliency,0,1,0,0,0,0,0,1
flooding river,0,0,0,1,0,0,0,1
flooding ryan,0,1,0,0,0,0,0,1
flooding scenarios,0,0,0,0,0,0,1,1
flooding scores,0,0,0,0,0,1,0,1
flooding sea,0,1,0,0,0,0,0,1
flooding situation,0,0,0,0,0,1,0,1
flooding snow,0,0,0,1,0,0,0,1
flooding towns,0,0,0,0,0,1,0,1
flooding yeah,0,0,0,1,0,0,0,1
floodlight fogel,0,0,1,0,0,0,0,1
floodlight ralston,0,0,0,0,1,0,0,1
floodlight's requests,0,0,0,0,1,0,0,1
floodplain knee,1,0,0,0,0,0,0,1
floodplain managers,0,0,0,1,0,0,0,1
floodplains city,1,0,0,0,0,0,0,1
floodplains offer,1,0,0,0,0,0,0,1
floods aamir,0,1,0,0,0,0,0,1
floods act,0,0,0,1,0,0,0,1
floods ahmed,0,0,0,0,0,1,0,1
floods andy,0,1,0,0,0,0,0,1
floods brought,1,0,0,0,0,0,0,1
floods covered,0,0,0,1,0,0,0,1
floods developing,0,1,0,0,0,0,0,1
floods droughts,0,0,0,0,0,1,0,1
floods fires,0,0,1,0,0,0,0,1
floods heat,0,1,0,0,0,0,0,1
floods industrialized,0,1,0,0,0,0,0,1
floods killed,0,1,0,0,0,0,0,1
floods pakistan,1,0,0,0,0,0,0,1
floods storms,0,1,0,0,0,0,0,1
floods subsided,0,1,0,0,0,0,0,1
floods transformed,1,0,0,0,0,0,0,1
floods tyler,0,1,0,0,0,0,0,1
floods women,1,0,0,0,0,0,0,1
floodwaters burst,0,1,0,0,0,0,0,1
floodwaters invade,0,0,0,0,0,1,0,1
floodwaters lauren,0,0,0,0,0,1,0,1
floodwaters music,0,0,0,0,0,1,0,1
floodwaters overwhelmed,0,0,0,0,0,1,0,1
floodwaters poured,0,0,0,0,1,0,0,1
floodwaters swamped,1,0,0,0,0,0,0,1
floor ingram,0,0,0,0,1,0,0,1
floors empty,0,0,0,0,1,0,0,1
flora champenois,0,0,0,0,1,0,0,1
flores anadolu,0,0,0,0,0,1,0,1
florida climate,0,1,0,0,0,0,0,1
florida coastline,0,1,0,0,0,0,0,1
florida counties,0,1,0,0,0,0,0,1
florida department,1,0,0,0,0,0,0,1
florida history,1,0,0,0,0,0,0,1
florida including,0,1,0,0,0,0,0,1
florida international,1,0,0,0,0,0,0,1
florida keys,1,0,0,0,0,0,0,1
florida legislature,0,0,1,0,0,0,0,1
florida makes,0,1,0,0,0,0,0,1
florida mar,0,0,0,1,0,0,0,1
florida matrix,0,0,1,0,0,0,0,1
florida parkinson,1,0,0,0,0,0,0,1
florida rarely,0,1,0,0,0,0,0,1
florida sized,0,0,0,0,1,0,0,1
florida south,0,1,0,0,0,0,0,1
florida sun,0,1,0,0,0,0,0,1
florida supreme,1,0,0,0,0,0,0,1
florida times,0,0,1,0,0,0,0,1
florida utilities,1,0,0,0,0,0,0,1
florida win,1,0,0,0,0,0,0,1
florida yesterday,1,0,0,0,0,0,0,1
florida's death,1,0,0,0,0,0,0,1
florida's decision,1,0,0,0,0,0,0,1
florida's department,1,0,0,0,0,0,0,1
florida's governor,0,0,1,0,0,0,0,1
florida's gulf,1,0,0,0,0,0,0,1
florida's lake,0,1,0,0,0,0,0,1
florida's panhandle,0,1,0,0,0,0,0,1
flour including,0,0,0,0,0,1,0,1
flourished including,0,0,0,0,0,1,0,1
flow downhill,0,1,0,0,0,0,0,1
flower painted,0,0,0,1,0,0,0,1
flowing downhill,0,0,0,1,0,0,0,1
flowing water,0,1,0,0,0,0,0,1
flows directly,0,0,0,0,0,1,0,1
flows eastward,0,0,1,0,0,0,0,1
fluctuating price,1,0,0,0,0,0,0,1
flurries sunday,0,0,0,0,1,0,0,1
flushing scottsdale,0,0,0,0,1,0,0,1
flying killjoys,0,0,0,0,1,0,0,1
flying tornadoes,0,0,0,0,0,1,0,1
focus click,0,0,0,0,1,0,0,1
focus education,0,0,0,0,1,0,0,1
focused budget,0,0,0,1,0,0,0,1
focused clarity,0,0,1,0,0,0,0,1
focused portfolios,0,0,1,0,0,0,0,1
focused programs,0,1,0,0,0,0,0,1
fode balde,0,1,0,0,0,0,0,1
fogg professor,0,0,0,0,0,1,0,1
folgers coffee,0,0,0,0,1,0,0,1
folk songs,0,0,0,0,0,1,0,1
folkenflik reported,0,0,1,0,0,0,0,1
folks including,0,0,0,1,0,0,0,1
follow suit,0,0,0,0,0,1,0,1
followers tweeted,0,0,0,0,0,1,0,1
foment local,0,0,0,0,1,0,0,1
fontaine jr,0,0,0,0,1,0,0,1
food aid,1,0,0,0,0,0,0,1
food brands,0,1,0,0,0,0,0,1
food column,0,0,0,0,0,0,1,1
food coming,0,0,1,0,0,0,0,1
food consumption,1,0,0,0,0,0,0,1
food containers,0,0,0,1,0,0,0,1
food corporations,0,1,0,0,0,0,0,1
food court,0,1,0,0,0,0,0,1
food crisis,1,0,0,0,0,0,0,1
food decisions,0,1,0,0,0,0,0,1
food distribution,0,0,0,0,0,1,0,1
food grade,1,0,0,0,0,0,0,1
food handout,0,0,1,0,0,0,0,1
food income,0,1,0,0,0,0,0,1
food ingredients,0,0,0,0,0,1,0,1
food innovation,0,1,0,0,0,0,0,1
food instability,1,0,0,0,0,0,0,1
food items,0,1,0,0,0,0,0,1
food lovers,0,1,0,0,0,0,0,1
food mankani,1,0,0,0,0,0,0,1
food program,0,0,1,0,0,0,0,1
food regulates,0,0,1,0,0,0,0,1
food revolution,0,1,0,0,0,0,0,1
food rinker,0,0,0,0,1,0,0,1
food services,0,0,0,1,0,0,0,1
food shipments,0,1,0,0,0,0,0,1
food shortages,0,0,1,0,0,0,0,1
food snow,0,0,0,0,0,1,0,1
food stamps,0,0,0,0,0,0,1,1
food starts,0,1,0,0,0,0,0,1
food supplement,1,0,0,0,0,0,0,1
food tent,1,0,0,0,0,0,0,1
food water,0,1,0,0,0,0,0,1
food's pre,0,1,0,0,0,0,0,1
foods chicken,0,1,0,0,0,0,0,1
foods cleaning,0,0,0,0,0,0,1,1
foods david,0,1,0,0,0,0,0,1
foods founded,0,1,0,0,0,0,0,1
foods scifi,0,1,0,0,0,0,0,1
foot crossing,0,0,1,0,0,0,0,1
foot deep,0,1,0,0,0,0,0,1
foot difference,0,1,0,0,0,0,0,1
foot drop,0,1,0,0,0,0,0,1
foot facility,0,1,0,0,0,0,0,1
foot flood,0,1,0,0,0,0,0,1
foot inside,0,1,0,0,0,0,0,1
foot level,0,1,0,0,0,0,0,1
foot mount,1,0,0,0,0,0,0,1
foot pencil,0,0,0,0,1,0,0,1
foot piles,0,0,0,0,0,1,0,1
football field's,0,1,0,0,0,0,0,1
foote helped,0,0,0,0,0,1,0,1
foote's experiment,0,0,0,0,0,1,0,1
foote's study,0,0,0,0,0,1,0,1
foothills sinarimbo,1,0,0,0,0,0,0,1
footnote excluding,0,1,0,0,0,0,0,1
footprint grows,0,1,0,0,0,0,0,1
footprint sharif,0,1,0,0,0,0,0,1
för klimatet,0,0,0,0,1,0,0,1
foraging relocation,0,0,1,0,0,0,0,1
force mabbutt,0,1,0,0,0,0,0,1
force southwest,0,0,1,0,0,0,0,1
forced migration,1,0,0,0,0,0,0,1
forced people,1,0,0,0,0,0,0,1
forced residents,0,0,0,1,0,0,0,1
forced thousands,0,0,0,1,0,0,0,1
forces colonialism,0,0,0,1,0,0,0,1
forces ironically,0,0,0,1,0,0,0,1
forcibly relocated,0,0,0,0,0,1,0,1
forcing animals,0,0,0,0,0,1,0,1
forcing road,0,0,0,0,0,1,0,1
ford motor,0,0,1,0,0,0,0,1
ford sells,0,0,0,0,1,0,0,1
fordham reports,1,0,0,0,0,0,0,1
forecast dangerous,0,1,0,0,0,0,0,1
forecast heavy,0,0,0,0,1,0,0,1
forecast increasing,0,0,0,1,0,0,0,1
forecast supercells,0,0,0,0,0,1,0,1
forecast zone,0,1,0,0,0,0,0,1
forecasters launch,0,0,0,0,1,0,0,1
forecasters predict,0,0,0,1,0,0,0,1
forecasters predicted,0,0,0,0,0,1,0,1
forecasters warned,0,1,0,0,0,0,0,1
forecasting agencies,0,1,0,0,0,0,0,1
forecasts call,0,0,0,0,1,0,0,1
forecasts giving,1,0,0,0,0,0,0,1
forecasts noaa,0,0,0,1,0,0,0,1
foreign country,0,1,0,0,0,0,0,1
foreign ministry,0,0,0,0,1,0,0,1
foreign tv,0,1,0,0,0,0,0,1
forest anthony,0,0,0,1,0,0,0,1
forest borbor,0,0,0,1,0,0,0,1
forest due,0,0,0,1,0,0,0,1
forest landowner,0,0,1,0,0,0,0,1
forest landowners,0,0,1,0,0,0,0,1
forest rangers,0,0,1,0,0,0,0,1
forest resources,0,0,0,0,0,0,1,1
forest scientist,1,0,0,0,0,0,0,1
forest transported,0,1,0,0,0,0,0,1
forest watch,0,0,0,1,0,0,0,1
forests change,0,0,1,0,0,0,0,1
forests lock,0,0,1,0,0,0,0,1
forests wetlands,0,0,1,0,0,0,0,1
forever home,0,0,0,0,1,0,0,1
forged ahead,0,1,0,0,0,0,0,1
forging partnerships,0,0,0,0,0,1,0,1
fork impoundment,1,0,0,0,0,0,0,1
fork watershed,0,0,0,1,0,0,0,1
form condensation,0,0,0,0,0,1,0,1
form earlier,0,1,0,0,0,0,0,1
form hosted,0,0,0,0,0,1,0,1
form layers,0,0,0,0,0,1,0,1
formal climate,0,1,0,0,0,0,0,1
formal rate,0,0,1,0,0,0,0,1
formal study,0,0,0,1,0,0,0,1
formally called,0,0,0,0,1,0,0,1
formally registered,0,0,1,0,0,0,0,1
formed blocks,0,1,0,0,0,0,0,1
formed citizens,0,0,0,0,1,0,0,1
formed hotel,0,1,0,0,0,0,0,1
formed island,1,0,0,0,0,0,0,1
formed means,1,0,0,0,0,0,0,1
formed underneath,1,0,0,0,0,0,0,1
forming ashley,0,0,0,0,0,1,0,1
forming snowpack,0,0,0,1,0,0,0,1
formula mankani,1,0,0,0,0,0,0,1
fortified city,0,1,0,0,0,0,0,1
fortunately methane,1,0,0,0,0,0,0,1
forum lists,0,0,1,0,0,0,0,1
forum's annual,0,0,0,0,0,1,0,1
forward action,0,0,0,1,0,0,0,1
forward ap,0,1,0,0,0,0,0,1
forward creating,0,1,0,0,0,0,0,1
forward failure,0,1,0,0,0,0,0,1
forward includes,0,0,0,0,0,1,0,1
forward network,0,0,0,0,0,1,0,1
forward speaking,0,0,0,0,0,1,0,1
forward ultimately,0,0,0,0,0,1,0,1
forward.rebecca hersher,0,0,0,0,0,1,0,1
fossil energy,0,0,0,0,1,0,0,1
fossils adam,0,0,0,0,0,1,0,1
foster resilience,0,0,0,1,0,0,0,1
fostered robust,0,1,0,0,0,0,0,1
fought efforts,0,0,1,0,0,0,0,1
fought hard,0,0,0,0,1,0,0,1
fought solar,0,0,0,0,1,0,0,1
foul line,0,1,0,0,0,0,0,1
found dead,0,0,0,0,0,0,1,1
found earlier,1,0,0,0,0,0,0,1
found extreme,0,0,0,1,0,0,0,1
found females,0,0,1,0,0,0,0,1
found naturally,1,0,0,0,0,0,0,1
found polar,0,0,1,0,0,0,0,1
found pretty,1,0,0,0,0,0,0,1
found refuge,0,1,0,0,0,0,0,1
found resources,0,0,0,1,0,0,0,1
found sean,0,0,1,0,0,0,0,1
found staircase,0,0,0,0,1,0,0,1
found thousands,1,0,0,0,0,0,0,1
found trade,0,0,1,0,0,0,0,1
foundation declined,0,0,0,0,1,0,0,1
foundation kunc,0,0,0,1,0,0,0,1
foundation mission,0,0,0,0,1,0,0,1
foundation searched,0,0,0,0,0,1,0,1
foundation's president,0,0,0,0,1,0,0,1
foundation's research,1,0,0,0,0,0,0,1
foundation's tax,0,0,0,0,1,0,0,1
foundational piece,0,0,0,1,0,0,0,1
foundations stretch,0,1,0,0,0,0,0,1
founded citizens,0,0,0,0,1,0,0,1
founder bill,0,0,0,0,0,1,0,1
founder jeff,0,0,0,1,0,0,0,1
founder jennifer,0,1,0,0,0,0,0,1
founder joe,0,0,1,0,0,0,0,1
founder phil,1,0,0,0,0,0,0,1
founder ron,0,0,1,0,0,0,0,1
foundering barely,0,0,0,0,1,0,0,1
fourth dimension,0,0,0,1,0,0,0,1
fox assistant,0,0,0,1,0,0,0,1
fractured sea,0,1,0,0,0,0,0,1
fracturing potentially,0,0,0,0,1,0,0,1
fragile louisiana,0,1,0,0,0,0,0,1
fragile mankani,1,0,0,0,0,0,0,1
fragility causing,1,0,0,0,0,0,0,1
framed addressing,0,0,0,1,0,0,0,1
framework calls,0,0,1,0,0,0,0,1
framework convention,0,1,0,0,0,0,0,1
framework enabling,0,1,0,0,0,0,0,1
framework identified,0,0,1,0,0,0,0,1
framework set,0,0,1,0,0,0,0,1
fran kritz,0,0,0,0,0,1,0,1
france italy,0,0,0,0,0,1,0,1
france's leclerc,0,0,0,1,0,0,0,1
france's pyrenees,0,1,0,0,0,0,0,1
frances seymour,0,0,0,0,0,0,1,1
francis 1st,0,0,0,0,1,0,0,1
francis expressed,0,1,0,0,0,0,0,1
francisco based,0,1,0,0,0,0,0,1
francisco climate,0,0,0,0,0,1,0,1
francisco sacramento,0,0,0,1,0,0,0,1
francisco's water,0,0,0,1,0,0,0,1
frank fan's,0,0,0,0,1,0,0,1
franklin professor,0,1,0,0,0,0,0,1
frankly pretty,0,0,1,0,0,0,0,1
frankly shocking,0,0,0,1,0,0,0,1
frannie leautier,0,1,0,0,0,0,0,1
fratzscher president,0,0,0,0,0,1,0,1
fraud prevention,0,0,0,0,0,0,1,1
frayer npr,0,0,0,0,0,1,0,1
freak blizzard,0,0,0,0,0,1,0,1
frederick douglass,0,1,0,0,0,0,0,1
frederick liu,0,0,0,0,0,1,0,1
frederick livingston,0,0,0,0,0,0,1,1
free access,0,1,0,0,0,0,0,1
free alternative,0,1,0,0,0,0,0,1
free children's,0,1,0,0,0,0,0,1
free coffee,0,1,0,0,0,0,0,1
free cooking,0,0,0,0,1,0,0,1
free crossing,0,1,0,0,0,0,0,1
free democrat,0,0,1,0,0,0,0,1
free democratic,0,0,1,0,0,0,0,1
free democrats,0,0,0,1,0,0,0,1
free household,0,0,0,0,1,0,0,1
free sources,0,0,0,0,1,0,0,1
free trade,0,0,0,0,0,1,0,1
freedman professor,0,0,0,0,0,1,0,1
freelance editors,0,0,0,0,1,0,0,1
freelance journalist,0,1,0,0,0,0,0,1
freelance photographer,0,0,0,0,0,1,0,1
freelance producer,0,0,0,0,0,1,0,1
freelance video,0,1,0,0,0,0,0,1
freely farmers,0,1,0,0,0,0,0,1
freely flowing,0,1,0,0,0,0,0,1
freeport ill,1,0,0,0,0,0,0,1
freeway picture,0,0,1,0,0,0,0,1
freeze north,0,0,0,0,1,0,0,1
freeze wellheads,0,0,0,0,1,0,0,1
freezer millennia,0,1,0,0,0,0,0,1
freezer trained,0,1,0,0,0,0,0,1
freezer trucks,0,1,0,0,0,0,0,1
freezing air,0,0,0,0,1,0,0,1
freezing night,0,0,0,0,1,0,0,1
freezing portland,0,0,0,0,1,0,0,1
freezing rain,0,0,0,0,1,0,0,1
freezing temps,0,0,0,0,1,0,0,1
freight california,0,0,0,0,0,1,0,1
freight train,0,0,0,1,0,0,0,1
french amx,0,0,0,1,0,0,0,1
french border,0,0,0,1,0,0,0,1
french la,1,0,0,0,0,0,0,1
french parliament,0,1,0,0,0,0,0,1
french press,0,0,0,1,0,0,0,1
frequent applause,1,0,0,0,0,0,0,1
frequent davis,0,0,0,1,0,0,0,1
frequent roy's,0,0,0,0,1,0,0,1
frequent supporter,0,0,0,0,0,1,0,1
frequently delays,0,0,0,0,1,0,0,1
frequently lives,0,0,0,0,0,1,0,1
frequently misunderstood,0,1,0,0,0,0,0,1
fresh fighters,0,0,1,0,0,0,0,1
fresh pumpkin,0,1,0,0,0,0,0,1
fresh water,0,0,0,1,0,0,0,1
freshly graded,0,1,0,0,0,0,0,1
freshwater crops,0,0,0,0,0,1,0,1
freshwater fish,0,0,0,0,0,0,1,1
freshwater globally,0,0,0,0,0,1,0,1
freshwater sources,0,1,0,0,0,0,0,1
fresno california,0,1,0,0,0,0,0,1
fresno counties,0,0,0,1,0,0,0,1
fretted lund,1,0,0,0,0,0,0,1
friction internationally,0,0,0,0,0,1,0,1
friday barhopping,0,0,0,0,1,0,0,1
friday biden,0,1,0,0,0,0,0,1
friday nov,0,1,0,0,0,0,0,1
friday past,0,0,0,0,0,1,0,1
friday reducing,0,1,0,0,0,0,0,1
friday yeah,1,0,0,0,0,0,0,1
friday's event,0,0,0,0,0,1,0,1
friday's press,0,0,0,0,0,1,0,1
friday's snow,0,0,0,1,0,0,0,1
friday's storm,0,0,0,1,0,0,0,1
fridays striking,0,0,0,0,1,0,0,1
friedrich predicts,0,1,0,0,0,0,0,1
friedrich schleussner,0,0,0,1,0,0,0,1
friend anna,0,1,0,0,0,0,0,1
friend mariah,0,1,0,0,0,0,0,1
friend nikita,0,0,0,0,1,0,0,1
friend steven,0,1,0,0,0,0,0,1
friendlier federal,0,0,0,1,0,0,0,1
friendly alternative,0,1,0,0,0,0,0,1
friendly farming,0,0,0,1,0,0,0,1
friendly flower,0,1,0,0,0,0,0,1
friendly path,0,1,0,0,0,0,0,1
friendly policies,0,0,0,0,1,0,0,1
friends knocked,0,0,0,0,1,0,0,1
friends responded,0,0,0,1,0,0,0,1
frigid air,0,0,0,1,0,0,0,1
frigid wind,0,1,0,0,0,0,0,1
frolicking deer,0,1,0,0,0,0,0,1
front alec,1,0,0,0,0,0,0,1
front door,0,0,0,0,0,0,1,1
front line,0,1,0,0,0,0,0,1
front moves,0,0,0,0,0,1,0,1
front wheels,0,0,0,0,1,0,0,1
front windows,0,1,0,0,0,0,0,1
frosty door,0,0,0,1,0,0,0,1
frothy nature,0,0,0,0,1,0,0,1
froze water,0,1,0,0,0,0,0,1
frozen brian,0,0,0,1,0,0,0,1
frozen ocean,0,0,1,0,0,0,0,1
frozen skating,0,0,0,0,1,0,0,1
frozen slick,0,0,0,0,1,0,0,1
frozen watery,0,1,0,0,0,0,0,1
frozen world,0,1,0,0,0,0,0,1
fruit bat,0,0,0,0,0,1,0,1
fruit bats,0,0,0,0,0,1,0,1
frustrated gerard,1,0,0,0,0,0,0,1
frustrated protestors,0,1,0,0,0,0,0,1
frustrated southwest,0,0,1,0,0,0,0,1
frustrated travelers,0,0,1,0,0,0,0,1
frustration firefighters,0,0,1,0,0,0,0,1
fry register,0,0,0,0,0,1,0,1
fuel addiction,0,1,0,0,0,0,0,1
fuel age.martí,0,0,0,0,1,0,0,1
fuel burned,0,0,0,0,1,0,0,1
fuel cars,0,0,0,0,1,0,0,1
fuel cell,0,0,0,0,0,1,0,1
fuel cells,0,1,0,0,0,0,0,1
fuel combustion,0,0,0,0,1,0,0,1
fuel corruption,1,0,0,0,0,0,0,1
fuel crunches,0,0,0,1,0,0,0,1
fuel economic,0,1,0,0,0,0,0,1
fuel economy,0,0,0,0,1,0,0,1
fuel exploration,0,0,0,0,1,0,0,1
fuel industries,0,0,0,1,0,0,0,1
fuel intensive,0,1,0,0,0,0,0,1
fuel licenses,0,1,0,0,0,0,0,1
fuel licensing,0,1,0,0,0,0,0,1
fuel magnate,0,0,0,0,1,0,0,1
fuel poverty,0,0,0,0,1,0,0,1
fuel producers,0,0,0,0,1,0,0,1
fuel sales,0,0,0,1,0,0,0,1
fuel simply,1,0,0,0,0,0,0,1
fuel subsidies,1,0,0,0,0,0,0,1
fuel supplies,0,1,0,0,0,0,0,1
fueled disaster,0,1,0,0,0,0,0,1
fueled extreme,1,0,0,0,0,0,0,1
fueling migration,0,1,0,0,0,0,0,1
fuels anjali,0,0,0,0,1,0,0,1
fuels anytime,0,0,1,0,0,0,0,1
fuels aronczyk,0,0,0,0,1,0,0,1
fuels biomass,1,0,0,0,0,0,0,1
fuels christoph,0,0,1,0,0,0,0,1
fuels climate,0,1,0,0,0,0,0,1
fuels cobalt,1,0,0,0,0,0,0,1
fuels compton,0,0,0,0,0,1,0,1
fuels energy,0,0,0,1,0,0,0,1
fuels forty,0,0,0,1,0,0,0,1
fuels globally,0,0,0,0,0,1,0,1
fuels heat,1,0,0,0,0,0,0,1
fuels kenya,1,0,0,0,0,0,0,1
fuels kerosene,0,0,0,0,1,0,0,1
fuels management,0,0,1,0,0,0,0,1
fuels mike,0,1,0,0,0,0,0,1
fuels monschauer,0,0,0,0,0,0,1,1
fuels natural,0,0,1,0,0,0,0,1
fuels past,0,0,0,0,0,1,0,1
fuels petroleum,0,0,0,1,0,0,0,1
fuels releases,0,0,0,0,0,1,0,1
fuels sean,0,0,1,0,0,0,0,1
fujita ef,0,0,0,0,0,1,0,1
fulfilling prophecy,0,0,0,1,0,0,0,1
fullest extent,0,1,0,0,0,0,0,1
fumes harbert,0,0,0,0,1,0,0,1
fun naselroad,0,1,0,0,0,0,0,1
fun skating,0,0,0,0,1,0,0,1
function guiding,0,0,0,0,1,0,0,1
functioning sites,0,0,1,0,0,0,0,1
fund administration,0,1,0,0,0,0,0,1
fund commissioned,0,0,0,1,0,0,0,1
fund critical,0,0,0,0,0,1,0,1
fund diaa,1,0,0,0,0,0,0,1
fund imf,1,0,0,0,0,0,0,1
fund inaction,0,0,1,0,0,0,0,1
fund neha,1,0,0,0,0,0,0,1
fund worker,1,0,0,0,0,0,0,1
fundamental question,1,0,0,0,0,0,0,1
fundamentally change,0,0,0,0,1,0,0,1
funded centrist,1,0,0,0,0,0,0,1
funded research,0,0,0,1,0,0,0,1
funded studies,0,0,0,1,0,0,0,1
funded weather,0,1,0,0,0,0,0,1
funding ani,0,1,0,0,0,0,0,1
funding arrangement,0,1,0,0,0,0,0,1
funding bill,0,1,0,0,0,0,0,1
funding brazil,0,0,0,1,0,0,0,1
funding discussions,0,1,0,0,0,0,0,1
funding fossil,0,0,0,0,0,1,0,1
funding gap,0,0,0,1,0,0,0,1
funding including,0,1,0,0,0,0,0,1
funding joel,0,1,0,0,0,0,0,1
funding levels,0,0,0,1,0,0,0,1
funding lisa,0,0,0,0,1,0,0,1
funding locally,1,0,0,0,0,0,0,1
funding maintenance,0,0,0,1,0,0,0,1
funding mechanism,0,0,1,0,0,0,0,1
funding noaa,0,0,0,1,0,0,0,1
funding shortfalls,0,0,1,0,0,0,0,1
funding.beth ford,0,0,0,1,0,0,0,1
funds asset,0,1,0,0,0,0,0,1
funds mechanisms,0,1,0,0,0,0,0,1
funds pension,0,1,0,0,0,0,0,1
fungi start,0,1,0,0,0,0,0,1
fungus called,0,0,0,0,0,1,0,1
funnel billions,0,0,0,1,0,0,0,1
funny cannon,0,1,0,0,0,0,0,1
furnace julia,0,0,0,0,0,0,1,1
furniture survived,0,1,0,0,0,0,0,1
furry critters,0,0,1,0,0,0,0,1
furry tails,0,0,1,0,0,0,0,1
fusion metaphor,0,0,0,0,1,0,0,1
future bans,0,0,0,0,0,1,0,1
future builds,0,1,0,0,0,0,0,1
future catastrophic,0,0,0,0,1,0,0,1
future challenges,0,0,0,0,0,1,0,1
future chapter,0,1,0,0,0,0,0,1
future condition,0,0,0,1,0,0,0,1
future connor,0,0,0,0,0,1,0,1
future costs,0,0,0,1,0,0,0,1
future curricula,0,1,0,0,0,0,0,1
future deforestation,0,0,0,0,0,0,1,1
future delegates,0,0,0,1,0,0,0,1
future development,0,0,0,0,1,0,0,1
future difficult,0,0,0,0,1,0,0,1
future disasters,0,1,0,0,0,0,0,1
future droughts,0,0,1,0,0,0,0,1
future energies,0,0,0,1,0,0,0,1
future eva,1,0,0,0,0,0,0,1
future events,0,0,0,0,1,0,0,1
future explains,0,0,0,1,0,0,0,1
future floods,1,0,0,0,0,0,0,1
future funding,0,1,0,0,0,0,0,1
future generation's,0,0,1,0,0,0,0,1
future imagines,0,1,0,0,0,0,0,1
future international,0,0,0,0,1,0,0,1
future kimberly,1,0,0,0,0,0,0,1
future levees,1,0,0,0,0,0,0,1
future living,0,0,0,0,1,0,0,1
future mountain,0,0,1,0,0,0,0,1
future music,0,1,0,0,0,0,0,1
future nagel,0,1,0,0,0,0,0,1
future noaa,0,0,0,1,0,0,0,1
future oil,0,0,0,0,0,1,0,1
future outbreaks,0,0,0,0,0,1,0,1
future park,1,0,0,0,0,0,0,1
future plummer,0,1,0,0,0,0,0,1
future power,0,0,0,0,1,0,0,1
future projections,0,0,0,1,0,0,0,1
future religious,0,1,0,0,0,0,0,1
future runs,0,0,0,0,0,1,0,1
future schools,0,0,0,1,0,0,0,1
future slides,0,0,0,1,0,0,0,1
future stems,0,0,0,0,0,0,1,1
future supporters,1,0,0,0,0,0,0,1
future thunberg,0,0,0,0,1,0,0,1
future weather,0,1,0,0,0,0,0,1
future.nathan rott,0,0,0,1,0,0,0,1
futuristic vibe,0,1,0,0,0,0,0,1
g20 talks,0,1,0,0,0,0,0,1
gabriel bouys,0,0,0,0,0,1,0,1
gabrielle wong,0,1,0,0,0,0,0,1
gadsden flag,0,0,0,1,0,0,0,1
gaesser wrote,0,0,0,0,1,0,0,1
gaia larsen,0,1,0,0,0,0,0,1
gain power,0,1,0,0,0,0,0,1
gained change,0,1,0,0,0,0,0,1
gained ryan,0,1,0,0,0,0,0,1
gained traction,1,0,0,0,0,0,0,1
gaining broad,0,0,1,0,0,0,0,1
gaining strength,0,0,0,0,0,1,0,1
gains access,0,0,1,0,0,0,0,1
galapagos islands,0,0,1,0,0,0,0,1
gale force,0,0,0,0,1,0,0,1
gallery sylvia,0,1,0,0,0,0,0,1
gallery's curator,0,1,0,0,0,0,0,1
gallisá muriente,0,0,0,1,0,0,0,1
gallon gas,1,0,0,0,0,0,0,1
gallon native,0,0,0,0,0,1,0,1
gallon remembered,1,0,0,0,0,0,0,1
gallon tank,0,1,0,0,0,0,0,1
gallon toyota,0,0,0,0,1,0,0,1
galvanize action,0,1,0,0,0,0,0,1
gamaliel rodríguez,0,0,0,1,0,0,0,1
gambia growing,0,1,0,0,0,0,0,1
game changer,0,0,0,1,0,0,0,1
game changing,0,0,0,0,0,1,0,1
garbage tangled,1,0,0,0,0,0,0,1
garbage washed,0,0,0,1,0,0,0,1
garden ideally,1,0,0,0,0,0,0,1
gardens spritz,0,0,0,1,0,0,0,1
gardrea hacks,0,0,0,1,0,0,0,1
garibaldi thohir,0,0,0,0,1,0,0,1
garvin sierra,0,0,0,1,0,0,0,1
gary vannatter,1,0,0,0,0,0,0,1
gas al,0,0,0,0,0,1,0,1
gas association,0,0,0,0,1,0,0,1
gas bill,0,1,0,0,0,0,0,1
gas bulletin,1,0,0,0,0,0,0,1
gas burners,0,0,0,1,0,0,0,1
gas campaign,0,0,0,1,0,0,0,1
gas casale,0,0,0,0,1,0,0,1
gas closer,0,0,0,0,1,0,0,1
gas company,0,0,0,0,1,0,0,1
gas cooktop,0,0,0,0,1,0,0,1
gas creates,0,0,1,0,0,0,0,1
gas customers,0,1,0,0,0,0,0,1
gas deposits,0,0,1,0,0,0,0,1
gas drilling,0,0,0,0,0,1,0,1
gas effect,0,0,0,0,0,1,0,1
gas emits,0,0,0,1,0,0,0,1
gas emitters,0,1,0,0,0,0,0,1
gas emitting,1,0,0,0,0,0,0,1
gas extraction,0,0,0,0,0,1,0,1
gas facilities,0,0,0,1,0,0,0,1
gas failures,0,0,0,0,1,0,0,1
gas fields,0,1,0,0,0,0,0,1
gas fossil,0,0,0,0,0,0,1,1
gas generated,1,0,0,0,0,0,0,1
gas guzzler,0,0,0,0,1,0,0,1
gas hookups,0,1,0,0,0,0,0,1
gas increases,0,0,0,0,1,0,0,1
gas indefinitely,0,0,0,0,1,0,0,1
gas investments,0,0,1,0,0,0,0,1
gas leaks,0,0,0,0,0,1,0,1
gas lines,0,0,0,1,0,0,0,1
gas officials,0,0,0,0,0,1,0,1
gas ovens,0,0,0,1,0,0,0,1
gas peaker,0,1,0,0,0,0,0,1
gas pipes,0,0,0,1,0,0,0,1
gas power,0,1,0,0,0,0,0,1
gas produced,0,1,0,0,0,0,0,1
gas producer,0,0,0,1,0,0,0,1
gas producers,0,1,0,0,0,0,0,1
gas production,0,0,0,0,0,1,0,1
gas pumps,1,0,0,0,0,0,0,1
gas regulatory,0,0,0,0,1,0,0,1
gas released,0,1,0,0,0,0,0,1
gas requirements,0,0,1,0,0,0,0,1
gas research,0,0,0,1,0,0,0,1
gas sources,0,1,0,0,0,0,0,1
gas stations,0,1,0,0,0,0,0,1
gas suppliers,0,0,0,0,1,0,0,1
gas tank,0,0,0,0,1,0,0,1
gas technology,0,0,0,0,1,0,0,1
gas tomorrow,0,0,0,0,0,1,0,1
gas turbine,0,1,0,0,0,0,0,1
gas usage,0,0,0,0,0,0,1,1
gas vehicle,0,0,0,0,1,0,0,1
gas wimmer,0,1,0,0,0,0,0,1
gaseous chemical,0,1,0,0,0,0,0,1
gases deforestation,0,1,0,0,0,0,0,1
gases hit,1,0,0,0,0,0,0,1
gases including,1,0,0,0,0,0,0,1
gasoline engine,0,0,0,0,1,0,0,1
gasoline powered,0,1,0,0,0,0,0,1
gasses human,0,1,0,0,0,0,0,1
gasses including,0,0,0,0,0,1,0,1
gassiott joins,0,0,0,1,0,0,0,1
gates langley,0,1,0,0,0,0,0,1
gather wild,0,0,0,0,0,1,0,1
gathered strength,0,1,0,0,0,0,0,1
gathering input,0,0,0,1,0,0,0,1
gavi's hampton,0,0,0,0,0,1,0,1
gawlou moussa,0,0,1,0,0,0,0,1
gay world,1,0,0,0,0,0,0,1
gayle laird,1,0,0,0,0,0,0,1
gazette newspaper,0,0,0,0,1,0,0,1
gbh reporter,0,0,0,0,1,0,0,1
gdp growth,0,1,0,0,0,0,0,1
gehad hamdy,0,1,0,0,0,0,0,1
gemma nelson,0,0,0,0,1,0,0,1
gen zs,0,1,0,0,0,0,0,1
gender lin,0,1,0,0,0,0,0,1
gender race,0,0,0,0,1,0,0,1
gene bank,0,0,1,0,0,0,0,1
gene myers,0,1,0,0,0,0,0,1
general's analysis,0,0,0,0,0,0,1,1
general's office,0,0,0,1,0,0,0,1
generate applications,1,0,0,0,0,0,0,1
generate heating,1,0,0,0,0,0,0,1
generate indoor,0,0,0,0,1,0,0,1
generate money,0,0,0,0,1,0,0,1
generated buzz,0,0,0,1,0,0,0,1
generated extreme,0,0,0,0,0,1,0,1
generated millions,0,0,0,0,1,0,0,1
generates greenhouse,0,1,0,0,0,0,0,1
generates money,0,0,0,1,0,0,0,1
generating capacity,0,0,0,1,0,0,0,1
generating electricity,0,0,0,1,0,0,0,1
generating empathy,0,1,0,0,0,0,0,1
generating pollution,0,0,1,0,0,0,0,1
generation ancona,1,0,0,0,0,0,0,1
generation capacity,0,0,0,1,0,0,0,1
generation confronts,0,1,0,0,0,0,0,1
generation machine,0,0,0,1,0,0,0,1
generation retires,0,0,0,0,1,0,0,1
generation significant,0,0,0,1,0,0,0,1
generation's lives,0,0,1,0,0,0,0,1
generational impact,0,0,0,0,0,1,0,1
generations ability,0,0,1,0,0,0,0,1
generations coming,0,0,0,0,0,1,0,1
generations england,0,0,0,1,0,0,0,1
generations lives,0,0,0,1,0,0,0,1
generations prisma,0,0,1,0,0,0,0,1
generators suggestions,0,0,0,0,1,0,0,1
generosity perseverance,0,1,0,0,0,0,0,1
genetic material,0,0,1,0,0,0,0,1
genetic resistance,0,0,0,0,0,1,0,1
genetic resources,0,0,0,0,0,1,0,1
genevieve foskett,0,0,0,0,1,0,0,1
gensini ap,0,0,0,0,0,1,0,1
gensini told,0,0,0,0,0,1,0,1
gently moving,0,0,0,0,0,1,0,1
gently revving,0,0,0,1,0,0,0,1
gently sends,0,0,0,0,1,0,0,1
gentrification school,1,0,0,0,0,0,0,1
genus neotamius,0,0,1,0,0,0,0,1
geo hazards,1,0,0,0,0,0,0,1
geo intelligence,0,0,0,1,0,0,0,1
geoff brumfiel,0,0,0,0,0,1,0,1
geoffrey goose,0,0,0,0,1,0,0,1
geoffrey supran,0,0,0,1,0,0,0,1
geographer kevin,0,0,0,1,0,0,0,1
geographic national,0,1,0,0,0,0,0,1
geographic published,0,0,1,0,0,0,0,1
geographic super,0,1,0,0,0,0,0,1
geographically diverse,0,0,0,0,0,1,0,1
geographically surrounded,0,1,0,0,0,0,0,1
geography south,0,0,0,0,0,1,0,1
geologic terms,1,0,0,0,0,0,0,1
geologist hired,0,0,0,1,0,0,0,1
geologist riccardo,0,1,0,0,0,0,0,1
geology standpoint,0,0,0,1,0,0,0,1
geometric growth,0,0,0,0,1,0,0,1
geometric shapes,1,0,0,0,0,0,0,1
geopolitical tiles,0,1,0,0,0,0,0,1
georgia bee,0,0,0,1,0,0,0,1
georgia island's,0,1,0,0,0,0,0,1
geothermal projects,0,0,0,0,1,0,0,1
gerald satterwhite,0,0,0,1,0,0,0,1
gerard stolar,1,0,0,0,0,0,0,1
german explorer,0,1,0,0,0,0,0,1
german industry,0,0,0,0,0,1,0,1
german institute,0,0,0,0,0,1,0,1
german media,0,0,0,0,0,1,0,1
german police,0,0,1,0,0,0,0,1
germanwatch praises,0,0,0,1,0,0,0,1
germany china,0,0,0,0,0,1,0,1
germany europe's,0,0,1,0,0,0,0,1
germany picture,0,0,0,0,1,0,0,1
germany's electricity,0,0,0,1,0,0,0,1
germany's environmental,0,0,1,0,0,0,0,1
germany's leopard,0,0,0,1,0,0,0,1
germany's request,0,0,0,0,0,1,0,1
getz ice,0,1,0,0,0,0,0,1
ghansadih colliery,0,0,0,0,1,0,0,1
ghansadih savitri,0,0,0,0,1,0,0,1
gharabli afp,0,1,0,0,0,0,0,1
ghebreyesus spoke,0,0,0,0,0,1,0,1
ghost forest,0,1,0,0,0,0,0,1
ghostly chill,0,1,0,0,0,0,0,1
ghostly white,0,1,0,0,0,0,0,1
giacomo pascale,0,1,0,0,0,0,0,1
giant credit,0,0,0,0,0,1,0,1
giant fans,1,0,0,0,0,0,0,1
giant glaciers,0,1,0,0,0,0,0,1
giant image,0,0,0,1,0,0,0,1
giant land,0,0,0,1,0,0,0,1
giant map,1,0,0,0,0,0,0,1
giant pipeline,0,0,1,0,0,0,0,1
giant powerpoint,0,0,0,0,0,0,1,1
giant sinkhole,0,0,0,1,0,0,0,1
giant surface,1,0,0,0,0,0,0,1
giant tesla,0,1,0,0,0,0,0,1
giant warehouses,0,1,0,0,0,0,0,1
giffin louisville,1,0,0,0,0,0,0,1
gillieron keystone,0,0,0,1,0,0,0,1
gilly moon,0,1,0,0,0,0,0,1
girl drowned,0,1,0,0,0,0,0,1
girl gestures,1,0,0,0,0,0,0,1
girl holds,1,0,0,0,0,0,0,1
girl's village,0,0,0,0,1,0,0,1
girls dances,0,0,0,0,1,0,0,1
gitmo prisoners,0,0,0,0,1,0,0,1
giusti ap,0,0,0,1,0,0,0,1
giving communities,1,0,0,0,0,0,0,1
giving money,0,0,0,0,1,0,0,1
giving tours,0,0,0,1,0,0,0,1
glacial ice,0,1,0,0,0,0,0,1
glacial lake,0,1,0,0,0,0,0,1
glacial noises,1,0,0,0,0,0,0,1
glacier breaks,0,0,0,0,1,0,0,1
glacier dichek,0,0,0,0,1,0,0,1
glacier international,0,1,0,0,0,0,0,1
glacier melt,0,1,0,0,0,0,0,1
glacier melts,0,1,0,0,0,0,0,1
glacier monitoring,0,1,0,0,0,0,0,1
glacier retreat,0,0,0,0,1,0,0,1
glacier scientists,0,0,0,0,1,0,0,1
glacier surface,0,0,0,0,1,0,0,1
glaciers found,0,1,0,0,0,0,0,1
glaciers include,0,1,0,0,0,0,0,1
glaciers james,1,0,0,0,0,0,0,1
glaciers melted,1,0,0,0,0,0,0,1
glaciers move,0,1,0,0,0,0,0,1
glaciers sound,1,0,0,0,0,0,0,1
glaciologist richard,0,0,0,0,1,0,0,1
gladwell getty,0,0,0,0,1,0,0,1
gladys martínez,0,0,0,0,1,0,0,1
glaring absence,0,0,1,0,0,0,0,1
glass breaking,0,1,0,0,0,0,0,1
glass containers,0,0,0,0,0,1,0,1
glass tube,0,0,0,0,0,1,0,1
glenn beck,0,0,0,0,0,1,0,1
glenn youngkin,1,0,0,0,0,0,0,1
glenwood springs,0,0,0,0,0,0,1,1
global agreement,0,0,1,0,0,0,0,1
global agriculture,0,1,0,0,0,0,0,1
global biodiversity,0,0,1,0,0,0,0,1
global catastrophe,0,0,0,0,1,0,0,1
global center,0,1,0,0,0,0,0,1
global commons,0,0,0,0,1,0,0,1
global computer,0,0,0,0,0,1,0,1
global dangers,0,1,0,0,0,0,0,1
global demand,0,1,0,0,0,0,0,1
global efforts,0,0,0,0,0,0,1,1
global emitter,0,0,0,0,1,0,0,1
global farmland,0,1,0,0,0,0,0,1
global forest,0,0,0,1,0,0,0,1
global forests,0,0,0,0,0,0,1,1
global framework,0,0,1,0,0,0,0,1
global health,0,1,0,0,0,0,0,1
global heating,0,0,0,0,0,0,1,1
global industries,0,0,0,0,1,0,0,1
global inequality,0,1,0,0,0,0,0,1
global infrastructure,0,1,0,0,0,0,0,1
global jervois,1,0,0,0,0,0,0,1
global leaders,0,0,0,0,1,0,0,1
global methane,1,0,0,0,0,0,0,1
global mou,0,1,0,0,0,0,0,1
global nonprofit,0,0,0,0,0,0,1,1
global ocean,0,0,0,0,1,0,0,1
global oceans,0,0,0,0,1,0,0,1
global oil,0,0,0,0,0,1,0,1
global policy,0,0,1,0,0,0,0,1
global political,0,0,0,1,0,0,0,1
global realization,0,1,0,0,0,0,0,1
global recession,1,0,0,0,0,0,0,1
global reliance,0,0,0,0,0,1,0,1
global response,0,1,0,0,0,0,0,1
global responsibility,0,1,0,0,0,0,0,1
global risks,0,0,1,0,0,0,0,1
global scale,0,0,0,0,1,0,0,1
global scene,0,1,0,0,0,0,0,1
global shield,0,1,0,0,0,0,0,1
global supplies,0,1,0,0,0,0,0,1
global systems,0,0,0,0,0,1,0,1
global threat,0,0,0,0,0,1,0,1
global tracker,0,1,0,0,0,0,0,1
global trend,1,0,0,0,0,0,0,1
global upheaval,0,1,0,0,0,0,0,1
global water,0,0,0,0,0,1,0,1
global witness,0,0,0,1,0,0,0,1
globally coal,0,0,0,0,0,1,0,1
globally connor,0,0,0,0,0,1,0,1
globally significant,0,0,0,0,0,1,0,1
globe climate,0,0,0,1,0,0,0,1
globe economically,0,1,0,0,0,0,0,1
globe scientists,0,0,0,0,0,1,0,1
globe top,0,1,0,0,0,0,0,1
gloom phase,0,0,0,0,0,1,0,1
gloves ian,0,1,0,0,0,0,0,1
glue fixing,0,0,1,0,0,0,0,1
gm canada's,0,0,0,0,0,1,0,1
goal agreed,0,0,0,1,0,0,0,1
goal alive,1,0,0,0,0,0,0,1
goal emissions,0,1,0,0,0,0,0,1
goal enrolling,0,1,0,0,0,0,0,1
goal globally,0,0,1,0,0,0,0,1
goal set,1,0,0,0,0,0,0,1
goal yeah,1,0,0,0,0,0,0,1
goals abroad,0,1,0,0,0,0,0,1
goals california,0,1,0,0,0,0,0,1
goals cleaning,0,0,0,1,0,0,0,1
goals dillen,0,0,0,0,0,1,0,1
goals include,0,1,0,0,0,0,0,1
goals joining,0,1,0,0,0,0,0,1
goals kaimuddin's,0,0,0,0,1,0,0,1
goals lead,0,1,0,0,0,0,0,1
goals similar,0,0,1,0,0,0,0,1
gobi fish,1,0,0,0,0,0,0,1
god guns,0,0,0,1,0,0,0,1
god laughter,0,0,0,0,1,0,0,1
god snow,0,0,0,0,1,0,0,1
god whoppers,0,0,0,0,0,1,0,1
gogh sunflower,0,1,0,0,0,0,0,1
gogh's sunflowers,0,1,0,0,0,0,0,1
golden light,0,1,0,0,0,0,0,1
golden mealworms,0,0,0,0,0,1,0,1
goldman ap,1,0,0,0,0,0,0,1
golf carts,0,1,0,0,0,0,0,1
golf developments,1,0,0,0,0,0,0,1
gonia explained,1,0,0,0,0,0,0,1
gonna fight,1,0,0,0,0,0,0,1
gonzález director,1,0,0,0,0,0,0,1
google facebook,0,0,0,0,0,1,0,1
gop donor,0,0,0,0,1,0,0,1
gop leader,1,0,0,0,0,0,0,1
gop luminaries,0,0,0,0,1,0,0,1
gora slavica,0,0,1,0,0,0,0,1
gora tells,0,0,1,0,0,0,0,1
gore added,0,1,0,0,0,0,0,1
gore hopes,0,1,0,0,0,0,0,1
gore recently,0,1,0,0,0,0,0,1
goree island,1,0,0,0,0,0,0,1
gosh toxic,0,0,0,0,1,0,0,1
gourds annually,0,1,0,0,0,0,0,1
gourds spinach,0,0,0,0,0,1,0,1
gov andy,0,1,0,0,0,0,0,1
gov bill,0,0,0,0,0,0,1,1
gov bob,1,0,0,0,0,0,0,1
gov glenn,1,0,0,0,0,0,0,1
gov hobbs,0,0,0,0,1,0,0,1
gov j.b,0,0,0,0,0,0,1,1
gov kate,1,0,0,0,0,0,0,1
gov kevin,0,1,0,0,0,0,0,1
gov larry,1,0,0,0,0,0,0,1
gov reuben,1,0,0,0,0,0,0,1
gov sarah,0,0,0,0,0,0,1,1
gov spencer,0,0,0,0,1,0,0,1
governance esg,0,0,1,0,0,0,0,1
governance investing.martí,0,0,1,0,0,0,0,1
governed melilla,0,1,0,0,0,0,0,1
governing coalition,0,0,1,0,0,0,0,1
governing development,1,0,0,0,0,0,0,1
governing growth,1,0,0,0,0,0,0,1
government affairs,0,1,0,0,0,0,0,1
government agree,0,0,0,0,0,1,0,1
government awarded,0,0,0,1,0,0,0,1
government bals,0,0,0,1,0,0,0,1
government cares,0,0,0,0,1,0,0,1
government data,0,0,0,0,0,1,0,1
government development,0,1,0,0,0,0,0,1
government expresses,0,1,0,0,0,0,0,1
government flood,0,0,0,0,1,0,0,1
government garnered,0,1,0,0,0,0,0,1
government grants,0,1,0,0,0,0,0,1
government handed,0,0,0,0,1,0,0,1
government hypothesizes,0,0,0,0,0,1,0,1
government immediately,0,1,0,0,0,0,0,1
government inaction,0,1,0,0,0,0,0,1
government information,0,1,0,0,0,0,0,1
government infrastructure,0,1,0,0,0,0,0,1
government investments,0,0,0,1,0,0,0,1
government invests,0,1,0,0,0,0,0,1
government leaders,0,1,0,0,0,0,0,1
government office,1,0,0,0,0,0,0,1
government offices,0,1,0,0,0,0,0,1
government officials,0,0,1,0,0,0,0,1
government passed,0,1,0,0,0,0,0,1
government pays,0,0,0,1,0,0,0,1
government plans,0,0,0,1,0,0,0,1
government program,0,0,0,0,0,0,1,1
government protections,0,1,0,0,0,0,0,1
government recently,0,0,0,0,0,1,0,1
government regulators,0,0,0,0,1,0,0,1
government run,0,0,0,0,1,0,0,1
government scientists,0,1,0,0,0,0,0,1
government scott,1,0,0,0,0,0,0,1
government sets,0,1,0,0,0,0,0,1
government sic,0,0,0,0,0,1,0,1
government started,1,0,0,0,0,0,0,1
government study,0,0,0,1,0,0,0,1
government support,0,0,0,0,1,0,0,1
government takes,1,0,0,0,0,0,0,1
government told,1,0,0,0,0,0,0,1
government twenty,0,1,0,0,0,0,0,1
government's ambitious,0,0,1,0,0,0,0,1
government's announcement,0,0,0,0,0,1,0,1
government's climate,0,0,1,0,0,0,0,1
government's decision,0,1,0,0,0,0,0,1
government's drought,0,0,0,0,0,1,0,1
government's emergency,0,0,0,0,1,0,0,1
government's flood,0,0,0,0,0,1,0,1
government's lawyer,0,0,0,0,0,1,0,1
government's main,1,0,0,0,0,0,0,1
government's operation,0,0,0,0,1,0,0,1
government's plans,0,1,0,0,0,0,0,1
government's presence,0,0,1,0,0,0,0,1
government's responsibilities,0,0,0,0,0,1,0,1
government's role,0,0,0,0,1,0,0,1
governments agree,0,1,0,0,0,0,0,1
governments backsliding,0,1,0,0,0,0,0,1
governments banks,0,1,0,0,0,0,0,1
governments creating,0,0,0,0,0,1,0,1
governments decide,0,0,0,1,0,0,0,1
governments financiers,0,0,0,0,0,1,0,1
governments imposed,0,0,0,0,0,1,0,1
governments providing,0,0,0,1,0,0,0,1
governments universities,0,0,0,0,1,0,0,1
governments worried,0,0,0,0,0,1,0,1
governor coming,0,0,0,0,0,0,1,1
governor jay,0,0,0,0,1,0,0,1
governor phil,0,0,0,0,1,0,0,1
governor spencer,0,0,0,0,1,0,0,1
governor's task,1,0,0,0,0,0,0,1
governors late,0,0,0,0,1,0,0,1
gowns goggles,0,1,0,0,0,0,0,1
gozo diaa,1,0,0,0,0,0,0,1
gps monitoring,0,0,0,1,0,0,0,1
gps tracking,0,0,0,0,1,0,0,1
grab handheld,0,0,0,1,0,0,0,1
grab hardhats,0,1,0,0,0,0,0,1
grabbing action,0,1,0,0,0,0,0,1
grade class,0,1,0,0,0,0,0,1
grade housing,0,0,0,0,1,0,0,1
grade steam,1,0,0,0,0,0,0,1
grade teachers,0,0,0,0,1,0,0,1
grader li,0,0,0,1,0,0,0,1
graders understand,0,0,0,1,0,0,0,1
gradual transition,0,0,0,0,1,0,0,1
gradually electrify,0,0,0,1,0,0,0,1
gradually increases,0,0,1,0,0,0,0,1
gradually starved,0,1,0,0,0,0,0,1
graduate student,0,0,0,0,0,1,0,1
graff opb,1,0,0,0,0,0,0,1
graham fogg,0,0,0,0,0,1,0,1
grain export,0,1,0,0,0,0,0,1
grain shipments,0,1,0,0,0,0,0,1
grains vegetables,0,1,0,0,0,0,0,1
grand bayou,0,1,0,0,0,0,0,1
grand piano,0,0,0,0,1,0,0,1
grand scheme,0,0,0,1,0,0,0,1
grand statements,0,1,0,0,0,0,0,1
grandfather's rebuilt,0,1,0,0,0,0,0,1
grandfather's town,0,1,0,0,0,0,0,1
grandmother died,0,1,0,0,0,0,0,1
grandmother's death,0,0,0,0,0,1,0,1
grandpa nicknamed,0,1,0,0,0,0,0,1
grandparents home,0,1,0,0,0,0,0,1
grant deane,1,0,0,0,0,0,0,1
grant portfolio,0,0,0,0,0,0,1,1
grant reid,0,1,0,0,0,0,0,1
granted berhe,0,0,1,0,0,0,0,1
granted citizenship,0,1,0,0,0,0,0,1
granted endangered,1,0,0,0,0,0,0,1
granted waivers,0,0,0,0,0,1,0,1
graphic descriptions,0,1,0,0,0,0,0,1
gras indian,0,1,0,0,0,0,0,1
grass appears,0,0,0,1,0,0,0,1
grass community,0,1,0,0,0,0,0,1
grass leaves,1,0,0,0,0,0,0,1
grassroots activists,0,0,0,0,1,0,0,1
grassroots organization,0,0,0,0,1,0,0,1
grates vicinity,1,0,0,0,0,0,0,1
grave moral,0,0,0,0,1,0,0,1
grave repercussions,0,0,0,0,0,0,1,1
graves adds,0,0,0,0,1,0,0,1
graves executive,0,0,0,0,1,0,0,1
gray brimmed,0,1,0,0,0,0,0,1
gray maine,0,0,0,0,1,0,0,1
gray morning,0,0,0,0,1,0,0,1
gray st,1,0,0,0,0,0,0,1
graze animals,0,1,0,0,0,0,0,1
graze cattle,0,1,0,0,0,0,0,1
grazing sheep,0,0,0,0,1,0,0,1
grease trap,0,0,0,0,1,0,0,1
greatly reduce,1,0,0,0,0,0,0,1
green building,0,1,0,0,0,0,0,1
green deal,0,0,0,0,0,1,0,1
green economy,0,0,0,0,0,1,0,1
green energy,0,1,0,0,0,0,0,1
green golf,0,0,0,1,0,0,0,1
green growers,0,0,0,0,0,1,0,1
green headstones,0,0,0,1,0,0,0,1
green industrial,0,0,0,0,1,0,0,1
green lawns,0,0,0,1,0,0,0,1
green manufacturing,0,0,0,0,1,0,0,1
green pivots,0,0,0,0,1,0,0,1
green power,1,0,0,0,0,0,0,1
green ready,1,0,0,0,0,0,0,1
green revolution,0,1,0,0,0,0,0,1
green rooted,0,0,0,1,0,0,0,1
green rows,0,1,0,0,0,0,0,1
green spaces,1,0,0,0,0,0,0,1
green sr,0,1,0,0,0,0,0,1
green subaru,1,0,0,0,0,0,0,1
green swamp,1,0,0,0,0,0,0,1
green tech,0,0,0,0,1,0,0,1
green technology,0,0,0,0,0,1,0,1
greener choices,0,1,0,0,0,0,0,1
greener electric,0,0,0,0,1,0,0,1
greener industrial,0,1,0,0,0,0,0,1
greenland kerem,1,0,0,0,0,0,0,1
greenpeace city,0,0,0,1,0,0,0,1
greenpeace usa,1,0,0,0,0,0,0,1
greenpeace's views,1,0,0,0,0,0,0,1
greens party,0,1,0,0,0,0,0,1
greens research,0,0,0,0,0,1,0,1
greg abbott,0,1,0,0,0,0,0,1
greg abbott's,0,0,0,0,1,0,0,1
greg benton,0,0,0,0,1,0,0,1
gregory ablavsky,0,0,0,0,0,1,0,1
grew concerned,0,0,0,0,1,0,0,1
grew dark,0,0,0,0,0,1,0,1
grew wary,1,0,0,0,0,0,0,1
grey chevrolet,0,1,0,0,0,0,0,1
grid abandoned,0,0,0,0,1,0,0,1
grid candelaria,0,0,0,0,1,0,0,1
grid collapsed,0,0,0,1,0,0,0,1
grid days,0,1,0,0,0,0,0,1
grid emergency,0,0,0,0,1,0,0,1
grid modernization,0,0,0,1,0,0,0,1
grid runs,0,0,0,0,1,0,0,1
grid specialists,0,0,0,0,1,0,0,1
grid yeah,0,1,0,0,0,0,0,1
grilled chicken,0,1,0,0,0,0,0,1
grim details,0,1,0,0,0,0,0,1
grim predictions,0,1,0,0,0,0,0,1
grim scientists,0,1,0,0,0,0,0,1
grim story,0,0,0,0,1,0,0,1
grindon reports,0,0,0,0,1,0,0,1
grizzly creek,0,0,0,0,0,0,1,1
groceries clothes,0,0,0,0,0,1,0,1
grocery aisle,1,0,0,0,0,0,0,1
grocery store,0,0,0,0,0,1,0,1
ground additionally,0,0,0,1,0,0,0,1
ground anticipating,0,0,0,0,1,0,0,1
ground breaking,0,0,0,0,1,0,0,1
ground cover,0,0,0,0,0,0,1,1
ground depending,0,1,0,0,0,0,0,1
ground funny,0,1,0,0,0,0,0,1
ground houser,0,0,0,0,1,0,0,1
ground lawn,1,0,0,0,0,0,0,1
ground level,0,0,0,0,0,1,0,1
ground lots,0,0,0,0,0,1,0,1
ground rules,0,0,0,0,0,1,0,1
ground saturation,0,0,0,0,0,1,0,1
ground schaeffer,0,0,1,0,0,0,0,1
ground sinarimbo,1,0,0,0,0,0,0,1
ground south,1,0,0,0,0,0,0,1
ground suspected,0,0,0,0,0,1,0,1
ground temperature,0,0,0,1,0,0,0,1
ground vannatter,1,0,0,0,0,0,0,1
ground water,0,0,0,0,1,0,0,1
groundbreaking effort,0,0,1,0,0,0,0,1
grounding line,0,0,0,0,1,0,0,1
groundwater aquifers,0,0,0,1,0,0,0,1
groundwater ferris,0,0,0,0,1,0,0,1
groundwater law,0,0,0,0,0,1,0,1
groundwater laws,0,0,0,0,1,0,0,1
groundwater management,0,0,0,0,1,0,0,1
groundwater report,0,0,0,0,1,0,0,1
groundwater reservoirs,0,0,0,0,0,1,0,1
groundwater resources,0,0,0,0,1,0,0,1
groundwater system,0,0,0,0,0,1,0,1
group.choksi city,0,0,0,1,0,0,0,1
group's leader,0,0,0,0,1,0,0,1
group's rhetoric,0,0,0,0,1,0,0,1
group's warnings,0,0,0,0,1,0,0,1
group's website,0,0,0,0,1,0,0,1
grow anymore,0,0,0,0,1,0,0,1
grow bitter,0,0,0,0,0,1,0,1
grow crops,0,0,0,0,0,1,0,1
grow grain,0,1,0,0,0,0,0,1
grow lights,0,0,0,1,0,0,0,1
grow peanuts,0,1,0,0,0,0,0,1
grow pecans,1,0,0,0,0,0,0,1
grow sunday,0,0,0,0,0,0,1,1
grow tall,0,0,0,0,0,0,1,1
grow upwards,1,0,0,0,0,0,0,1
grow vegetables,0,1,0,0,0,0,0,1
grower shipper,0,0,0,0,0,1,0,1
growing appetite,0,1,0,0,0,0,0,1
growing communities,1,0,0,0,0,0,0,1
growing conditions,1,0,0,0,0,0,0,1
growing demand,0,0,1,0,0,0,0,1
growing enmity,0,1,0,0,0,0,0,1
growing ev,0,0,0,0,0,1,0,1
growing extinction,1,0,0,0,0,0,0,1
growing focus,0,1,0,0,0,0,0,1
growing frustrations,0,1,0,0,0,0,0,1
growing hay,0,0,0,0,1,0,0,1
growing human,0,1,0,0,0,0,0,1
growing importance,0,0,0,0,0,1,0,1
growing influence,0,0,0,0,1,0,0,1
growing level,0,0,0,0,0,1,0,1
growing population,0,0,0,0,1,0,0,1
growing populations,0,0,0,1,0,0,0,1
growing process,0,1,0,0,0,0,0,1
growing simply,0,1,0,0,0,0,0,1
growing thirsty,1,0,0,0,0,0,0,1
growing threat,0,1,0,0,0,0,0,1
growing tomatoes,0,0,0,0,0,1,0,1
growing weariness,0,1,0,0,0,0,0,1
growing.julia simon,0,0,0,0,0,1,0,1
grown directly,0,1,0,0,0,0,0,1
grown meaning,0,0,0,0,0,0,1,1
grown meat,0,0,1,0,0,0,0,1
grown ups,0,1,0,0,0,0,0,1
grows inside,0,1,0,0,0,0,0,1
grows louder,0,0,0,0,0,1,0,1
grows potatoes,0,1,0,0,0,0,0,1
growth development,0,0,0,0,0,1,0,1
growth encompassing,0,0,0,0,1,0,0,1
growth hub,0,1,0,0,0,0,0,1
growth industry,1,0,0,0,0,0,0,1
growth medium,0,1,0,0,0,0,0,1
growth orbsorn,0,0,0,0,1,0,0,1
growth plan,0,0,0,0,1,0,0,1
growth plans,1,0,0,0,0,0,0,1
growth prospects,0,0,0,1,0,0,0,1
growth rules,1,0,0,0,0,0,0,1
growth seasonal,0,0,0,0,0,1,0,1
growth socio,0,0,0,0,0,1,0,1
growth stroud,1,0,0,0,0,0,0,1
growth understood,1,0,0,0,0,0,0,1
growth utah,0,0,0,0,1,0,0,1
grubby clothes,1,0,0,0,0,0,0,1
grubs fattened,0,0,0,0,0,1,0,1
grunt porter,1,0,0,0,0,0,0,1
gti energy's,0,0,0,0,1,0,0,1
guantanamo prisoner,0,0,0,0,1,0,0,1
guantanamo prisoners,0,0,0,0,1,0,0,1
guantanamo yeah,0,0,0,0,1,0,0,1
guantanamo's military,0,0,0,0,1,0,0,1
guaranteed buyer,1,0,0,0,0,0,0,1
guaranteed cleanup,1,0,0,0,0,0,0,1
guaranteeing energy,0,0,1,0,0,0,0,1
guard confirmed,0,0,0,0,0,0,1,1
guard soldiers,1,0,0,0,0,0,0,1
guard stranding,1,0,0,0,0,0,0,1
guard told,1,0,0,0,0,0,0,1
guard video,1,0,0,0,0,0,0,1
guards patrolling,0,1,0,0,0,0,0,1
guatemala storms,1,0,0,0,0,0,0,1
guatemalan officials,1,0,0,0,0,0,0,1
guayule produces,1,0,0,0,0,0,0,1
guess honesty,0,0,0,0,1,0,0,1
guest appearances,0,1,0,0,0,0,0,1
guest lighting,1,0,0,0,0,0,0,1
guest steven,1,0,0,0,0,0,0,1
guest workers,1,0,0,0,0,0,0,1
guidelines set,0,1,0,0,0,0,0,1
guiding decision,0,0,0,0,1,0,0,1
guilanpour vice,0,1,0,0,0,0,0,1
guilhem joins,0,0,0,0,0,1,0,1
guillermo gonzález,1,0,0,0,0,0,0,1
guilt throwing,0,1,0,0,0,0,0,1
guinan missouri's,1,0,0,0,0,0,0,1
guinea outbreak,0,0,0,0,0,1,0,1
guinea suspected,0,0,0,0,0,1,0,1
guitars dulcimers,0,1,0,0,0,0,0,1
gujarat earthquake,0,1,0,0,0,0,0,1
gulf arab,0,0,0,1,0,0,0,1
gulf coastline,0,1,0,0,0,0,0,1
gulping data,0,0,0,0,1,0,0,1
gun laws,0,0,0,0,1,0,0,1
gun rights,0,0,0,1,0,0,0,1
guns gas,0,0,0,1,0,0,0,1
guns people,0,1,0,0,0,0,0,1
gusts knocked,0,1,0,0,0,0,0,1
gusts powering,0,0,0,0,1,0,0,1
gut wrenching,1,0,0,0,0,0,0,1
guterres announced,0,0,0,0,0,1,0,1
guterres listens,0,1,0,0,0,0,0,1
guy stumbles,0,0,0,0,1,0,0,1
guy's arm,0,0,0,0,1,0,0,1
guys banks,0,0,0,0,0,1,0,1
guys driving,0,0,1,0,0,0,0,1
gwyn beattie,0,0,0,1,0,0,0,1
h.w chiu,0,0,0,1,0,0,0,1
haaland formally,0,0,0,0,0,1,0,1
haaland opposition,0,0,0,0,0,1,0,1
haaland touted,0,0,0,0,1,0,0,1
habeck told,0,0,1,0,0,0,0,1
habeck warned,0,0,1,0,0,0,0,1
habitat loss,0,0,1,0,0,0,0,1
habitat underwater,1,0,0,0,0,0,0,1
habitat warmer,0,0,0,1,0,0,0,1
habitually focused,0,1,0,0,0,0,0,1
hager alex,1,0,0,0,0,0,0,1
hager reports,1,0,0,0,0,0,0,1
hagerty dicroce,1,0,0,0,0,0,0,1
hail damage,1,0,0,0,0,0,0,1
hail spawning,0,0,0,0,0,1,0,1
hair nets,0,1,0,0,0,0,0,1
haitian migrants,0,1,0,0,0,0,0,1
half billion,0,0,0,0,1,0,0,1
half dozen,0,1,0,0,0,0,0,1
half hour,0,0,0,0,0,1,0,1
half shell,0,0,0,0,0,0,1,1
half southeast,0,0,0,0,0,0,1,1
half wait,0,0,0,0,1,0,0,1
hall julia,0,0,0,0,1,0,0,1
halted exploration,0,0,0,0,0,1,0,1
halting willow,0,0,0,0,0,1,0,1
hamdy dpa,0,1,0,0,0,0,0,1
hampshire department,0,0,0,1,0,0,0,1
hampshire's department,0,0,0,1,0,0,0,1
hampshire's white,0,0,0,0,1,0,0,1
hampton roads,0,1,0,0,0,0,0,1
hanak director,0,0,0,0,0,1,0,1
hand continues,0,0,1,0,0,0,0,1
hand faced,0,0,0,1,0,0,0,1
hand hot,0,0,0,0,1,0,0,1
hand leaves,1,0,0,0,0,0,0,1
hand u.n,1,0,0,0,0,0,0,1
hand wringing,0,0,0,1,0,0,0,1
handed boxes,1,0,0,0,0,0,0,1
handed terimaine,0,1,0,0,0,0,0,1
handheld thermometer,0,0,0,1,0,0,0,1
handheld thermometers,0,0,0,1,0,0,0,1
handle bigger,0,0,0,1,0,0,0,1
handle increasing,0,0,0,1,0,0,0,1
handling rain,0,0,0,0,1,0,0,1
hanif imam,1,0,0,0,0,0,0,1
hanifa lund,1,0,0,0,0,0,0,1
hanley coordinator,0,0,0,0,0,1,0,1
hannah kaplan,0,0,0,0,0,0,1,1
hannibal hanschke,0,0,1,0,0,0,0,1
hanschke getty,0,0,1,0,0,0,0,1
haoua gawlou,0,0,1,0,0,0,0,1
haoua's food,0,0,1,0,0,0,0,1
happen cox,0,0,0,0,1,0,0,1
happen earlier,0,0,0,0,0,1,0,1
happen hill,0,1,0,0,0,0,0,1
happen intermittently,0,0,0,1,0,0,0,1
happen mary,0,1,0,0,0,0,0,1
happen people,0,0,0,0,1,0,0,1
happened pretty,0,0,1,0,0,0,0,1
happened researchers,0,0,0,1,0,0,0,1
happened tuesday,0,0,0,0,0,1,0,1
happening earlier,1,0,0,0,0,0,0,1
happening faster,0,1,0,0,0,0,0,1
happening gradually,0,0,1,0,0,0,0,1
happening noaa,0,0,0,0,1,0,0,1
happening noaa's,0,1,0,0,0,0,0,1
happening underneath,0,0,0,0,1,0,0,1
happening yeah,0,0,0,0,0,1,0,1
happens.i'm standing,1,0,0,0,0,0,0,1
happy locke,0,1,0,0,0,0,0,1
happy ukraine's,0,0,0,1,0,0,0,1
haram attacks,0,0,1,0,0,0,0,1
haram carries,0,0,1,0,0,0,0,1
haram destroyed,0,0,1,0,0,0,0,1
harbeck nasa,0,1,0,0,0,0,0,1
harbor dredging,0,1,0,0,0,0,0,1
hard beginning,0,0,0,1,0,0,0,1
hard causing,0,0,0,0,0,1,0,1
hard decisions,1,0,0,0,0,0,0,1
hard life,0,0,0,0,0,1,0,1
hard negotiations,0,0,1,0,0,0,0,1
hard power,1,0,0,0,0,0,0,1
hard pressed,0,0,0,0,1,0,0,1
hard reality,0,0,0,1,0,0,0,1
hard surface,0,0,0,1,0,0,0,1
hardcore ice,0,0,0,0,1,0,0,1
hardened soil,0,0,0,1,0,0,0,1
harder leading,1,0,0,0,0,0,0,1
harder peter,0,1,0,0,0,0,0,1
harder predicting,0,0,0,0,0,1,0,1
hardest predate,1,0,0,0,0,0,0,1
hardest punches,0,0,0,0,0,1,0,1
hardin county,0,0,0,0,1,0,0,1
hardline conservative,0,0,1,0,0,0,0,1
hardwood bark,1,0,0,0,0,0,0,1
hardworking honest,0,0,0,0,1,0,0,1
hardy ky,1,0,0,0,0,0,0,1
hardy storm,1,0,0,0,0,0,0,1
harford host,0,0,0,0,0,1,0,1
harm bee,0,0,0,1,0,0,0,1
harm biodiversity,0,0,0,0,0,1,0,1
harm caused,0,1,0,0,0,0,0,1
harm communities,0,0,0,0,1,0,0,1
harm property,0,0,0,0,1,0,0,1
harmed communities,0,0,0,1,0,0,0,1
harmful air,0,0,0,1,0,0,0,1
harmful effects,0,0,0,1,0,0,0,1
harmful gas,0,0,1,0,0,0,0,1
harmful pollution,0,0,0,0,1,0,0,1
harms al,0,0,0,1,0,0,0,1
harness fiction,0,0,0,0,0,0,1,1
harold brooks,0,0,0,0,0,1,0,1
harold wimmer,0,1,0,0,0,0,0,1
harris county,0,0,0,1,0,0,0,1
harris seminole,0,1,0,0,0,0,0,1
harsh droughts,0,0,0,1,0,0,0,1
harsh grip,0,1,0,0,0,0,0,1
harsh plants,0,0,0,0,0,1,0,1
harsh words,0,0,0,0,1,0,0,1
hart hit,0,0,0,1,0,0,0,1
harvard historian,0,0,0,0,1,0,0,1
harvard university,0,0,0,1,0,0,0,1
harvest crops,1,0,0,0,0,0,0,1
harvest houston,0,0,0,0,0,0,1,1
harvest timber,0,0,0,0,0,1,0,1
harvesting pressure,0,0,0,0,0,0,1,1
harvesting rainwater,0,0,0,0,0,1,0,1
harvesting systems,0,0,0,0,0,1,0,1
harvesting vegetables,0,1,0,0,0,0,0,1
harvey hurricane,0,1,0,0,0,0,0,1
harvey irma,0,0,0,0,1,0,0,1
hashtag exxonknew,0,0,0,1,0,0,0,1
hat lin,0,1,0,0,0,0,0,1
hatcher washington's,1,0,0,0,0,0,0,1
hate relationship,0,0,0,1,0,0,0,1
haul water,0,0,0,0,0,1,0,1
hauling bulging,1,0,0,0,0,0,0,1
hauling company,0,0,0,0,1,0,0,1
hawaii corals,0,1,0,0,0,0,0,1
hawaii institute,0,1,0,0,0,0,0,1
hawaiian remained,0,0,0,1,0,0,0,1
hawk multiple,1,0,0,0,0,0,0,1
hayward california,0,0,1,0,0,0,0,1
haywire politicians,1,0,0,0,0,0,0,1
haywood told,0,1,0,0,0,0,0,1
haywood's tattoo,0,1,0,0,0,0,0,1
hazard assessments,1,0,0,0,0,0,0,1
hazard mitigation,1,0,0,0,0,0,0,1
hazardous event,0,1,0,0,0,0,0,1
hazardous waste,0,0,0,0,1,0,0,1
hazards extending,0,1,0,0,0,0,0,1
hazards vulnerability,0,1,0,0,0,0,0,1
hazy skies,1,0,0,0,0,0,0,1
head downriver,0,1,0,0,0,0,0,1
head home,1,0,0,0,0,0,0,1
headline read,0,0,1,0,0,0,0,1
headlines bp,0,0,0,0,1,0,0,1
headlines coming,0,1,0,0,0,0,0,1
headlines devoted,0,0,0,0,0,0,1,1
headlines recently,0,0,0,0,0,1,0,1
headwaters economics,1,0,0,0,0,0,0,1
headwaters podcast,0,0,0,0,0,1,0,1
headwinds facing,0,1,0,0,0,0,0,1
health benefits,0,1,0,0,0,0,0,1
health breakthroughs,0,0,0,1,0,0,0,1
health challenges,0,0,0,0,0,0,1,1
health consequences,0,0,0,1,0,0,0,1
health consortium,0,0,1,0,0,0,0,1
health counseling,0,0,0,1,0,0,0,1
health crisis,1,0,0,0,0,0,0,1
health dfc,0,1,0,0,0,0,0,1
health economic,0,1,0,0,0,0,0,1
health emergencies,0,0,0,0,0,1,0,1
health food,0,0,1,0,0,0,0,1
health issues,0,0,1,0,0,0,0,1
health ministry,1,0,0,0,0,0,0,1
health officer,0,0,0,0,0,1,0,1
health officials,0,0,0,0,0,1,0,1
health outcomes,0,0,1,0,0,0,0,1
health perspective,0,1,0,0,0,0,0,1
health policy,0,0,0,0,0,1,0,1
health professionals,0,0,0,0,0,1,0,1
health programs,0,1,0,0,0,0,0,1
health protective,0,0,0,1,0,0,0,1
health related,0,1,0,0,0,0,0,1
health science,0,1,0,0,0,0,0,1
health services,1,0,0,0,0,0,0,1
health specialist,0,0,1,0,0,0,0,1
health studies,0,0,0,1,0,0,0,1
health systems,0,1,0,0,0,0,0,1
health trees,0,0,1,0,0,0,0,1
health worker,0,0,0,0,0,1,0,1
healthier version,0,1,0,0,0,0,0,1
healthy colony,0,0,0,1,0,0,0,1
healthy fats,0,1,0,0,0,0,0,1
healthy intact,0,0,1,0,0,0,0,1
healthy mike,0,0,1,0,0,0,0,1
healthy populations,0,0,1,0,0,0,0,1
healthy respect,0,0,1,0,0,0,0,1
healthy saline,0,0,0,0,1,0,0,1
hear agencies,0,0,0,0,1,0,0,1
hear glass,0,1,0,0,0,0,0,1
hear trent,1,0,0,0,0,0,0,1
hear y'all,0,0,0,1,0,0,0,1
heard arguments,0,0,0,0,0,1,0,1
heard countries,0,0,0,1,0,0,0,1
heard inside,0,1,0,0,0,0,0,1
heard liesbeth,0,0,0,0,1,0,0,1
heard people,0,1,0,0,0,0,0,1
heard rumors,0,1,0,0,0,0,0,1
hearing reports,0,0,0,0,0,1,0,1
hearing ripped,0,0,0,0,1,0,0,1
hearings spotsylvania,0,0,0,0,1,0,0,1
hearings starting,0,0,0,0,1,0,0,1
heart attack,0,1,0,0,0,0,0,1
heart cells,0,1,0,0,0,0,0,1
heart fell,0,1,0,0,0,0,0,1
heart healthy,0,1,0,0,0,0,0,1
heart monitor,1,0,0,0,0,0,0,1
heartbeats maine,1,0,0,0,0,0,0,1
heartland clay,0,1,0,0,0,0,0,1
hearts broken,0,1,0,0,0,0,0,1
heat absorbing,0,0,0,1,0,0,0,1
heat events,0,0,0,1,0,0,0,1
heat exposure,0,1,0,0,0,0,0,1
heat extremes,0,0,0,0,0,1,0,1
heat flooding,0,1,0,0,0,0,0,1
heat islands,0,0,0,1,0,0,0,1
heat maps,0,0,0,1,0,0,0,1
heat president,1,0,0,0,0,0,0,1
heat related,0,0,1,0,0,0,0,1
heat released,1,0,0,0,0,0,0,1
heat stress,0,1,0,0,0,0,0,1
heat thaws,0,1,0,0,0,0,0,1
heat thirty,1,0,0,0,0,0,0,1
heat trapped,0,0,0,1,0,0,0,1
heat vulnerability,0,0,0,1,0,0,0,1
heated debate,0,0,0,0,1,0,0,1
heaters emitted,0,0,0,0,1,0,0,1
heaters sales,0,0,0,0,1,0,0,1
heaters studies,0,0,0,0,1,0,0,1
heather tanana,0,0,0,0,0,1,0,1
heating carbon,0,0,0,0,1,0,0,1
heating company,0,0,0,0,0,0,1,1
heating cooling,0,1,0,0,0,0,0,1
heating electricity,1,0,0,0,0,0,0,1
heating emissions,0,0,0,1,0,0,0,1
heating equipment,0,0,0,0,0,0,1,1
heating fuel,0,0,0,1,0,0,0,1
heating gas,0,0,0,0,0,0,1,1
heating hot,1,0,0,0,0,0,0,1
heating medium,1,0,0,0,0,0,0,1
heating system,0,1,0,0,0,0,0,1
heating technicians,0,0,0,0,0,1,0,1
heavier airplane,0,0,0,0,1,0,0,1
heaviest rainfall,0,1,0,0,0,0,0,1
heaviest snow,0,0,0,0,1,0,0,1
heaviest snowfall,0,0,0,0,1,0,0,1
heavily buddhist,0,1,0,0,0,0,0,1
heavily vetted,0,1,0,0,0,0,0,1
heavy amounts,0,1,0,0,0,0,0,1
heavy damage,0,1,0,0,0,0,0,1
heavy debt,1,0,0,0,0,0,0,1
heavy frost,0,0,0,0,1,0,0,1
heavy handed,0,0,0,0,0,0,1,1
heavy industries,0,0,0,1,0,0,0,1
heavy metal,0,0,0,0,0,0,1,1
heavy mountain,0,0,0,1,0,0,0,1
heavy rainstorms,0,0,0,1,0,0,0,1
heavy surf,0,1,0,0,0,0,0,1
heavy tanks,0,0,0,1,0,0,0,1
heavy thunderstorms,1,0,0,0,0,0,0,1
heavy trucks,0,0,0,0,0,1,0,1
hedges lives,0,0,1,0,0,0,0,1
hedges recorded,0,0,1,0,0,0,0,1
heeding warnings,0,0,0,1,0,0,0,1
hefty price,0,0,0,1,0,0,0,1
heightened risks,1,0,0,0,0,0,0,1
heightening fears,0,1,0,0,0,0,0,1
held houses,1,0,0,0,0,0,0,1
held indefinitely,0,0,0,0,1,0,0,1
held leases,0,0,0,0,0,1,0,1
held responsible,1,0,0,0,0,0,0,1
helen barrington,0,0,0,1,0,0,0,1
helene muller,0,0,1,0,0,0,0,1
helicopter's load,0,0,0,0,0,1,0,1
helicopters wait,0,0,0,0,0,1,0,1
helped bring,0,0,0,0,0,0,1,1
helped clarify,1,0,0,0,0,0,0,1
helped connect,0,0,1,0,0,0,0,1
helped create,1,0,0,0,0,0,0,1
helped delay,0,0,0,1,0,0,0,1
helped ease,0,0,0,0,1,0,0,1
helped energize,0,0,0,0,0,1,0,1
helped fund,0,1,0,0,0,0,0,1
helped institutionalize,0,1,0,0,0,0,0,1
helped lead,1,0,0,0,0,0,0,1
helped local,0,0,0,0,1,0,0,1
helped organize,0,0,0,0,0,1,0,1
helped people,0,0,0,0,1,0,0,1
helped remake,0,0,0,0,1,0,0,1
helped roll,0,1,0,0,0,0,0,1
helped shape,0,1,0,0,0,0,0,1
helped stall,0,0,0,0,1,0,0,1
helped start,0,0,0,0,0,0,1,1
helpful moving,0,0,0,0,0,1,0,1
helping bolster,0,0,0,0,0,1,0,1
helping brexit,0,0,0,0,0,1,0,1
helping folks,0,1,0,0,0,0,0,1
helping funnel,0,0,0,1,0,0,0,1
helping house,0,1,0,0,0,0,0,1
helping implement,1,0,0,0,0,0,0,1
helping local,0,1,0,0,0,0,0,1
helping low,0,1,0,0,0,0,0,1
helping musicians,0,1,0,0,0,0,0,1
helping nasa,0,0,0,1,0,0,0,1
helping pay,0,0,0,1,0,0,0,1
helping poorer,0,1,0,0,0,0,0,1
helping search,1,0,0,0,0,0,0,1
helping stop,0,1,0,0,0,0,0,1
helping tiny,1,0,0,0,0,0,0,1
helping women,0,1,0,0,0,0,0,1
helps advance,0,0,0,1,0,0,0,1
helps chip,0,0,0,0,0,0,1,1
helps create,0,0,0,0,0,0,1,1
helps drive,0,0,0,1,0,0,0,1
helps pay,0,1,0,0,0,0,0,1
hemorrhagic fever,0,0,0,0,0,1,0,1
herald executive,0,0,1,0,0,0,0,1
herb farm,0,0,0,0,0,1,0,1
heritage committee,0,1,0,0,0,0,0,1
heritage list,0,1,0,0,0,0,0,1
heritage site,0,1,0,0,0,0,0,1
heroic cleft,0,0,1,0,0,0,0,1
herrera swiss,0,0,0,1,0,0,0,1
hersher contributed,0,0,1,0,0,0,0,1
hersher explains,0,0,0,1,0,0,0,1
herz contributed,0,0,0,0,1,0,0,1
herzer risi,0,0,0,0,0,1,0,1
hey ari,0,1,0,0,0,0,0,1
hey camila,0,0,0,0,1,0,0,1
hey eleanor,0,1,0,0,0,0,0,1
hey eric,0,0,0,1,0,0,0,1
hey jeff,0,0,0,1,0,0,0,1
hey juana,0,0,0,1,0,0,0,1
hey kirk,0,0,0,0,1,0,0,1
hey lauren,0,1,0,0,0,0,0,1
hey mary,0,0,1,0,0,0,0,1
hey nate,0,0,1,0,0,0,0,1
hey ruth,0,1,0,0,0,0,0,1
hey stay,0,0,0,1,0,0,0,1
hidden fossil,0,1,0,0,0,0,0,1
hidden majesty,0,0,1,0,0,0,0,1
hidden ulterior,0,0,1,0,0,0,0,1
highlander suv,0,0,0,0,1,0,0,1
highly ambitious,0,1,0,0,0,0,0,1
highly anomalous,0,0,0,0,1,0,0,1
highly anticipated,0,1,0,0,0,0,0,1
highly contentious,0,1,0,0,0,0,0,1
highly protected,0,1,0,0,0,0,0,1
highly trafficked,0,0,1,0,0,0,0,1
highly vulnerable,0,0,0,0,0,1,0,1
highs agency,1,0,0,0,0,0,0,1
highway abruptly,1,0,0,0,0,0,0,1
highway closure,1,0,0,0,0,0,0,1
highway cutting,0,0,0,0,0,0,1,1
highway patrol,0,1,0,0,0,0,0,1
highway police,0,0,0,1,0,0,0,1
highway railing,1,0,0,0,0,0,0,1
highway remained,0,0,0,0,1,0,0,1
highway visible,1,0,0,0,0,0,0,1
hijinks including,0,0,1,0,0,0,0,1
hikari's apricity,0,0,0,1,0,0,0,1
hike.martí yesterday,0,0,0,0,0,1,0,1
hill added,0,0,0,0,0,1,0,1
hill's job,0,1,0,0,0,0,0,1
hills close,0,0,1,0,0,0,0,1
hills reconnecting,0,0,1,0,0,0,0,1
hills santa,0,0,1,0,0,0,0,1
hills section,0,0,0,0,1,0,0,1
hillsides flood,0,0,0,1,0,0,0,1
himalayan foothills,0,0,0,0,0,1,0,1
himalayan town,0,1,0,0,0,0,0,1
hindered transportation,1,0,0,0,0,0,0,1
hindman's appalachian,0,1,0,0,0,0,0,1
hints psychologists,0,0,0,1,0,0,0,1
hip hop,0,1,0,0,0,0,0,1
hire locals,1,0,0,0,0,0,0,1
hiring chefs,0,0,0,1,0,0,0,1
hirsch hey,0,0,0,1,0,0,0,1
historian steve,0,0,1,0,0,0,0,1
historians economists,0,0,0,0,1,0,0,1
historic contribution,0,1,0,0,0,0,0,1
historic crisis,0,1,0,0,0,0,0,1
historic deal,0,0,1,0,0,0,0,1
historic die,0,0,1,0,0,0,0,1
historic disaster,0,0,0,1,0,0,0,1
historic drought,1,0,0,0,0,0,0,1
historic emitters,0,1,0,0,0,0,0,1
historic flooding,1,0,0,0,0,0,0,1
historic footprint,0,0,0,0,1,0,0,1
historic habitat,0,0,1,0,0,0,0,1
historic heat,0,1,0,0,0,0,0,1
historic inequity,0,0,0,1,0,0,0,1
historic instruments,0,1,0,0,0,0,0,1
historic lows,0,0,0,1,0,0,0,1
historic missteps,0,1,0,0,0,0,0,1
historic polluter,0,1,0,0,0,0,0,1
historic records,0,1,0,0,0,0,0,1
historic snowfall,0,0,0,0,1,0,0,1
historic snowpack,0,0,0,0,0,1,0,1
historic storm,0,0,0,0,1,0,0,1
historical averages,0,0,0,1,0,0,0,1
historical park,1,0,0,0,0,0,0,1
historical standards,0,0,0,0,0,1,0,1
historically black,1,0,0,0,0,0,0,1
historically contributed,0,0,0,0,0,1,0,1
historically dry,0,0,0,1,0,0,0,1
historically happened,0,0,1,0,0,0,0,1
historically thrived,0,0,0,0,0,1,0,1
history biden's,0,0,0,0,0,1,0,1
history humanity,0,0,0,1,0,0,0,1
history hundreds,0,1,0,0,0,0,0,1
history lm,0,0,0,0,1,0,0,1
history lying,1,0,0,0,0,0,0,1
history science,0,1,0,0,0,0,0,1
history sean,0,0,0,0,0,0,1,1
history texas,0,0,0,0,1,0,0,1
history tore,0,0,0,1,0,0,0,1
hit alaska,0,0,1,0,0,0,0,1
hit climate,0,0,1,0,0,0,0,1
hit davis,0,1,0,0,0,0,0,1
hit earlier,0,0,0,0,0,1,0,1
hit florida's,0,1,0,0,0,0,0,1
hit friday,0,0,0,0,0,0,1,1
hit home,0,0,0,0,0,1,0,1
hit huddled,0,0,0,0,0,0,1,1
hit hundreds,0,0,0,1,0,0,0,1
hit kusiong,1,0,0,0,0,0,0,1
hit los,0,0,0,0,0,1,0,1
hit maguindanao,1,0,0,0,0,0,0,1
hit merced,0,0,0,1,0,0,0,1
hit minus,0,0,0,0,1,0,0,1
hit montecito,0,0,0,1,0,0,0,1
hit nicaragua's,1,0,0,0,0,0,0,1
hit pakistan,0,1,0,0,0,0,0,1
hit record,1,0,0,0,0,0,0,1
hit roadblocks.for,0,0,0,0,1,0,0,1
hit texas,1,0,0,0,0,0,0,1
hit town,0,1,0,0,0,0,0,1
hit western,0,0,1,0,0,0,0,1
hits homes,0,0,0,1,0,0,0,1
hitting land,0,1,0,0,0,0,0,1
hive recently,0,0,0,0,0,1,0,1
hobbs groundwater,0,0,0,0,1,0,0,1
hobbs replied,0,0,0,0,1,0,0,1
hoboken n.j,0,0,0,1,0,0,0,1
hockey maple,0,0,0,0,0,1,0,1
hoesung lee,0,0,0,0,0,1,0,1
hokkaido university,0,0,0,0,0,1,0,1
hold annual,0,1,0,0,0,0,0,1
hold bigger,0,1,0,0,0,0,0,1
hold committee,0,0,0,0,1,0,0,1
hold drills,1,0,0,0,0,0,0,1
hold ground,0,0,0,1,0,0,0,1
hold ken,0,0,0,0,0,1,0,1
hold operators,1,0,0,0,0,0,0,1
hold politicians,0,1,0,0,0,0,0,1
holding basins,0,1,0,0,0,0,0,1
holding global,0,0,0,1,0,0,0,1
holding pattern,0,1,0,0,0,0,0,1
holding people,0,1,0,0,0,0,0,1
holds events,0,0,0,1,0,0,0,1
holds steadfast,0,0,0,0,1,0,0,1
holiday weekend,0,0,0,1,0,0,0,1
holidays ruined,0,0,1,0,0,0,0,1
hollywood boulevard,0,0,1,0,0,0,0,1
hollywood icon's,0,0,1,0,0,0,0,1
hollywood movie,0,1,0,0,0,0,0,1
hollywood production,0,0,1,0,0,0,0,1
hollywood ventura,0,0,1,0,0,0,0,1
home begum,0,0,0,0,0,1,0,1
home biedul,0,0,0,0,1,0,0,1
home change,0,0,1,0,0,0,0,1
home collapsed,0,1,0,0,0,0,0,1
home countries,0,1,0,0,0,0,0,1
home creating,0,1,0,0,0,0,0,1
home due,0,0,0,0,0,0,1,1
home eli,0,1,0,0,0,0,0,1
home evs,0,1,0,0,0,0,0,1
home fits,0,1,0,0,0,0,0,1
home leads,0,0,0,1,0,0,0,1
home lies,0,0,0,0,1,0,0,1
home master,0,0,0,0,1,0,0,1
home measures,0,0,0,0,0,1,0,1
home nabity,0,0,0,0,1,0,0,1
home ozone,0,0,0,0,1,0,0,1
home pretty,0,0,0,0,0,1,0,1
home range,0,0,1,0,0,0,0,1
home run,0,0,0,0,0,1,0,1
home sits,0,0,0,0,0,1,0,1
home turf,0,0,1,0,0,0,0,1
home wading,0,0,0,0,0,1,0,1
home yeah,0,0,0,1,0,0,0,1
home's hallways,0,1,0,0,0,0,0,1
homeless residents,1,0,0,0,0,0,0,1
homeless services,0,0,0,0,1,0,0,1
homelessness crisis,1,0,0,0,0,0,0,1
homeowner raking,0,0,1,0,0,0,0,1
homes appliance,0,0,0,1,0,0,0,1
homes buyout,1,0,0,0,0,0,0,1
homes coming,0,0,0,0,1,0,0,1
homes converted,0,0,0,1,0,0,0,1
homes families,0,1,0,0,0,0,0,1
homes floated,1,0,0,0,0,0,0,1
homes forced,0,1,0,0,0,0,0,1
homes hunting,0,0,1,0,0,0,0,1
homes including,0,0,0,0,1,0,0,1
homes washed,0,1,0,0,0,0,0,1
hometown produces,0,0,0,0,1,0,0,1
hometowns nearby,0,1,0,0,0,0,0,1
honda stellantis,0,0,0,0,0,1,0,1
honestly wondering,0,0,0,1,0,0,0,1
honeybee vaccine,0,0,0,1,0,0,0,1
honeybees climate,0,0,0,1,0,0,0,1
honeybees communicate,0,0,0,0,0,1,0,1
honeybees live,0,0,0,1,0,0,0,1
honeybees play,0,0,0,1,0,0,0,1
hood people,0,0,0,1,0,0,0,1
hook ups,0,0,0,0,0,1,0,1
hooley ap,0,0,0,0,0,0,1,1
hoover dam,1,0,0,0,0,0,0,1
hop scenes,0,1,0,0,0,0,0,1
hope al,0,0,0,1,0,0,0,1
hope gore,0,1,0,0,0,0,0,1
hope ruto,1,0,0,0,0,0,0,1
hope sitting,0,1,0,0,0,0,0,1
hope unsuccessfully,0,0,1,0,0,0,0,1
hopeful indication,0,0,1,0,0,0,0,1
hopeful story,0,1,0,0,0,0,0,1
hopeless naselroad,0,1,0,0,0,0,0,1
hopeless project,0,1,0,0,0,0,0,1
hopes.ricci shryock,0,0,0,1,0,0,0,1
hoping housed,0,0,0,0,1,0,0,1
hoping people,0,0,0,0,0,1,0,1
hopke associate,0,0,0,1,0,0,0,1
hopkins counties,0,1,0,0,0,0,0,1
hornewer owns,0,0,0,0,1,0,0,1
horrendous cost,0,1,0,0,0,0,0,1
horseshoe island,0,1,0,0,0,0,0,1
hose blasting,0,0,0,1,0,0,0,1
hospital bed,0,0,0,1,0,0,0,1
hospital data,0,0,0,0,0,1,0,1
hospital facility,0,1,0,0,0,0,0,1
hospitalized sunday,0,0,0,1,0,0,0,1
hospitals fire,0,0,0,1,0,0,0,1
hospitals texas,1,0,0,0,0,0,0,1
host aaron,0,0,0,0,0,1,0,1
host aldo,0,0,0,0,0,1,0,1
host animal,0,0,0,0,0,1,0,1
host animals,0,0,0,0,0,1,0,1
host emily,0,0,0,1,0,0,0,1
host mary,0,0,0,0,1,0,0,1
host npr's,0,1,0,0,0,0,0,1
host sean,0,0,0,1,0,0,0,1
host tucker,0,0,0,0,0,1,0,1
hostile elements,0,0,0,0,0,0,1,1
hosts emily,0,0,0,0,0,1,0,1
hosts typically,0,0,0,1,0,0,0,1
hot asphalt,0,0,0,1,0,0,0,1
hot celebrity,0,0,0,0,0,1,0,1
hot chocolate,0,0,0,0,1,0,0,1
hot fried,0,0,0,0,1,0,0,1
hot patch,1,0,0,0,0,0,0,1
hot playgrounds,0,0,0,1,0,0,0,1
hot spot,0,0,0,1,0,0,0,1
hot spots,0,0,0,1,0,0,0,1
hot takes,0,0,0,1,0,0,0,1
hot temperatures,0,0,0,1,0,0,0,1
hot wind,1,0,0,0,0,0,0,1
hotel adding,0,1,0,0,0,0,0,1
hotel chains,0,1,0,0,0,0,0,1
hotline food,0,0,0,0,0,1,0,1
hotter atmosphere,0,0,0,1,0,0,0,1
hotter california's,0,0,0,0,0,1,0,1
hotter conditions,1,0,0,0,0,0,0,1
hotter days,0,0,1,0,0,0,0,1
hotter future,0,0,1,0,0,0,0,1
hotter louisville,0,0,0,1,0,0,0,1
hotter world,0,1,0,0,0,0,0,1
hottest temperatures,0,0,0,1,0,0,0,1
hour berlin,0,0,1,0,0,0,0,1
hour dicaro,0,0,0,0,0,1,0,1
hour esme,0,0,1,0,0,0,0,1
hour makeup,1,0,0,0,0,0,0,1
hour range,0,0,0,0,1,0,0,1
hour session,0,1,0,0,0,0,0,1
hour shift,0,0,0,1,0,0,0,1
hour winds,0,1,0,0,0,0,0,1
hourglass shaped,0,1,0,0,0,0,0,1
hourly data,0,0,0,0,0,1,0,1
hours davis,0,0,0,1,0,0,0,1
hours drive,0,0,1,0,0,0,0,1
hours notice,0,1,0,0,0,0,0,1
hours supercells,0,0,0,0,0,1,0,1
house aides,0,0,0,1,0,0,0,1
house announced,1,0,0,0,0,0,0,1
house arguing,0,0,0,0,0,1,0,1
house caught,0,0,0,0,0,0,1,1
house chef,0,1,0,0,0,0,0,1
house climate,0,0,0,0,0,1,0,1
house committee,0,0,0,0,0,0,1,1
house correspondent,1,0,0,0,0,0,0,1
house displaced,0,1,0,0,0,0,0,1
house elise,0,0,0,0,0,1,0,1
house energy,0,0,0,0,0,0,1,1
house facing,0,1,0,0,0,0,0,1
house flooded,0,0,0,0,0,1,0,1
house fred,0,1,0,0,0,0,0,1
house gop,1,0,0,0,0,0,0,1
house heavily,0,0,0,0,0,0,1,1
house hide,0,1,0,0,0,0,0,1
house lawyer,0,0,0,1,0,0,0,1
house located,1,0,0,0,0,0,0,1
house lots,0,0,0,0,1,0,0,1
house michael,0,1,0,0,0,0,0,1
house official,0,0,0,0,0,1,0,1
house ralston,0,0,0,0,1,0,0,1
house research,0,0,0,1,0,0,0,1
house signing,0,0,0,0,0,1,0,1
house supporters,0,0,0,0,0,1,0,1
house takes,1,0,0,0,0,0,0,1
house warm,0,0,0,0,1,0,0,1
house washed,0,0,0,0,0,1,0,1
house yeah,0,1,0,0,0,0,0,1
house's proposal,0,1,0,0,0,0,0,1
house's raj,0,0,0,0,1,0,0,1
housed neighbors,0,0,0,0,1,0,0,1
household fuel,0,0,0,0,1,0,0,1
household gas,0,0,0,1,0,0,0,1
household poverty,0,0,0,0,1,0,0,1
household's coal,0,0,0,0,1,0,0,1
households applied,1,0,0,0,0,0,0,1
households depend,0,0,1,0,0,0,0,1
houser found,0,0,0,0,1,0,0,1
houser's family,0,0,0,0,1,0,0,1
houser's land,0,0,0,0,1,0,0,1
houser's project,0,0,0,0,1,0,0,1
houser's ranching,0,0,0,0,1,0,0,1
houses atop,0,0,0,0,0,1,0,1
houses built,0,1,0,0,0,0,0,1
houses digging,0,1,0,0,0,0,0,1
houses modern,1,0,0,0,0,0,0,1
houses stretch,0,0,0,1,0,0,0,1
houses thousands,0,0,0,1,0,0,0,1
housing boom,0,0,0,0,1,0,0,1
housing market,0,0,0,0,0,1,0,1
housing units,0,0,0,0,1,0,0,1
houston democrat,0,0,0,0,1,0,0,1
houston public,0,0,0,0,0,0,1,1
huascarán national,0,1,0,0,0,0,0,1
huckabee sanders,0,0,0,0,0,0,1,1
hueso evacuated,0,0,0,0,0,0,1,1
huge advantage,0,1,0,0,0,0,0,1
huge backlog,0,1,0,0,0,0,0,1
huge camp,0,1,0,0,0,0,0,1
huge chunk,0,0,0,0,1,0,0,1
huge climate,0,1,0,0,0,0,0,1
huge cookout.oh,1,0,0,0,0,0,0,1
huge crater,0,1,0,0,0,0,0,1
huge crop,1,0,0,0,0,0,0,1
huge crowd,0,1,0,0,0,0,0,1
huge damaged,0,1,0,0,0,0,0,1
huge demand,0,1,0,0,0,0,0,1
huge effort,1,0,0,0,0,0,0,1
huge fund,0,1,0,0,0,0,0,1
huge gap,0,0,0,0,0,1,0,1
huge hit,0,0,0,0,0,0,1,1
huge influx,0,0,0,1,0,0,0,1
huge national,1,0,0,0,0,0,0,1
huge nickel,0,0,0,0,1,0,0,1
huge parking,0,1,0,0,0,0,0,1
huge population,0,0,0,0,1,0,0,1
huge power,0,0,1,0,0,0,0,1
huge profits,0,0,0,0,1,0,0,1
huge range,0,0,0,0,0,0,1,1
huge role,0,1,0,0,0,0,0,1
huge share,0,0,1,0,0,0,0,1
huge spending,0,0,0,1,0,0,0,1
huge spike,0,1,0,0,0,0,0,1
huge steps,0,1,0,0,0,0,0,1
huge storms,0,0,0,1,0,0,0,1
huge volumes,0,0,0,0,0,1,0,1
huge wildfire,1,0,0,0,0,0,0,1
huge willow,0,0,0,0,0,1,0,1
huge workforce,0,1,0,0,0,0,0,1
huge youth,0,1,0,0,0,0,0,1
hughes library,0,1,0,0,0,0,0,1
huh kyle,0,0,1,0,0,0,0,1
human anti,0,0,0,0,0,1,0,1
human brain,0,0,0,0,1,0,0,1
human chains,1,0,0,0,0,0,0,1
human consumption,0,0,0,0,0,1,0,1
human cost,0,0,0,0,1,0,0,1
human costs,0,0,0,0,1,0,0,1
human disturbances,0,0,0,0,1,0,0,1
human driven,0,0,0,1,0,0,0,1
human emissions,0,1,0,0,0,0,0,1
human experience,0,0,1,0,0,0,0,1
human heart,0,1,0,0,0,0,0,1
human impacts,0,0,0,0,1,0,0,1
human melodrama,0,0,1,0,0,0,0,1
human mind,0,0,0,1,0,0,0,1
human mortality,0,0,0,0,0,1,0,1
human place.so,1,0,0,0,0,0,0,1
human populations,0,0,0,0,0,1,0,1
human potential,0,1,0,0,0,0,0,1
human relationship,0,0,0,1,0,0,0,1
human residents,0,0,1,0,0,0,0,1
human safety,0,0,1,0,0,0,0,1
human services,0,0,0,0,1,0,0,1
human suffering,0,0,0,0,0,0,1,1
human survival,0,1,0,0,0,0,0,1
humanitarian catastrophe,0,1,0,0,0,0,0,1
humanitarian grounds,0,0,0,0,1,0,0,1
humanitarian supplies,1,0,0,0,0,0,0,1
humanity ali,0,1,0,0,0,0,0,1
humanity finally,0,0,0,0,0,1,0,1
humanity global,0,1,0,0,0,0,0,1
humanity office,0,1,0,0,0,0,0,1
humanity's languages,0,0,0,1,0,0,0,1
humanity's senseless,0,0,1,0,0,0,0,1
humanity's struggle,1,0,0,0,0,0,0,1
humans begin,0,1,0,0,0,0,0,1
humans coexisting,0,0,0,1,0,0,0,1
humans cut,0,1,0,0,0,0,0,1
humans emit,0,1,0,0,0,0,0,1
humans flourishing,0,0,0,0,1,0,0,1
humans hope,0,1,0,0,0,0,0,1
humans marburg,0,0,0,0,0,1,0,1
humans plants,0,1,0,0,0,0,0,1
humans reduce,0,0,0,1,0,0,0,1
humans saddled,0,0,0,0,0,1,0,1
humans scientists,0,0,0,1,0,0,0,1
humans slow,0,1,0,0,0,0,0,1
humble gas,0,0,0,0,1,0,0,1
humidity amid,0,0,0,0,1,0,0,1
humming quietly,0,0,0,1,0,0,0,1
humphrey storm,0,0,0,0,1,0,0,1
hundred coal,0,0,0,0,1,0,0,1
hundred inches,0,0,0,0,0,1,0,1
hundred million,0,0,0,0,1,0,0,1
hundred people,0,0,0,1,0,0,0,1
hundred percent,0,1,0,0,0,0,0,1
hundred protests,0,0,0,0,0,1,0,1
hundred sixty,0,0,0,1,0,0,0,1
hundred thousand,1,0,0,0,0,0,0,1
hunger crisis,1,0,0,0,0,0,0,1
hunger strike,0,1,0,0,0,0,0,1
hungry freelance,0,0,0,0,0,1,0,1
hungry lawns,0,0,0,0,0,1,0,1
hunt perching,0,0,1,0,0,0,0,1
hunt prey,0,0,0,0,0,1,0,1
hunting camps,0,0,1,0,0,0,0,1
hunting dozens,0,0,0,0,0,1,0,1
hunting permits,1,0,0,0,0,0,0,1
huq director,0,0,0,0,0,1,0,1
huq explains,0,0,0,0,0,1,0,1
hurdles puerto,1,0,0,0,0,0,0,1
hurley arrived,0,1,0,0,0,0,0,1
hurricane caused,0,1,0,0,0,0,0,1
hurricane center's,0,1,0,0,0,0,0,1
hurricane damage,0,1,0,0,0,0,0,1
hurricane dorian,0,1,0,0,0,0,0,1
hurricane evacuations,1,0,0,0,0,0,0,1
hurricane formation,0,1,0,0,0,0,0,1
hurricane guerrero,0,0,0,1,0,0,0,1
hurricane harvey,0,1,0,0,0,0,0,1
hurricane hurricane,0,1,0,0,0,0,0,1
hurricane ida,1,0,0,0,0,0,0,1
hurricane isabel,0,1,0,0,0,0,0,1
hurricane kate,0,1,0,0,0,0,0,1
hurricane late,0,1,0,0,0,0,0,1
hurricane risk,0,0,0,0,1,0,0,1
hurricane winds,0,0,0,1,0,0,0,1
hurricane world,0,0,0,1,0,0,0,1
hurricanes conditions,0,0,0,0,0,0,1,1
hurricanes form,0,1,0,0,0,0,0,1
hurricanes harvey,0,0,0,0,1,0,0,1
hurricanes heat,0,1,0,0,0,0,0,1
hurricanes katrina,0,0,0,0,1,0,0,1
hurricanes worse,0,1,0,0,0,0,0,1
hurt existing,0,0,0,0,1,0,0,1
hurt kcal,0,0,0,0,1,0,0,1
hurt local,1,0,0,0,0,0,0,1
hurt people,0,0,1,0,0,0,0,1
hurting crops,0,0,1,0,0,0,0,1
hurting hit,0,0,0,1,0,0,0,1
hurts crops,0,1,0,0,0,0,0,1
husband helped,1,0,0,0,0,0,0,1
husband matthew,0,1,0,0,0,0,0,1
husein finally,0,1,0,0,0,0,0,1
hyacinth roots,0,0,0,0,0,1,0,1
hybrid burger,0,1,0,0,0,0,0,1
hybrid highlander,0,0,0,0,1,0,0,1
hybrid market,0,0,0,0,1,0,0,1
hybrid model,0,0,0,0,1,0,0,1
hybrid rav,0,0,0,0,1,0,0,1
hybrid suvs,0,0,0,0,1,0,0,1
hybrid toyota,0,0,0,0,1,0,0,1
hybrid vehicles,0,0,0,0,1,0,0,1
hybrid version,0,0,0,0,1,0,0,1
hybrids actual,0,0,0,0,1,0,0,1
hybrids hybrids,0,0,0,0,1,0,0,1
hybrids toyota's,0,0,0,0,1,0,0,1
hydroelectric dams,0,1,0,0,0,0,0,1
hydroelectric storage,0,1,0,0,0,0,0,1
hydrogen fuel,0,0,0,0,0,1,0,1
hydrogen poses,0,0,1,0,0,0,0,1
hydrogen project,0,1,0,0,0,0,0,1
hydrogen projects,0,0,1,0,0,0,0,1
hydrogen sulfide,0,0,0,0,0,1,0,1
hydrologic cycle,0,0,0,0,0,1,0,1
hydrological models,0,0,0,0,0,1,0,1
hydroponic gardening,0,1,0,0,0,0,0,1
hydroponic gardens,0,0,0,1,0,0,0,1
hydropower china's,0,0,0,0,0,1,0,1
hydropower generation,0,0,0,0,0,0,1,1
hydropower infrastructure,0,0,0,0,1,0,0,1
hyper partisan,0,0,0,1,0,0,0,1
hyperpartisan media,0,0,0,1,0,0,0,1
hypothermia skin,0,0,0,0,1,0,0,1
hypothetical regulators,0,0,0,0,1,0,0,1
ian brown,1,0,0,0,0,0,0,1
ian caused,0,1,0,0,0,0,0,1
ian dumped,0,1,0,0,0,0,0,1
ian flattened,1,0,0,0,0,0,0,1
ian hit,0,1,0,0,0,0,0,1
ian joughin,0,1,0,0,0,0,0,1
ian mcdonnell,0,0,1,0,0,0,0,1
ian quil,1,0,0,0,0,0,0,1
ian rebecca,0,0,0,1,0,0,0,1
ian roared,1,0,0,0,0,0,0,1
ian's confirmed,1,0,0,0,0,0,0,1
ian's flooding,0,1,0,0,0,0,0,1
ice added,0,0,0,0,1,0,0,1
ice ages,1,0,0,0,0,0,0,1
ice arts,0,1,0,0,0,0,0,1
ice bodies,0,1,0,0,0,0,0,1
ice caps,0,1,0,0,0,0,0,1
ice coastal,0,0,1,0,0,0,0,1
ice data,0,0,0,0,1,0,0,1
ice disappears,1,0,0,0,0,0,0,1
ice essential,0,0,1,0,0,0,0,1
ice fisherman,0,0,0,0,1,0,0,1
ice floating,0,1,0,0,0,0,0,1
ice floats,0,0,0,0,1,0,0,1
ice frozen,0,0,1,0,0,0,0,1
ice funding,0,0,0,1,0,0,0,1
ice levels,1,0,0,0,0,0,0,1
ice loss,1,0,0,0,0,0,0,1
ice melt,0,1,0,0,0,0,0,1
ice melted,1,0,0,0,0,0,0,1
ice melting,0,1,0,0,0,0,0,1
ice researcher,0,0,0,0,1,0,0,1
ice seals,0,0,0,0,0,1,0,1
ice shaped,0,1,0,0,0,0,0,1
ice sheet's,0,1,0,0,0,0,0,1
ice skating,0,0,0,0,1,0,0,1
ice surface,1,0,0,0,0,0,0,1
ice thicker,0,0,0,0,1,0,0,1
ice weighed,0,0,0,0,1,0,0,1
iceberg floats,0,1,0,0,0,0,0,1
icebergs float,0,1,0,0,0,0,0,1
icefin lowered,0,0,0,0,1,0,0,1
ick response,0,1,0,0,0,0,0,1
icon's legacy,0,0,1,0,0,0,0,1
iconic scene,1,0,0,0,0,0,0,1
iconic shot,0,0,1,0,0,0,0,1
iconic training,0,1,0,0,0,0,0,1
icy roads,0,0,0,0,1,0,0,1
icy tarmac,0,0,1,0,0,0,0,1
idabel morris,0,1,0,0,0,0,0,1
idaho cobalt,1,0,0,0,0,0,0,1
idaho mine,1,0,0,0,0,0,0,1
idea sort,1,0,0,0,0,0,0,1
idea tamma,0,0,0,0,1,0,0,1
idea yeah,1,0,0,0,0,0,0,1
ideal conditions,0,0,0,0,0,1,0,1
ideal vision,0,1,0,0,0,0,0,1
ideas floating,0,0,0,0,1,0,0,1
identified animal,1,0,0,0,0,0,0,1
identify hotspots,0,0,0,1,0,0,0,1
identify immortalized,0,1,0,0,0,0,0,1
identifying subsidies,0,0,1,0,0,0,0,1
identitarian suggested,0,0,0,0,0,1,0,1
identity alive.for,1,0,0,0,0,0,0,1
ifansasti getty,0,0,1,0,0,0,0,1
ignaszewski researches,0,0,1,0,0,0,0,1
ignited bright,0,0,0,0,1,0,0,1
ignoring data,0,0,0,0,1,0,0,1
ii public,0,1,0,0,0,0,0,1
ii yeah,0,0,0,1,0,0,0,1
iii wax,0,1,0,0,0,0,0,1
ill preliminary,0,0,1,0,0,0,0,1
illegal actions,0,0,0,0,0,0,1,1
illegal coal,0,0,0,0,1,0,0,1
illegal immigration,0,1,0,0,0,0,0,1
illegal logging,0,0,0,0,0,0,1,1
illegal road,0,0,0,0,0,0,1,1
illegal trade,0,0,1,0,0,0,0,1
illegitimately installed,0,0,0,0,1,0,0,1
illinois gov,0,0,0,0,0,0,1,1
illinois indiana,0,0,0,0,1,0,0,1
illinois stunning,0,0,0,0,0,0,1,1
ilulissat greenland,0,1,0,0,0,0,0,1
imadali hide,0,1,0,0,0,0,0,1
image adelie,0,1,0,0,0,0,0,1
image flood,0,1,0,0,0,0,0,1
image fractured,0,1,0,0,0,0,0,1
image icebergs,0,1,0,0,0,0,0,1
image maurice,0,1,0,0,0,0,0,1
image meltwater,0,1,0,0,0,0,0,1
image pete,0,1,0,0,0,0,0,1
image robert,0,1,0,0,0,0,0,1
image spyboy,0,1,0,0,0,0,0,1
image titled,0,0,0,0,0,1,0,1
image track,0,0,0,0,0,1,0,1
images lightrocket,0,1,0,0,0,0,0,1
images sopa,0,1,0,0,0,0,0,1
images universal,0,0,1,0,0,0,0,1
imaging techniques,1,0,0,0,0,0,0,1
iman maani,0,0,1,0,0,0,0,1
immediately halts,0,1,0,0,0,0,0,1
immediately replace,0,0,0,1,0,0,0,1
immediately return,0,1,0,0,0,0,0,1
immediately solve,0,0,0,0,0,1,0,1
immense damage,0,1,0,0,0,0,0,1
immense global,0,1,0,0,0,0,0,1
immersion schools,0,0,0,1,0,0,0,1
immigrant advocates,0,1,0,0,0,0,0,1
immigrant history,0,0,0,1,0,0,0,1
immigrant political,1,0,0,0,0,0,0,1
immigrant politicians,0,1,0,0,0,0,0,1
immigration advocates,0,0,1,0,0,0,0,1
immigration laws,0,1,0,0,0,0,0,1
immigration people,0,1,0,0,0,0,0,1
imminent water,0,0,0,0,0,1,0,1
immy mulekatete,0,0,0,0,1,0,0,1
impact analysis,0,0,0,0,0,1,0,1
impact climate,0,1,0,0,0,0,0,1
impact flows,0,0,0,0,1,0,0,1
impact historically,1,0,0,0,0,0,0,1
impact including,0,0,0,0,1,0,0,1
impact jobs,0,0,0,0,0,1,0,1
impact plants,0,0,1,0,0,0,0,1
impact research,0,0,0,1,0,0,0,1
impacted kids,0,1,0,0,0,0,0,1
impactful pop,0,0,0,0,0,0,1,1
impacting food,0,0,0,1,0,0,0,1
impacting quality,1,0,0,0,0,0,0,1
impacts afp,0,1,0,0,0,0,0,1
impacts exhausting,0,0,0,0,0,1,0,1
impacts industrialized,0,1,0,0,0,0,0,1
impacts white,0,1,0,0,0,0,0,1
impassable roadways,0,0,0,0,0,1,0,1
impatiently holds,1,0,0,0,0,0,0,1
impending disasters,0,1,0,0,0,0,0,1
impending hazardous,0,1,0,0,0,0,0,1
impending storm,0,1,0,0,0,0,0,1
implement disaster,0,1,0,0,0,0,0,1
implement policy,0,0,1,0,0,0,0,1
implement voluntary,0,0,0,0,1,0,0,1
implemented covid,0,1,0,0,0,0,0,1
implementing climate,0,1,0,0,0,0,0,1
implementing policies,0,1,0,0,0,0,0,1
implications permanently,0,1,0,0,0,0,0,1
importantly consumers,0,0,0,1,0,0,0,1
importantly inspiration,0,0,0,0,1,0,0,1
imported fossil,0,0,0,1,0,0,0,1
imported water,0,0,0,0,1,0,0,1
imposed mandates,0,0,0,0,0,1,0,1
impossible erika,0,1,0,0,0,0,0,1
impressionist painting,0,1,0,0,0,0,0,1
impressive feat,0,0,0,0,1,0,0,1
impressive record,0,0,0,1,0,0,0,1
impressively resilient,0,0,0,0,0,1,0,1
impromptu ferry,1,0,0,0,0,0,0,1
improve climate,0,1,0,0,0,0,0,1
improve food,0,0,0,0,0,1,0,1
improve forecasts,1,0,0,0,0,0,0,1
improve local,0,0,0,0,1,0,0,1
improve navigation,0,1,0,0,0,0,0,1
improve reliability,0,0,0,1,0,0,0,1
improve relief,0,0,0,0,0,0,1,1
improve soil,0,0,0,0,0,0,1,1
improve weather,1,0,0,0,0,0,0,1
improved agricultural,0,0,0,0,0,0,1,1
improved nutrition,0,1,0,0,0,0,0,1
improving forest,1,0,0,0,0,0,0,1
improving gas,0,0,0,0,1,0,0,1
improving management,0,0,0,0,0,1,0,1
improving people's,0,0,0,0,0,1,0,1
improving refinery,1,0,0,0,0,0,0,1
improving watersheds,0,0,0,0,0,1,0,1
impulsive decisions,0,0,0,0,1,0,0,1
impulsive popping,1,0,0,0,0,0,0,1
in.this story,0,1,0,0,0,0,0,1
inaccurate clichés,0,0,1,0,0,0,0,1
inacio lula,0,1,0,0,0,0,0,1
inácio lula,0,0,0,0,0,0,1,1
inadequate money,0,1,0,0,0,0,0,1
inaudible yelling,0,1,0,0,0,0,0,1
inaugural speech,1,0,0,0,0,0,0,1
inauguration ceremony,0,1,0,0,0,0,0,1
incarceration camp,0,0,0,0,1,0,0,1
incentivize carbon,0,0,0,0,0,1,0,1
incentivize domestic,1,0,0,0,0,0,0,1
incentivize farmers,0,1,0,0,0,0,0,1
incentivize investment,0,1,0,0,0,0,0,1
incentivize investments,1,0,0,0,0,0,0,1
incentivize recycling,0,0,0,1,0,0,0,1
incentivizes consumers,0,1,0,0,0,0,0,1
incentivizes electric,0,1,0,0,0,0,0,1
incentivizing people,0,0,0,0,1,0,0,1
inch difference,0,1,0,0,0,0,0,1
inches danny,0,1,0,0,0,0,0,1
inches deep,0,0,0,0,1,0,0,1
inches expected,0,0,0,1,0,0,0,1
incident residents,0,0,0,1,0,0,0,1
inclined actors,0,0,0,1,0,0,0,1
include alabama,0,0,1,0,0,0,0,1
include armed,0,1,0,0,0,0,0,1
include building,0,1,0,0,0,0,0,1
include consultations,0,1,0,0,0,0,0,1
include dallas,0,0,0,0,0,1,0,1
include electric,0,1,0,0,0,0,0,1
include funding,0,0,0,0,0,0,1,1
include gently,0,0,0,1,0,0,0,1
include issuing,0,1,0,0,0,0,0,1
include people,0,0,0,0,0,1,0,1
include projections,0,0,0,1,0,0,0,1
include splitting,0,0,0,0,0,0,1,1
include straightforward,0,0,0,0,0,1,0,1
include subsidized,0,1,0,0,0,0,0,1
include training,0,1,0,0,0,0,0,1
include widespread,1,0,0,0,0,0,0,1
included artifacts,0,1,0,0,0,0,0,1
included hiring,0,0,0,1,0,0,0,1
included insects,0,0,0,0,0,1,0,1
includes aspen,0,0,0,1,0,0,0,1
includes claims,0,0,0,0,1,0,0,1
includes financial,0,0,0,1,0,0,0,1
includes incentives,0,0,1,0,0,0,0,1
includes leaders,0,1,0,0,0,0,0,1
includes liability,0,0,0,1,0,0,0,1
includes penalties,0,0,0,0,1,0,0,1
includes prioritizing,0,0,0,1,0,0,0,1
includes reducing,0,0,0,0,0,1,0,1
includes rolling,0,0,0,0,0,1,0,1
includes sea,0,1,0,0,0,0,0,1
includes surging,0,1,0,0,0,0,0,1
includes symbols,1,0,0,0,0,0,0,1
includes tax,0,0,0,0,0,1,0,1
including action,0,1,0,0,0,0,0,1
including agricultural,0,0,0,0,0,1,0,1
including alabama,0,0,1,0,0,0,0,1
including andros,0,1,0,0,0,0,0,1
including anjali,0,0,0,0,1,0,0,1
including arizona,0,0,0,0,0,1,0,1
including arsenic,0,0,0,0,1,0,0,1
including bill,0,1,0,0,0,0,0,1
including blocking,0,1,0,0,0,0,0,1
including bloody,0,0,0,0,0,1,0,1
including bottled,0,0,0,0,0,1,0,1
including box,0,0,0,0,0,1,0,1
including british,0,1,0,0,0,0,0,1
including claims,0,0,0,0,1,0,0,1
including clean,0,0,0,0,0,0,1,1
including climate,0,1,0,0,0,0,0,1
including cloud,0,0,0,0,1,0,0,1
including colorado,0,0,0,1,0,0,0,1
including companies,0,0,0,1,0,0,0,1
including cultivating,0,1,0,0,0,0,0,1
including dancing,0,0,0,0,1,0,0,1
including deploying,0,0,1,0,0,0,0,1
including entire,1,0,0,0,0,0,0,1
including fats,0,1,0,0,0,0,0,1
including france,0,0,0,0,0,1,0,1
including frank,0,0,0,0,1,0,0,1
including hospital,0,0,0,0,0,1,0,1
including india,0,0,0,1,0,0,0,1
including injuries,0,0,1,0,0,0,0,1
including insects,0,0,0,0,0,1,0,1
including jaundice,0,0,0,0,0,1,0,1
including jpmorgan,0,0,0,0,0,1,0,1
including justices,0,0,0,0,0,1,0,1
including kaplan's,0,0,0,0,0,0,1,1
including lee,1,0,0,0,0,0,0,1
including military,0,0,0,1,0,0,0,1
including mingma,0,1,0,0,0,0,0,1
including ngos,0,0,1,0,0,0,0,1
including nitrogen,1,0,0,0,0,0,0,1
including ohio,0,0,0,0,1,0,0,1
including oil,0,1,0,0,0,0,0,1
including oxnard,0,0,0,1,0,0,0,1
including plug,0,0,0,0,0,1,0,1
including potentially,0,0,1,0,0,0,0,1
including private,0,0,1,0,0,0,0,1
including protecting,0,0,0,0,0,1,0,1
including public,0,0,1,0,0,0,0,1
including removal,0,1,0,0,0,0,0,1
including republican,0,1,0,0,0,0,0,1
including rolling,0,0,0,0,0,1,0,1
including russia,0,1,0,0,0,0,0,1
including san,0,0,0,0,1,0,0,1
including shipments,0,1,0,0,0,0,0,1
including silver,0,0,0,0,0,1,0,1
including snowfall,0,0,0,0,1,0,0,1
including steven,0,1,0,0,0,0,0,1
including terrain,0,0,0,1,0,0,0,1
including tyson,0,1,0,0,0,0,0,1
including watsonville,0,0,0,1,0,0,0,1
including whirlpool,0,0,0,0,1,0,0,1
including worldwide,0,1,0,0,0,0,0,1
inclusive education,0,0,0,0,1,0,0,1
income coming,0,0,0,0,1,0,0,1
income households,0,0,0,1,0,0,0,1
income inequality,0,0,0,0,1,0,0,1
income ladder,0,0,0,0,1,0,0,1
income neighborhoods,0,0,0,0,0,1,0,1
income people,0,1,0,0,0,0,0,1
incoming runoff,0,0,0,0,0,1,0,1
incoming storm,0,1,0,0,0,0,0,1
incomplete answer,0,0,0,0,1,0,0,1
incorporate knowledge,0,0,0,0,1,0,0,1
increase adaptation,0,1,0,0,0,0,0,1
increase climate,0,1,0,0,0,0,0,1
increase energy,0,0,0,0,1,0,0,1
increase explains,0,0,0,0,1,0,0,1
increase fuel,0,0,0,0,1,0,0,1
increase heat,0,0,1,0,0,0,0,1
increase police,0,1,0,0,0,0,0,1
increase precipitation,0,0,0,1,0,0,0,1
increase private,0,1,0,0,0,0,0,1
increase renewable,0,0,0,0,1,0,0,1
increase sanctions,0,0,0,0,1,0,0,1
increase specifically,0,0,0,1,0,0,0,1
increase walkability,0,0,0,0,0,1,0,1
increased automation,0,0,0,0,0,1,0,1
increased demands,0,0,0,0,0,0,1,1
increased ecosystem,1,0,0,0,0,0,0,1
increased fire,0,0,0,0,0,1,0,1
increased flights,0,0,1,0,0,0,0,1
increased flooding,1,0,0,0,0,0,0,1
increased momentum,0,1,0,0,0,0,0,1
increased revenue,0,0,0,0,0,1,0,1
increased risk,0,1,0,0,0,0,0,1
increased water,0,1,0,0,0,0,0,1
increasing amounts,0,0,0,1,0,0,0,1
increasing anger,0,1,0,0,0,0,0,1
increasing climate,0,1,0,0,0,0,0,1
increasing conservation,1,0,0,0,0,0,0,1
increasing demand,0,0,0,0,0,1,0,1
increasing droughts,0,0,1,0,0,0,0,1
increasing earlier,0,0,0,0,0,1,0,1
increasing existing,0,1,0,0,0,0,0,1
increasing frequency,0,0,0,0,0,1,0,1
increasing frustration,0,1,0,0,0,0,0,1
increasing gas,0,0,1,0,0,0,0,1
increasing globally,0,0,0,0,0,1,0,1
increasing greenhouse,0,0,0,0,1,0,0,1
increasing hurricane,0,0,0,0,1,0,0,1
increasing importance,0,0,0,1,0,0,0,1
increasing life,0,1,0,0,0,0,0,1
increasing private,0,1,0,0,0,0,0,1
increasing recycling,0,0,1,0,0,0,0,1
increasing risk,1,0,0,0,0,0,0,1
increasing risks,1,0,0,0,0,0,0,1
increasing scrutiny,0,0,0,0,1,0,0,1
increasing warnings,1,0,0,0,0,0,0,1
increasing water,0,0,0,0,0,1,0,1
increasingly arid,1,0,0,0,0,0,0,1
increasingly costly,0,0,0,0,1,0,0,1
increasingly destructive,0,0,0,1,0,0,0,1
increasingly dire,0,0,0,0,0,1,0,1
increasingly expensive,0,0,0,1,0,0,0,1
increasingly facing,0,1,0,0,0,0,0,1
increasingly hostile,0,0,0,0,0,0,1,1
increasingly popular,0,1,0,0,0,0,0,1
increasingly severe,0,0,0,0,0,1,0,1
increasingly vulnerable,0,1,0,0,0,0,0,1
incredible rainfall,0,0,0,1,0,0,0,1
incredibly awesome,0,0,0,1,0,0,0,1
incredibly brave,0,1,0,0,0,0,0,1
incredibly cold,0,0,0,0,1,0,0,1
incredibly confusing,0,0,1,0,0,0,0,1
incredibly distressing,0,0,1,0,0,0,0,1
incredibly profitable,0,0,0,0,1,0,0,1
incredibly versatile,0,1,0,0,0,0,0,1
incremental approach,0,0,0,0,1,0,0,1
incremental cuts,0,0,1,0,0,0,0,1
incur due,0,0,0,1,0,0,0,1
indefinitely yeah,0,0,0,0,1,0,0,1
independence national,1,0,0,0,0,0,0,1
independent academics,0,0,0,1,0,0,0,1
independent investigation,0,1,0,0,0,0,0,1
independent news,0,0,1,0,0,0,0,1
independent researcher,0,0,0,0,1,0,0,1
independently verify,0,0,1,0,0,0,0,1
india adapt,0,1,0,0,0,0,0,1
india altaf,0,0,0,0,0,1,0,1
india india,0,1,0,0,0,0,0,1
india representative,0,1,0,0,0,0,0,1
india's emissions,0,1,0,0,0,0,0,1
india's green,0,1,0,0,0,0,0,1
india's growth,0,1,0,0,0,0,0,1
india's largest,0,0,0,0,1,0,0,1
india's meghalaya,0,0,0,0,0,1,0,1
indian law,0,0,0,0,0,1,0,1
indian mound,1,0,0,0,0,0,0,1
indian reservations,0,0,0,0,0,1,0,1
indian river,0,1,0,0,0,0,0,1
indian treaties,0,0,0,0,0,1,0,1
indiana jones,0,1,0,0,0,0,0,1
indiana's sullivan,0,0,0,0,0,0,1,1
indians suffer,0,1,0,0,0,0,0,1
indicator music,0,0,1,0,0,0,0,1
indicator species,0,0,0,0,1,0,0,1
indigenous foods,0,0,0,0,0,1,0,1
indigenous knowledge,0,0,0,0,0,1,0,1
indigenous land,0,0,0,0,0,0,1,1
indigenous lands,0,0,0,0,0,0,1,1
indigenous materials,0,0,0,0,0,1,0,1
indigenous rights,0,0,1,0,0,0,0,1
indirect jobs,0,0,0,0,0,1,0,1
indispensable component,0,1,0,0,0,0,0,1
indisputably guided,0,0,0,1,0,0,0,1
individual buildings,1,0,0,0,0,0,0,1
individual drum,0,0,0,1,0,0,0,1
individual freedom,0,0,0,0,0,1,0,1
individual home,0,0,0,0,0,1,0,1
individual impacts,1,0,0,0,0,0,0,1
individual line,1,0,0,0,0,0,0,1
individual manufacturers,0,0,0,0,1,0,0,1
individual offices,0,0,0,0,0,0,1,1
individual researchers,0,0,1,0,0,0,0,1
indonesia announced,0,1,0,0,0,0,0,1
indonesia emerges,0,0,0,0,1,0,0,1
indonesia npr's,0,1,0,0,0,0,0,1
indonesia peatland,0,0,0,0,0,0,1,1
indonesia plans,0,0,0,0,1,0,0,1
indonesia retire,0,0,0,0,1,0,0,1
indonesia signed,0,0,0,0,1,0,0,1
indonesia solar,0,0,0,0,1,0,0,1
indonesia ulet,0,0,1,0,0,0,0,1
indonesia's approach,0,0,0,0,1,0,0,1
indonesia's aspirations,0,0,0,0,1,0,0,1
indonesia's decarbonization,0,0,0,0,1,0,0,1
indonesia's energy,0,0,0,0,1,0,0,1
indonesia's thriving,0,0,0,0,0,0,1,1
indonesia's transition,0,0,0,0,1,0,0,1
indonesian borneo,0,0,0,0,1,0,0,1
indonesian energy,0,0,0,0,1,0,0,1
indonesian island,0,1,0,0,0,0,0,1
indonesian officials,0,0,0,0,1,0,0,1
indonesian president,0,0,0,0,1,0,0,1
indonesian renewable,0,0,0,0,1,0,0,1
indonesian solar,0,0,0,0,1,0,0,1
indonesians worry,0,0,0,0,1,0,0,1
induced climate,0,0,0,1,0,0,0,1
induced greenhouse,0,1,0,0,0,0,0,1
induced sea,0,0,0,1,0,0,0,1
industrial averages,1,0,0,0,0,0,0,1
industrial era,0,0,1,0,0,0,0,1
industrial fishing,1,0,0,0,0,0,0,1
industrial future,0,1,0,0,0,0,0,1
industrial growth,0,0,0,0,0,1,0,1
industrial levels,0,0,0,0,0,0,1,1
industrial park,0,0,0,0,1,0,0,1
industrial parks,0,0,0,0,1,0,0,1
industrial pollution,0,1,0,0,0,0,0,1
industrial processes,1,0,0,0,0,0,0,1
industrial revolution,0,1,0,0,0,0,0,1
industrial scale,0,0,0,1,0,0,0,1
industrial sites,1,0,0,0,0,0,0,1
industrial source,0,1,0,0,0,0,0,1
industrial sources,0,0,0,0,1,0,0,1
industrial strength,0,0,1,0,0,0,0,1
industrial style,0,0,0,1,0,0,0,1
industrialized world,0,0,0,0,0,1,0,1
industries affected,0,0,0,1,0,0,0,1
industries volkswagen,0,0,0,0,0,1,0,1
industry allies,0,0,0,0,1,0,0,1
industry appears,0,0,0,0,1,0,0,1
industry arguing,0,0,0,0,1,0,0,1
industry aronczyk,0,0,0,1,0,0,0,1
industry believes,1,0,0,0,0,0,0,1
industry brad,1,0,0,0,0,0,0,1
industry brew,0,1,0,0,0,0,0,1
industry carved,0,1,0,0,0,0,0,1
industry citi,0,0,0,0,0,1,0,1
industry conference,0,0,0,0,1,0,0,1
industry government,0,0,0,1,0,0,0,1
industry heads,0,1,0,0,0,0,0,1
industry hunnes,0,1,0,0,0,0,0,1
industry illegal,0,0,0,0,0,0,1,1
industry industry,1,0,0,0,0,0,0,1
industry johnson,0,0,0,0,1,0,0,1
industry lobby,1,0,0,0,0,0,0,1
industry participants,0,0,0,0,1,0,0,1
industry plans,1,0,0,0,0,0,0,1
industry power,0,0,0,0,0,1,0,1
industry pushed,0,0,0,0,1,0,0,1
industry resolved,0,0,0,0,1,0,0,1
industry scott,1,0,0,0,0,0,0,1
industry supported,0,0,0,0,1,0,0,1
industry talk,0,0,0,0,1,0,0,1
industry utilities,0,0,0,1,0,0,0,1
industry warns,1,0,0,0,0,0,0,1
inequity plays,0,0,0,1,0,0,0,1
inevitably care,0,0,1,0,0,0,0,1
inevitably challenging,0,0,0,0,1,0,0,1
inevitably disappointment,0,1,0,0,0,0,0,1
inextricable linkage,0,0,1,0,0,0,0,1
inextricably linked,0,1,0,0,0,0,0,1
inextricably tied,0,1,0,0,0,0,0,1
infantes afp,0,1,0,0,0,0,0,1
infected fluids,0,0,0,0,0,1,0,1
infected hive,0,0,0,1,0,0,0,1
infectious diseases,0,0,0,0,0,1,0,1
infield dirt,0,1,0,0,0,0,0,1
infiltration basins,0,0,0,1,0,0,0,1
infinite america's,1,0,0,0,0,0,0,1
infinite loop,0,1,0,0,0,0,0,1
inflamed pancreas,0,0,0,0,0,1,0,1
inflation powell,0,0,0,0,0,1,0,1
influence abroad,0,0,0,1,0,0,0,1
influence ballot,0,0,1,0,0,0,0,1
influence decisions,0,0,1,0,0,0,0,1
influence public,0,0,1,0,0,0,0,1
influencemap analyst,0,0,1,0,0,0,0,1
influencemap's report,0,0,1,0,0,0,0,1
influencers continue,0,0,0,0,0,1,0,1
influencers decry,0,0,0,0,0,1,0,1
influencers moments,0,0,0,1,0,0,0,1
influencing florida,0,0,1,0,0,0,0,1
influential activist,0,0,0,0,1,0,0,1
influential climate,0,0,0,0,1,0,0,1
influx yeah,0,1,0,0,0,0,0,1
info cities,0,0,0,1,0,0,0,1
inform bolten,0,0,1,0,0,0,0,1
inform countries,0,1,0,0,0,0,0,1
informal forecast,0,0,0,0,0,1,0,1
informal school,1,0,0,0,0,0,0,1
information adding,0,0,0,0,1,0,0,1
information process,0,0,0,0,1,0,0,1
information provided,0,0,1,0,0,0,0,1
information starting,0,0,0,1,0,0,0,1
informed citizens,0,0,1,0,0,0,0,1
infrared surface,0,0,0,1,0,0,0,1
infrastructure bill,0,1,0,0,0,0,0,1
infrastructure built,0,0,0,0,0,1,0,1
infrastructure costs,0,0,0,1,0,0,0,1
infrastructure designed,0,0,0,1,0,0,0,1
infrastructure funding,0,0,0,1,0,0,0,1
infrastructure investment,0,0,0,0,0,0,1,1
infrastructure joe,0,0,0,0,0,1,0,1
infrastructure ken,0,0,0,0,0,1,0,1
infrastructure money,0,0,0,0,1,0,0,1
infrastructure officials,0,1,0,0,0,0,0,1
infrastructure people,0,0,0,0,1,0,0,1
infrastructure project,0,0,0,0,1,0,0,1
infrastructure projects,0,1,0,0,0,0,0,1
infrastructure push,0,1,0,0,0,0,0,1
infrastructure spending,0,0,0,1,0,0,0,1
infrastructure updates,1,0,0,0,0,0,0,1
infrastructure yeah,0,0,0,1,0,0,0,1
ing space,0,0,1,0,0,0,0,1
inganga ap,1,0,0,0,0,0,0,1
ingraham ben,0,0,0,0,0,1,0,1
inherently contradicts,0,0,1,0,0,0,0,1
inherently inequitable,0,0,0,0,1,0,0,1
initial disaster,0,1,0,0,0,0,0,1
initial federal,0,0,0,0,0,1,0,1
initial harvest,0,0,0,0,0,0,1,1
initial investment,0,1,0,0,0,0,0,1
initial response,1,0,0,0,0,0,0,1
initial vote,0,0,0,0,1,0,0,1
initially approved,0,0,0,0,0,1,0,1
initially provide,0,1,0,0,0,0,0,1
initiated enter,0,0,0,1,0,0,0,1
initiative aimed,0,0,1,0,0,0,0,1
initiative armed,0,1,0,0,0,0,0,1
initiative assists,0,0,0,0,1,0,0,1
initiative builds,0,1,0,0,0,0,0,1
initiative called,0,0,0,0,0,1,0,1
initiative emissions,0,1,0,0,0,0,0,1
initiative plastic,1,0,0,0,0,0,0,1
initiative quickly,0,0,0,0,0,1,0,1
initiative smi,0,1,0,0,0,0,0,1
initiatives electric,0,0,0,0,0,0,1,1
injured doug,0,0,0,0,0,0,1,1
injured jeremiah,0,0,0,0,0,0,1,1
injured people,1,0,0,0,0,0,0,1
injuries due,0,1,0,0,0,0,0,1
injuries sustained,0,0,1,0,0,0,0,1
inked deals,1,0,0,0,0,0,0,1
inland covering,0,1,0,0,0,0,0,1
inland empire,0,0,0,0,0,1,0,1
inland mississippi,1,0,0,0,0,0,0,1
inland river,1,0,0,0,0,0,0,1
inland senegalese,0,1,0,0,0,0,0,1
inland suburbs,0,0,0,0,1,0,0,1
inland waters,1,0,0,0,0,0,0,1
innovation factory,0,1,0,0,0,0,0,1
innovative products,0,1,0,0,0,0,0,1
innovative solutions,0,1,0,0,0,0,0,1
innovative technology,0,1,0,0,0,0,0,1
input portillo,0,0,1,0,0,0,0,1
insect eating,0,0,0,0,0,1,0,1
insect matter,0,0,0,0,0,1,0,1
insect pressure,0,0,0,0,0,1,0,1
insects ability,0,0,0,0,0,1,0,1
insects aristotle,0,0,0,0,0,1,0,1
insects initially,0,0,0,0,0,1,0,1
insects potential,0,0,0,0,0,1,0,1
insects spiders,1,0,0,0,0,0,0,1
insecure neighborhoods,0,0,0,0,0,1,0,1
insecurity caused,0,0,1,0,0,0,0,1
insecurity leads,0,0,0,0,0,1,0,1
insecurity sarah,0,0,0,0,1,0,0,1
inside bathing,0,1,0,0,0,0,0,1
inside cities,0,0,0,1,0,0,0,1
inside john,0,0,0,0,1,0,0,1
inside steve,1,0,0,0,0,0,0,1
inside vicinity,1,0,0,0,0,0,0,1
insists measures,0,0,1,0,0,0,0,1
inslee tooted,0,0,0,0,1,0,0,1
inslee's promises,0,0,0,0,1,0,0,1
inslee's push,0,0,0,0,1,0,0,1
inspection upside,0,1,0,0,0,0,0,1
inspector general's,0,0,0,0,0,0,1,1
inspiration generosity,0,1,0,0,0,0,0,1
inspire action,0,0,0,1,0,0,0,1
inspire climate,1,0,0,0,0,0,0,1
inspire people,0,1,0,0,0,0,0,1
inspiring conservation,0,0,1,0,0,0,0,1
instability losses,1,0,0,0,0,0,0,1
instagram tiktok,0,0,1,0,0,0,0,1
install bike,0,0,0,1,0,0,0,1
install charging,0,0,0,0,1,0,0,1
install heat,0,0,0,0,0,0,1,1
installation ghost,0,1,0,0,0,0,0,1
installed debris,0,0,0,1,0,0,0,1
installed study,0,0,0,1,0,0,0,1
installed system,1,0,0,0,0,0,0,1
installing distributed,0,0,0,1,0,0,0,1
installing systems,0,0,0,0,0,1,0,1
installment plans,1,0,0,0,0,0,0,1
instance climate,0,1,0,0,0,0,0,1
instance earlier,0,1,0,0,0,0,0,1
instance global,0,0,0,0,0,0,1,1
instance practices,0,1,0,0,0,0,0,1
instance salmonella,0,1,0,0,0,0,0,1
instill loyalty,0,0,1,0,0,0,0,1
institute communities,0,0,1,0,0,0,0,1
institute director,0,0,0,1,0,0,0,1
institute lost,0,1,0,0,0,0,0,1
institute's sustainable,0,1,0,0,0,0,0,1
institution aronczyk,0,0,0,1,0,0,0,1
institution taking,0,1,0,0,0,0,0,1
institutions assess,0,0,0,0,1,0,0,1
institutions including,0,0,0,1,0,0,0,1
instrument scientist,1,0,0,0,0,0,0,1
instrumentation netting,0,0,0,1,0,0,0,1
instruments including,0,1,0,0,0,0,0,1
instruments materials,0,1,0,0,0,0,0,1
instruments wrangling,0,1,0,0,0,0,0,1
insufficient meaning,0,0,0,0,0,1,0,1
insurance company,0,0,0,0,0,0,1,1
insurance covers,0,1,0,0,0,0,0,1
insurance industry,0,0,0,0,1,0,0,1
insurance lori,0,1,0,0,0,0,0,1
intact meaning,0,0,1,0,0,0,0,1
intact nature,0,0,1,0,0,0,0,1
integrate carbon,1,0,0,0,0,0,0,1
integrity framework,0,1,0,0,0,0,0,1
intelligence based,0,0,0,1,0,0,0,1
intelligence committee,0,0,0,1,0,0,0,1
intelligence division,0,0,0,1,0,0,0,1
intelligence firm,0,0,0,1,0,0,0,1
intelligence method,0,1,0,0,0,0,0,1
intelligence predicts,0,0,0,1,0,0,0,1
intended individuals,0,0,0,1,0,0,0,1
intended internal,0,0,0,1,0,0,0,1
intense battle,0,0,0,0,0,1,0,1
intense downpours,0,0,0,1,0,0,0,1
intense drought,0,0,0,1,0,0,0,1
intense dry,0,0,0,1,0,0,0,1
intense dynamics,1,0,0,0,0,0,0,1
intense extreme,0,0,0,1,0,0,0,1
intense noaa,0,1,0,0,0,0,0,1
intense rain,0,0,0,1,0,0,0,1
intense smog,0,0,0,0,0,1,0,1
intense study,0,0,0,0,1,0,0,1
intense winter,0,0,0,0,0,1,0,1
intensely unavoidably,0,1,0,0,0,0,0,1
intensified efforts,0,0,0,0,0,1,0,1
intensifying hurricanes,1,0,0,0,0,0,0,1
intensifying weather,0,0,0,1,0,0,0,1
intensity data,1,0,0,0,0,0,0,1
intensity flurries,0,0,0,0,1,0,0,1
intensive care,0,1,0,0,0,0,0,1
intensive economy,0,1,0,0,0,0,0,1
intensive effort,0,0,0,0,0,1,0,1
intentional movement,0,0,0,0,1,0,0,1
intentionally cheating,0,1,0,0,0,0,0,1
intentionally designed,0,1,0,0,0,0,0,1
intentionally set,1,0,0,0,0,0,0,1
interact intimately,0,0,1,0,0,0,0,1
interactive dialogues,0,0,0,0,0,1,0,1
interactive installation,0,1,0,0,0,0,0,1
interactive map,0,1,0,0,0,0,0,1
interamerican association,0,0,0,0,1,0,0,1
intergovernmental conference,0,0,0,0,1,0,0,1
interim targets,0,1,0,0,0,0,0,1
interior minister,1,0,0,0,0,0,0,1
interior ministry,0,1,0,0,0,0,0,1
internal bleeding,0,0,0,0,0,1,0,1
internal displacement,1,0,0,0,0,0,0,1
internal policy,0,0,0,1,0,0,0,1
internal report,0,0,0,0,0,1,0,1
internal watchdog,0,0,0,0,0,0,1,1
international action,0,0,0,1,0,0,0,1
international aid,1,0,0,0,0,0,0,1
international banks,0,0,0,0,1,0,0,1
international borders,0,1,0,0,0,0,0,1
international celebrity,0,0,0,0,1,0,0,1
international centre,0,0,0,0,0,1,0,1
international collaboration,0,0,0,0,0,1,0,1
international district,1,0,0,0,0,0,0,1
international environmental,0,0,0,0,1,0,0,1
international fertilizer,1,0,0,0,0,0,0,1
international flights,1,0,0,0,0,0,0,1
international fund,0,1,0,0,0,0,0,1
international image,0,0,0,0,1,0,0,1
international institute,0,0,0,0,1,0,0,1
international meeting,0,0,0,0,0,1,0,1
international negotiations,0,0,0,0,0,1,0,1
international organization,0,1,0,0,0,0,0,1
international partners,0,0,0,0,1,0,0,1
international peace,0,1,0,0,0,0,0,1
international recognition,0,0,1,0,0,0,0,1
international renewable,0,0,0,1,0,0,0,1
international research,0,0,0,0,1,0,0,1
international space,1,0,0,0,0,0,0,1
international strategies,0,1,0,0,0,0,0,1
international support,0,1,0,0,0,0,0,1
international told,1,0,0,0,0,0,0,1
international university,1,0,0,0,0,0,0,1
international waters,0,0,0,0,0,1,0,1
internationally agreed,0,0,0,1,0,0,0,1
internet florida,1,0,0,0,0,0,0,1
internet system,1,0,0,0,0,0,0,1
interpreter germany,0,0,0,1,0,0,0,1
interpreter germany's,0,0,0,1,0,0,0,1
interpreter immigration,0,1,0,0,0,0,0,1
intersectional environmentalist,1,0,0,0,0,0,0,1
interstate resources,0,0,0,0,1,0,0,1
interview morgan,0,1,0,0,0,0,0,1
interview schorsch,0,0,1,0,0,0,0,1
interview sunday,0,0,0,0,0,1,0,1
intestinal pathogens,0,1,0,0,0,0,0,1
intimate interviews,0,0,0,1,0,0,0,1
intimidate individuals,0,0,1,0,0,0,0,1
intrepid teammates,0,1,0,0,0,0,0,1
intrinsically connected,0,0,1,0,0,0,0,1
introduced rapidly,0,0,0,0,0,1,0,1
inundated farmland,0,0,0,1,0,0,0,1
inupiat north,0,0,0,0,0,1,0,1
inventive solutions,0,0,0,1,0,0,0,1
invertebrate predator,1,0,0,0,0,0,0,1
invest millions,0,1,0,0,0,0,0,1
invest money,0,0,0,0,0,1,0,1
invest time,0,0,0,0,1,0,0,1
investigation floodlight,0,0,1,0,0,0,0,1
investigation found,0,0,0,0,1,0,0,1
investigation npr,0,1,0,0,0,0,0,1
investigative report,1,0,0,0,0,0,0,1
investigators unable,0,0,0,0,0,0,1,1
investing heavily,0,0,0,0,1,0,0,1
investing hundreds,0,0,0,1,0,0,0,1
investing inherently,0,0,1,0,0,0,0,1
investing jobs,0,0,1,0,0,0,0,1
investing money,0,0,0,1,0,0,0,1
investing yesterday,0,0,1,0,0,0,0,1
investment bank,0,1,0,0,0,0,0,1
investment dollars,1,0,0,0,0,0,0,1
investment duarte,0,1,0,0,0,0,0,1
investment firm,0,0,0,0,1,0,0,1
investment fund,0,1,0,0,0,0,0,1
investment funds,0,1,0,0,0,0,0,1
investment happening,0,0,1,0,0,0,0,1
investment multilateral,0,1,0,0,0,0,0,1
investment opportunities,0,1,0,0,0,0,0,1
investment programs,0,1,0,0,0,0,0,1
investment reaches,0,0,0,0,0,1,0,1
investment required,0,1,0,0,0,0,0,1
investment running,0,0,0,0,1,0,0,1
investment strategies,1,0,0,0,0,0,0,1
investment streak,0,0,0,0,0,1,0,1
investment summit,0,0,0,1,0,0,0,1
investment trends,0,1,0,0,0,0,0,1
investment worth,0,0,0,0,0,1,0,1
investments relative,0,0,0,0,1,0,0,1
investments social,0,0,1,0,0,0,0,1
investments thursday,0,0,0,1,0,0,0,1
investor venture,0,0,0,0,0,1,0,1
investors financiers,0,0,0,0,0,1,0,1
investors interpreted,0,0,0,0,1,0,0,1
investors rodger,0,1,0,0,0,0,0,1
invisible tornadoes,0,0,0,0,0,1,0,1
invite arms,0,0,0,1,0,0,0,1
invited shortly,0,1,0,0,0,0,0,1
invoice shared,0,0,1,0,0,0,0,1
involve coordinating,0,0,0,0,0,1,0,1
involve water,0,1,0,0,0,0,0,1
involve women,0,1,0,0,0,0,0,1
involves buying,0,0,0,1,0,0,0,1
involving indian,0,0,0,0,0,1,0,1
involving jewish,0,0,0,0,0,1,0,1
iom tells,0,1,0,0,0,0,0,1
ion battery,0,1,0,0,0,0,0,1
iowa conservative,0,0,0,0,1,0,0,1
iowa gaesser,0,0,0,0,1,0,0,1
ipod batteries,0,1,0,0,0,0,0,1
ira oversight,0,0,0,0,0,0,1,1
ira passed,0,0,0,0,0,1,0,1
iraq afghanistan,0,0,0,1,0,0,0,1
irawan nurphoto,0,0,0,0,1,0,0,1
iron pills,1,0,0,0,0,0,0,1
iron supplements,1,0,0,0,0,0,0,1
irreparable harm,0,1,0,0,0,0,0,1
irreversible damage,1,0,0,0,0,0,0,1
irreversible losses,0,1,0,0,0,0,0,1
irreversible sea,0,0,0,0,0,1,0,1
irreversible service,1,0,0,0,0,0,0,1
irreversibly impossible,0,1,0,0,0,0,0,1
irrevocable losses,0,1,0,0,0,0,0,1
irrigated citrus,1,0,0,0,0,0,0,1
irrigation glaciers,0,0,0,1,0,0,0,1
irrigation methods,0,0,0,0,0,1,0,1
irrigation runoff,1,0,0,0,0,0,0,1
irrigation systems,1,0,0,0,0,0,0,1
irs earlier,0,0,0,0,0,0,1,1
isabel caused,0,1,0,0,0,0,0,1
isabel infantes,0,1,0,0,0,0,0,1
island countries,0,0,0,0,1,0,0,1
island country,0,1,0,0,0,0,0,1
island cut,1,0,0,0,0,0,0,1
island east,1,0,0,0,0,0,0,1
island effect,0,0,0,1,0,0,0,1
island irene,0,1,0,0,0,0,0,1
island killing,0,0,0,1,0,0,0,1
island melilla,0,1,0,0,0,0,0,1
island paradise,0,0,0,1,0,0,0,1
island received,0,1,0,0,0,0,0,1
island recover,1,0,0,0,0,0,0,1
island rests,0,0,0,0,1,0,0,1
island s.c,0,1,0,0,0,0,0,1
island saturday,1,0,0,0,0,0,0,1
island's modern,1,0,0,0,0,0,0,1
island's power,0,0,0,1,0,0,0,1
island's southwestern,0,1,0,0,0,0,0,1
islands bimini,0,1,0,0,0,0,0,1
islands charlotte,1,0,0,0,0,0,0,1
islands continuously,0,1,0,0,0,0,0,1
islands declare,0,0,0,0,0,1,0,1
islands land,1,0,0,0,0,0,0,1
islands left,1,0,0,0,0,0,0,1
islands low,0,1,0,0,0,0,0,1
islands officials,0,1,0,0,0,0,0,1
islands unprecedented,1,0,0,0,0,0,0,1
isolated amid,1,0,0,0,0,0,0,1
israel solar,0,1,0,0,0,0,0,1
israeli environmental,0,1,0,0,0,0,0,1
israeli permission,0,1,0,0,0,0,0,1
issue coming,0,1,0,0,0,0,0,1
issue contributing,0,0,0,1,0,0,0,1
issue energy,0,0,0,0,0,1,0,1
issue explained,0,0,0,0,0,1,0,1
issue farm,0,0,0,1,0,0,0,1
issue head,0,0,0,1,0,0,0,1
issue late,0,0,1,0,0,0,0,1
issue plans,0,0,0,0,0,0,1,1
issue policy,0,0,0,1,0,0,0,1
issue writ,0,0,1,0,0,0,0,1
issue.hi michael,0,0,1,0,0,0,0,1
issued strong,0,0,0,1,0,0,0,1
issues cooperation,0,0,0,0,0,1,0,1
issues cropping,0,1,0,0,0,0,0,1
issues experts,0,0,0,0,0,1,0,1
issues reducing,0,0,0,0,1,0,0,1
issues related,0,0,0,0,0,0,1,1
issues slack,0,0,0,1,0,0,0,1
issues starlink,1,0,0,0,0,0,0,1
issues uninhabitable,0,0,0,0,1,0,0,1
issues unrelated,0,1,0,0,0,0,0,1
issues verifying,0,0,0,0,1,0,0,1
it’s electricity,0,0,0,1,0,0,0,1
italian firefighter,0,1,0,0,0,0,0,1
italian ice,1,0,0,0,0,0,0,1
italian premier,0,1,0,0,0,0,0,1
italian resort,0,1,0,0,0,0,0,1
italy bulgaria,0,0,0,0,0,1,0,1
italy michael,0,1,0,0,0,0,0,1
italy voters,1,0,0,0,0,0,0,1
italy's dolomites,0,1,0,0,0,0,0,1
items covered,0,0,0,1,0,0,0,1
items thrown,1,0,0,0,0,0,0,1
items tweeted,0,0,0,1,0,0,0,1
iverson noaa,0,0,0,0,0,1,0,1
j.b pritzker,0,0,0,0,0,0,1,1
j.d vance,0,0,0,0,1,0,0,1
jaber disagrees,0,0,0,1,0,0,0,1
jaber holding,0,0,0,1,0,0,0,1
jaber singled,0,0,0,0,0,1,0,1
jaber spoke,0,0,0,1,0,0,0,1
jaber told,0,0,0,1,0,0,0,1
jaber's appointment,0,0,0,1,0,0,0,1
jaber's nomination,0,0,0,1,0,0,0,1
jaber's view,0,0,0,1,0,0,0,1
jack abramoff,0,0,0,0,1,0,0,1
jack schmidt,1,0,0,0,0,0,0,1
jack smith,0,0,0,1,0,0,0,1
jacket gloves,0,0,0,0,1,0,0,1
jackie ben,0,1,0,0,0,0,0,1
jackie qataliña,0,0,1,0,0,0,0,1
jackson climate,0,1,0,0,0,0,0,1
jackson mississippi,1,0,0,0,0,0,0,1
jackson tupelo,0,0,0,0,0,1,0,1
jaclyn jeffrey,0,0,0,0,1,0,0,1
jacqueline novogratz,0,1,0,0,0,0,0,1
jacquelyn martin,0,0,0,0,1,0,0,1
jahan zuberi,1,0,0,0,0,0,0,1
jahan's nephew,0,0,0,0,0,1,0,1
jahxiel ian,0,1,0,0,0,0,0,1
jailed activists,0,1,0,0,0,0,0,1
jakarta based,0,0,0,0,1,0,0,1
jake bittle's,0,0,0,0,1,0,0,1
jake parsons,0,0,0,0,1,0,0,1
james comer,0,0,0,1,0,0,0,1
james cook,0,1,0,0,0,0,0,1
james lankford,0,1,0,0,0,0,0,1
jamie rhome,0,1,0,0,0,0,0,1
jan victor,0,0,0,0,0,1,0,1
jane eller,0,0,0,0,1,0,0,1
january deforestation,0,1,0,0,0,0,0,1
january easing,0,0,0,1,0,0,0,1
january employers,0,0,0,0,0,1,0,1
january february,0,0,0,0,0,0,1,1
january talking,0,0,0,0,0,1,0,1
japan canada,0,1,0,0,0,0,0,1
japanese americans,0,0,0,0,1,0,0,1
japanese automaker,0,0,0,0,1,0,0,1
japanese cook,0,0,0,0,0,1,0,1
jared holt,0,0,0,1,0,0,0,1
jason torchinsky,0,0,0,0,1,0,0,1
java kaimuddin,0,0,0,0,1,0,0,1
jay balagna,1,0,0,0,0,0,0,1
jay inslee's,0,0,0,0,1,0,0,1
jayson martínez,0,1,0,0,0,0,0,1
jean ritchie,0,1,0,0,0,0,0,1
jeanine jones,0,0,0,0,1,0,0,1
jed mandel,0,0,1,0,0,0,0,1
jeff burchfield,0,0,1,0,0,0,0,1
jeff forward,0,1,0,0,0,0,0,1
jeff hey,0,0,0,1,0,0,0,1
jeff pitts,0,0,1,0,0,0,0,1
jeff reveals,0,0,0,1,0,0,0,1
jeffrey day,0,0,0,0,0,0,1,1
jeffrey wilensky,0,0,0,0,1,0,0,1
jelani brown,1,0,0,0,0,0,0,1
jelani ph,1,0,0,0,0,0,0,1
jen brady,1,0,0,0,0,0,0,1
jenni proller,0,0,0,1,0,0,0,1
jenni pröller,0,0,1,0,0,0,0,1
jennifer clarke,0,0,0,0,0,1,0,1
jennifer corpuz,0,0,1,0,0,0,0,1
jennifer francis,0,0,0,1,0,0,0,1
jennifer granholm,0,0,0,1,0,0,0,1
jennifer jacquet,0,0,0,1,0,0,0,1
jennifer rubio,0,0,0,1,0,0,0,1
jennifer vanos,0,0,0,1,0,0,0,1
jeopardizing hydropower,0,0,0,1,0,0,0,1
jeremy harbeck,0,1,0,0,0,0,0,1
jeremy lancaster,0,0,0,1,0,0,0,1
jeremy renner,0,0,0,1,0,0,0,1
jerk real,1,0,0,0,0,0,0,1
jerome powell,0,0,0,0,0,1,0,1
jersey beaches,0,0,0,0,1,0,0,1
jersey governor,0,0,0,0,1,0,0,1
jersey waters,0,0,0,0,1,0,0,1
jess jiang,0,0,1,0,0,0,0,1
jesse bell,0,0,1,0,0,0,0,1
jessica battle,0,0,0,0,1,0,0,1
jessica spiegel,0,0,0,0,1,0,0,1
jet flights,0,0,1,0,0,0,0,1
jet fuel,0,0,1,0,0,0,0,1
jet fumes,0,0,1,0,0,0,0,1
jet powered,0,0,0,0,1,0,0,1
jet ps,0,1,0,0,0,0,0,1
jet skis,0,0,0,1,0,0,0,1
jetn̄il kijiner,0,1,0,0,0,0,0,1
jets flying,0,0,1,0,0,0,0,1
jetty carved,1,0,0,0,0,0,0,1
jetty road,1,0,0,0,0,0,0,1
jewish people,0,0,0,0,0,1,0,1
jharia founded,0,0,0,0,1,0,0,1
jharkhand home,0,0,0,0,1,0,0,1
jharkhand rely,0,0,0,0,1,0,0,1
jill biden,1,0,0,0,0,0,0,1
jill hopke,0,0,0,1,0,0,0,1
jill pulley,0,0,0,0,1,0,0,1
jim andrew,0,1,0,0,0,0,0,1
jim boyle,0,0,0,0,1,0,0,1
jim jordan,0,0,0,1,0,0,0,1
jim thompson,0,0,0,0,1,0,0,1
jiwen fan,1,0,0,0,0,0,0,1
jo mount,0,0,0,0,0,1,0,1
joaquin river,0,0,0,0,0,1,0,1
job creation,0,0,0,0,0,1,0,1
job market,0,0,0,0,0,1,0,1
job officials,0,0,0,0,1,0,0,1
job reading,0,0,0,0,0,1,0,1
job security,0,1,0,0,0,0,0,1
job selling,1,0,0,0,0,0,0,1
job shut,0,0,0,0,0,0,1,1
jobs act,0,0,0,0,0,0,1,1
jobs automotive,0,0,0,0,0,1,0,1
jobs data,0,0,0,0,0,1,0,1
jobs killer,1,0,0,0,0,0,0,1
jobs local,1,0,0,0,0,0,0,1
jobs pensions,0,0,0,0,1,0,0,1
jobs scott,0,0,0,0,0,1,0,1
jobs willow,0,0,0,0,0,1,0,1
jodie rummer,0,1,0,0,0,0,0,1
joe burbank,0,1,0,0,0,0,0,1
joe cavaretta,0,1,0,0,0,0,0,1
joe conforti,1,0,0,0,0,0,0,1
joe fox,0,0,0,0,0,0,1,1
joe raedle,0,0,0,0,0,1,0,1
joel stegner,0,0,0,0,1,0,0,1
johann ludwig,0,1,0,0,0,0,0,1
johi jetty,1,0,0,0,0,0,0,1
john arkoosh,0,0,0,0,1,0,0,1
john barrasso,0,1,0,0,0,0,0,1
john conger,0,1,0,0,0,0,0,1
john cox's,0,0,0,1,0,0,0,1
john degrove,1,0,0,0,0,0,0,1
john doerr,0,1,0,0,0,0,0,1
john lanham,0,0,0,0,1,0,0,1
john steinbeck,0,0,0,0,0,1,0,1
johnsen's hands,0,0,1,0,0,0,0,1
johnson delivered,0,0,0,0,1,0,0,1
johnson painting,1,0,0,0,0,0,0,1
join ford,0,0,0,0,0,1,0,1
join partners,0,0,1,0,0,0,0,1
join president,0,1,0,0,0,0,0,1
joined boko,0,0,1,0,0,0,0,1
joined forces,0,0,0,0,1,0,0,1
joined fridays,0,0,0,0,1,0,0,1
joined homebuilders,0,1,0,0,0,0,0,1
joint declaration,0,1,0,0,0,0,0,1
joint investment,0,1,0,0,0,0,0,1
joint powers,0,0,0,0,1,0,0,1
joko widodo,0,0,0,0,1,0,0,1
jon betz,0,1,0,0,0,0,0,1
jon rosenthal,0,0,0,0,1,0,0,1
jonathan godes,0,0,0,0,0,0,1,1
jonathan nackstrand,0,1,0,0,0,0,0,1
jones added,0,0,0,0,1,0,0,1
jones ap,0,1,0,0,0,0,0,1
jones exploring,0,1,0,0,0,0,0,1
jones prepared,0,1,0,0,0,0,0,1
joplin missouri,0,0,0,0,0,1,0,1
jordan afp,1,0,0,0,0,0,0,1
jordan issued,0,0,1,0,0,0,0,1
jordan spoke,0,1,0,0,0,0,0,1
jordan u.s,1,0,0,0,0,0,0,1
jordanian companies,0,1,0,0,0,0,0,1
jose carlos,0,0,0,1,0,0,0,1
joseph henry,0,0,0,0,0,1,0,1
joseph prezioso,0,0,0,0,1,0,0,1
josh ching,0,0,0,0,1,0,0,1
josh edelson,0,0,0,1,0,0,0,1
josh macey,1,0,0,0,0,0,0,1
josh newall,0,0,0,0,1,0,0,1
joshua baca,1,0,0,0,0,0,0,1
joshua march,0,1,0,0,0,0,0,1
josiah kephart,0,0,0,1,0,0,0,1
joughin explains,0,1,0,0,0,0,0,1
journal bbc,0,1,0,0,0,0,0,1
journal focusing,0,0,0,0,0,0,1,1
journal halle,1,0,0,0,0,0,0,1
journal proceedings,0,0,0,1,0,0,0,1
journal quaternary,1,0,0,0,0,0,0,1
journal science,0,0,0,1,0,0,0,1
journalism holds,0,0,1,0,0,0,0,1
journalism partnership,1,0,0,0,0,0,0,1
journalism relies,0,0,1,0,0,0,0,1
journalist based,0,1,0,0,0,0,0,1
journalist irene,0,1,0,0,0,0,0,1
journalist story,0,0,0,0,1,0,0,1
journalistic practices,0,0,1,0,0,0,0,1
journalists choice,0,0,1,0,0,0,0,1
journalists diving,0,0,0,0,1,0,0,1
journalists funded,1,0,0,0,0,0,0,1
journalists people,0,0,1,0,0,0,0,1
journals photos,0,1,0,0,0,0,0,1
journey begin,0,1,0,0,0,0,0,1
journey east,0,0,0,0,0,1,0,1
journey giving,1,0,0,0,0,0,0,1
journey sudan,0,1,0,0,0,0,0,1
joy makes,0,0,0,0,0,1,0,1
joy occurs,0,1,0,0,0,0,0,1
joyner founder,0,0,0,0,0,0,1,1
jpmorgan chase,0,0,0,0,0,1,0,1
jr day,0,0,0,1,0,0,0,1
jr holds,0,1,0,0,0,0,0,1
jr inspected,1,0,0,0,0,0,0,1
jr managing,0,0,0,0,1,0,0,1
jr talked,0,0,0,0,1,0,0,1
juan sanchez,0,1,0,0,0,0,0,1
juan whitney,0,0,0,1,0,0,0,1
juana mendez,0,0,0,1,0,0,0,1
juana people,0,0,0,1,0,0,0,1
juana tweeted,0,0,0,1,0,0,0,1
judge agreed,0,1,0,0,0,0,0,1
judge brandon,0,1,0,0,0,0,0,1
judge doug,0,1,0,0,0,0,0,1
judge restored,0,0,0,0,0,1,0,1
judge vacated,0,0,0,0,0,1,0,1
judge's ruling,0,1,0,0,0,0,0,1
juicy plume,0,0,0,1,0,0,0,1
julia blew,1,0,0,0,0,0,0,1
julia daniel,0,0,0,0,1,0,0,1
julian oscillation,0,0,0,1,0,0,0,1
julie kalansky,0,0,0,0,0,1,0,1
julie lesnik,0,0,0,0,0,1,0,1
julien dumoulin,0,0,1,0,0,0,0,1
julio cortez,0,0,0,0,0,1,0,1
july floods,0,1,0,0,0,0,0,1
jump started,0,0,0,0,0,0,1,1
june incident,0,1,0,0,0,0,0,1
june sekera,0,0,0,0,1,0,0,1
june similar,1,0,0,0,0,0,0,1
jungle highway,0,1,0,0,0,0,0,1
jungle officials,0,1,0,0,0,0,0,1
jungwoo chun,0,0,0,0,1,0,0,1
junior walk,1,0,0,0,0,0,0,1
juno beach,0,0,1,0,0,0,0,1
jurisdiction resume,0,0,0,0,1,0,0,1
jurors heard,0,0,0,0,1,0,0,1
jury urged,0,0,0,0,1,0,0,1
justice barry,0,0,0,1,0,0,0,1
justice director,0,0,0,0,1,0,0,1
justice facilitating,0,0,0,0,0,1,0,1
justice falsely,0,0,0,0,0,1,0,1
justice issues,0,0,0,1,0,0,0,1
justice ministers,0,0,1,0,0,0,0,1
justice movements,1,0,0,0,0,0,0,1
justice neil,0,0,0,0,0,1,0,1
justice office,0,0,0,0,0,0,1,1
justice organization,0,0,0,0,0,1,0,1
justice people,0,0,0,0,1,0,0,1
justice picture,0,0,0,0,1,0,0,1
justices samuel,0,0,0,0,0,1,0,1
justin trudeau,0,0,0,0,0,1,0,1
juvenile motivations,0,0,0,1,0,0,0,1
juxtaposing lush,0,0,0,1,0,0,0,1
kagera region,0,0,0,0,0,1,0,1
kahala'u bay,0,1,0,0,0,0,0,1
kailua kona,0,1,0,0,0,0,0,1
kaimuddin adds,0,0,0,0,1,0,0,1
kaimuddin deputy,0,0,0,0,1,0,0,1
kaimuddin's office,0,0,0,0,1,0,0,1
kalamazoo michigan,0,0,0,0,1,0,0,1
kale cucumbers,0,0,0,1,0,0,0,1
kalimantan adek,0,0,0,0,1,0,0,1
kalina dmitriew,0,0,1,0,0,0,0,1
kamala thiagarajan,0,1,0,0,0,0,0,1
kamil krzaczynski,0,0,0,0,1,0,0,1
kansas earlier,0,0,1,0,0,0,0,1
kapins gently,0,0,0,0,0,1,0,1
kaplan professor,0,1,0,0,0,0,0,1
karachi based,1,0,0,0,0,0,0,1
karachi pakistan,0,1,0,0,0,0,0,1
karen clark,1,0,0,0,0,0,0,1
karen harbert,0,0,0,0,1,0,0,1
karen misako,0,0,0,0,1,0,0,1
karen morgaine,0,0,1,0,0,0,0,1
karen sokol,0,0,0,1,0,0,0,1
kari lake,0,0,0,0,1,0,0,1
karl rove,0,0,0,0,1,0,0,1
kasegaluk lagoon,0,0,0,0,0,1,0,1
kate brown,1,0,0,0,0,0,0,1
kate concannon,0,0,1,0,0,0,0,1
katharine wilkinson,0,0,0,0,0,1,0,1
katherine garcia,0,0,0,0,1,0,0,1
kathryn sorensen,0,1,0,0,0,0,0,1
kathy ferris,0,0,0,0,1,0,0,1
kathy jetn̄il,0,1,0,0,0,0,0,1
kathy webb,0,0,0,0,1,0,0,1
katie auth,0,1,0,0,0,0,0,1
katie peikes,0,0,0,1,0,0,0,1
katrina stormwaters,0,1,0,0,0,0,0,1
katya jestin,0,0,0,0,1,0,0,1
kavanaugh appeared,0,0,0,0,0,1,0,1
kaveh guilanpour,0,1,0,0,0,0,0,1
kay hide,0,1,0,0,0,0,0,1
kaya ph,1,0,0,0,0,0,0,1
kayly ober,1,0,0,0,0,0,0,1
kazuhiro nogi,0,0,0,0,1,0,0,1
kcal tv,0,0,0,0,1,0,0,1
kcrw contacted,0,0,1,0,0,0,0,1
kcrw contributed,0,0,0,1,0,0,0,1
kcrw reports,0,0,1,0,0,0,0,1
kcrw's matt,0,0,0,0,0,1,0,1
kealah explains,0,0,0,1,0,0,0,1
kealah tells,0,0,0,1,0,0,0,1
kealah vines,0,0,0,1,0,0,0,1
keeping average,0,0,1,0,0,0,0,1
keeping global,0,0,1,0,0,0,0,1
keeping groundwater,0,0,0,0,0,1,0,1
keeping warming,0,1,0,0,0,0,0,1
keith delaplane,0,0,0,1,0,0,0,1
keith larson,0,1,0,0,0,0,0,1
keith romer,0,0,1,0,0,0,0,1
keith weakley,0,0,0,0,1,0,0,1
keli cain,0,1,0,0,0,0,0,1
kelly hogan,1,0,0,0,0,0,0,1
kelly levin,0,1,0,0,0,0,0,1
kelly talks,0,0,0,0,1,0,0,1
kelsey hudson,0,1,0,0,0,0,0,1
kelsey power,0,0,0,0,1,0,0,1
kenney insists,0,1,0,0,0,0,0,1
kenney leads,0,1,0,0,0,0,0,1
kentucky agrees,0,0,0,1,0,0,0,1
kentucky alpha,1,0,0,0,0,0,0,1
kentucky based,0,0,0,0,1,0,0,1
kentucky communities,1,0,0,0,0,0,0,1
kentucky determined,1,0,0,0,0,0,0,1
kentucky environmental,0,0,0,0,1,0,0,1
kentucky households,0,1,0,0,0,0,0,1
kentucky raised,0,1,0,0,0,0,0,1
kentucky route,0,1,0,0,0,0,0,1
kentucky style,0,1,0,0,0,0,0,1
kentucky's music,0,1,0,0,0,0,0,1
kenya pageant,0,1,0,0,0,0,0,1
kenya released,1,0,0,0,0,0,0,1
kenya senegal,0,1,0,0,0,0,0,1
kenya's daily,0,1,0,0,0,0,0,1
kenya's fertilizer,1,0,0,0,0,0,0,1
kenya's newly,1,0,0,0,0,0,0,1
kenyan embassy,0,1,0,0,0,0,0,1
kenyan government,0,1,0,0,0,0,0,1
kerala bihar,0,1,0,0,0,0,0,1
kerem yucel,1,0,0,0,0,0,0,1
kerfuffle gas,0,0,0,0,1,0,0,1
kern county,0,0,0,0,0,1,0,1
kern river,0,0,0,0,0,1,0,1
kernza flakes,0,0,1,0,0,0,0,1
kerosene heaters,0,0,0,0,1,0,0,1
kerosene space,0,0,0,1,0,0,0,1
kerry added,0,1,0,0,0,0,0,1
kerry holds,0,1,0,0,0,0,0,1
kerry u.s,0,0,0,0,1,0,0,1
kerry's press,0,1,0,0,0,0,0,1
kesler corey,0,0,1,0,0,0,0,1
ketki samel,0,0,1,0,0,0,0,1
keurig brewing,0,0,0,1,0,0,0,1
kevin conners,0,0,0,0,0,1,0,1
kevin czajkowski,0,0,0,1,0,0,0,1
kevin hagerty,1,0,0,0,0,0,0,1
kevin hanley,0,0,0,0,0,1,0,1
kevin howard,0,1,0,0,0,0,0,1
kevin mccarthy,0,0,0,1,0,0,0,1
kevin stitt,0,1,0,0,0,0,0,1
key airports,0,0,1,0,0,0,0,1
key approvals,0,1,0,0,0,0,0,1
key argument,0,0,0,0,0,1,0,1
key bedrock,0,1,0,0,0,0,0,1
key challenge,0,1,0,0,0,0,0,1
key deadlines,0,0,0,1,0,0,0,1
key difference,0,0,0,0,0,1,0,1
key discussion,0,1,0,0,0,0,0,1
key experts,0,0,0,0,0,1,0,1
key factors,0,1,0,0,0,0,0,1
key food,1,0,0,0,0,0,0,1
key goal,0,0,0,1,0,0,0,1
key inflection,0,0,1,0,0,0,0,1
key ingredient,0,0,0,0,0,1,0,1
key issue,0,1,0,0,0,0,0,1
key opportunity,0,1,0,0,0,0,0,1
key paris,0,0,0,1,0,0,0,1
key pipeline,0,0,1,0,0,0,0,1
key question,0,0,0,1,0,0,0,1
key questions,0,0,0,0,1,0,0,1
key shipping,0,1,0,0,0,0,0,1
key stakeholders,1,0,0,0,0,0,0,1
key support,0,0,0,0,0,1,0,1
key tactical,0,0,0,0,1,0,0,1
key weapons,0,0,0,1,0,0,0,1
key weather,0,0,0,0,0,0,1,1
keys pilot,0,1,0,0,0,0,0,1
keystone species,0,0,0,0,0,1,0,1
keystone xl,0,0,0,0,0,1,0,1
khan completed,0,0,0,0,1,0,0,1
khan pleads,0,0,0,0,1,0,0,1
khan's lawyers,0,0,0,0,1,0,0,1
khan's position,0,0,0,0,1,0,0,1
khanna afp,0,0,0,0,0,1,0,1
kherson newly,0,1,0,0,0,0,0,1
khon khon.when,0,1,0,0,0,0,0,1
khon khon's,0,1,0,0,0,0,0,1
kia hyundai,0,0,0,0,1,0,0,1
kick people,1,0,0,0,0,0,0,1
kid rosensweig's,0,1,0,0,0,0,0,1
kids enjoy,0,1,0,0,0,0,0,1
kids health,0,0,1,0,0,0,0,1
kids lunches,0,0,0,1,0,0,0,1
kids speaking,0,0,0,0,1,0,0,1
kijiner climate,0,1,0,0,0,0,0,1
kiki velez,0,1,0,0,0,0,0,1
kilimanjaro national,0,1,0,0,0,0,0,1
kill meat,0,1,0,0,0,0,0,1
killed keli,0,1,0,0,0,0,0,1
killed millions,0,0,0,1,0,0,0,1
killer tornado,0,0,0,0,0,1,0,1
killing dozens,0,0,0,1,0,0,0,1
kilometers east,0,1,0,0,0,0,0,1
kilometers northeast,0,1,0,0,0,0,0,1
kilometers south,0,0,0,0,0,0,1,1
kilometers southwest,0,0,0,0,0,0,1,1
kilowatt hour,0,0,0,0,1,0,0,1
kim cobb,0,0,0,1,0,0,0,1
kim damon,0,0,0,0,1,0,0,1
kim stanley,0,1,0,0,0,0,0,1
kinetic energy,0,1,0,0,0,0,0,1
king abdullah,0,1,0,0,0,0,0,1
king charles,0,1,0,0,0,0,0,1
king jr,0,0,0,1,0,0,0,1
king junior,0,1,0,0,0,0,0,1
king penguin,0,1,0,0,0,0,0,1
king reports,0,0,0,0,0,1,0,1
king spent,0,0,0,1,0,0,0,1
king willem,0,0,0,0,0,1,0,1
kingdom protesters,0,0,0,0,0,1,0,1
kinking pipelines,0,1,0,0,0,0,0,1
kircher assistant,0,0,0,0,0,0,1,1
kiribati government,0,1,0,0,0,0,0,1
kiribati government's,0,1,0,0,0,0,0,1
kirk glad,0,0,0,0,1,0,0,1
kirk hey,0,0,0,0,1,0,0,1
kirk salt,0,0,0,0,1,0,0,1
kirkham british,1,0,0,0,0,0,0,1
kirsten snow,0,0,0,0,0,0,1,1
kitchen begum,0,0,0,0,0,1,0,1
kitchen pretty,0,0,0,1,0,0,0,1
kitchen range,0,0,0,0,1,0,0,1
kitchen scaling,0,0,0,0,0,1,0,1
kitchen sink,0,0,0,0,1,0,0,1
kitchen stays,0,0,0,0,1,0,0,1
kitchen table,0,0,0,1,0,0,0,1
klaus schwab,0,0,0,0,0,1,0,1
kneel.seydu balde,0,1,0,0,0,0,0,1
knkx reports,0,0,0,0,1,0,0,1
knowledge blm,0,0,0,0,0,1,0,1
knowledge indigenous,0,0,1,0,0,0,0,1
knowledge tall,1,0,0,0,0,0,0,1
knowledgeable population,0,0,0,0,1,0,0,1
koenig web,0,0,0,0,0,0,1,1
kona hawaii,0,1,0,0,0,0,0,1
korean battery,0,0,0,0,0,1,0,1
kosong empty,0,0,0,0,1,0,0,1
kph tropical,0,1,0,0,0,0,0,1
kqed climate,0,0,0,0,1,0,0,1
kqed contributed,0,0,0,0,0,1,0,1
kqed danielle,0,0,0,1,0,0,0,1
kqed explains,0,0,0,1,0,0,0,1
kqed hide,0,0,0,0,0,1,0,1
kqed kevin,0,1,0,0,0,0,0,1
kqed's ezra,0,0,0,0,0,0,1,1
krebs executive,0,0,0,0,1,0,0,1
kreidenweis professor,1,0,0,0,0,0,0,1
kris karnauskas,0,0,1,0,0,0,0,1
kris lord,1,0,0,0,0,0,0,1
kristen thurman,0,0,0,1,0,0,0,1
kristen thurman's,0,0,0,1,0,0,0,1
kristen's husband,0,0,0,1,0,0,0,1
kristyna wentz,1,0,0,0,0,0,0,1
krzaczynski afp,0,0,0,0,1,0,0,1
kshensky arensberg,0,0,0,0,1,0,0,1
ktoo hide,0,0,0,0,0,1,0,1
kunc's alex,1,0,0,0,0,0,0,1
kunm alice,1,0,0,0,0,0,0,1
kusiong populated,1,0,0,0,0,0,0,1
kusiong village,1,0,0,0,0,0,0,1
kusiong villagers,1,0,0,0,0,0,0,1
kut hide,0,0,0,0,1,0,0,1
kwasi explains,0,0,1,0,0,0,0,1
kwasi studies,0,0,1,0,0,0,0,1
kwasi wresnford,0,0,1,0,0,0,0,1
ky hatfield,1,0,0,0,0,0,0,1
kyle center,0,0,0,0,1,0,0,1
kyle ellingson,0,0,0,0,0,1,0,1
kyrsten sinema,0,1,0,0,0,0,0,1
l'auberge des,0,1,0,0,0,0,0,1
la butte,1,0,0,0,0,0,0,1
la county,0,0,0,0,1,0,0,1
la home,0,0,1,0,0,0,0,1
la niña,0,1,0,0,0,0,0,1
la school,0,0,1,0,0,0,0,1
la waziya,0,1,0,0,0,0,0,1
la's echo,0,0,0,0,1,0,0,1
lab assuming,0,0,0,0,1,0,0,1
lab grown,0,0,1,0,0,0,0,1
lab received,0,1,0,0,0,0,0,1
lab valeti,0,1,0,0,0,0,0,1
lab workers,0,0,0,0,0,1,0,1
lab's industrial,0,0,0,1,0,0,0,1
labeling requirements,0,1,0,0,0,0,0,1
labels gas,0,0,0,0,1,0,0,1
labor department,0,0,0,0,0,1,0,1
labor intensive,0,0,0,0,0,1,0,1
labor obligations,1,0,0,0,0,0,0,1
labor party,0,1,0,0,0,0,0,1
labor shortages,1,0,0,0,0,0,0,1
labor unions,0,0,0,0,0,1,0,1
laboratory fellow,1,0,0,0,0,0,0,1
laboratory told,0,0,0,0,0,1,0,1
lacco ameno,0,1,0,0,0,0,0,1
lack access,0,0,0,0,0,1,0,1
lack adequate,0,0,0,0,0,1,0,1
lack parks,0,0,0,1,0,0,0,1
lack shade,0,0,0,1,0,0,0,1
lack thereof,0,1,0,0,0,0,0,1
laden mountains,0,0,0,1,0,0,0,1
lady jill,1,0,0,0,0,0,0,1
lag time,0,1,0,0,0,0,0,1
lagoon water,0,1,0,0,0,0,0,1
laguna de,1,0,0,0,0,0,0,1
laid waste,0,0,0,0,0,0,1,1
laird california,1,0,0,0,0,0,0,1
laist reported,0,0,0,0,1,0,0,1
lajas baseball,0,1,0,0,0,0,0,1
lajas set,0,1,0,0,0,0,0,1
lake carly,0,0,0,0,1,0,0,1
lake city's,0,0,0,0,1,0,0,1
lake completely,0,0,0,0,1,0,0,1
lake deposits,0,0,0,0,1,0,0,1
lake drying,0,0,0,0,1,0,0,1
lake kirk,0,0,0,0,1,0,0,1
lake mmm,0,0,0,0,1,0,0,1
lake multiple,0,1,0,0,0,0,0,1
lake nearby,0,1,0,0,0,0,0,1
lake okeechobee,0,1,0,0,0,0,0,1
lake people,0,0,0,0,1,0,0,1
lake placid,0,0,0,0,1,0,0,1
lake stink,0,0,0,0,1,0,0,1
lake utukok,0,0,0,0,0,1,0,1
lake valley,0,0,0,0,1,0,0,1
lake water,0,0,0,1,0,0,0,1
lake waters,1,0,0,0,0,0,0,1
lake's brine,0,0,0,0,1,0,0,1
lakes draining,0,1,0,0,0,0,0,1
lakes freezing,0,0,0,1,0,0,0,1
lamar henderson,0,1,0,0,0,0,0,1
lamas buddhist,0,1,0,0,0,0,0,1
lame duck,0,1,0,0,0,0,0,1
laments burns,0,0,0,0,0,0,1,1
lancaster warned,0,0,0,1,0,0,0,1
lance conocophillips,0,0,0,0,0,1,0,1
lance perrilloux,0,0,0,0,0,1,0,1
land attractive,0,0,0,0,1,0,0,1
land base,0,0,1,0,0,0,0,1
land carnivore,0,0,1,0,0,0,0,1
land company,1,0,0,0,0,0,0,1
land crossing,0,1,0,0,0,0,0,1
land degradation,0,1,0,0,0,0,0,1
land designation,0,0,1,0,0,0,0,1
land families,0,0,0,0,1,0,0,1
land giving,0,1,0,0,0,0,0,1
land initially,0,1,0,0,0,0,0,1
land inland,1,0,0,0,0,0,0,1
land living,1,0,0,0,0,0,0,1
land managed,0,0,0,0,0,1,0,1
land owners,1,0,0,0,0,0,0,1
land planes,0,1,0,0,0,0,0,1
land practices,0,0,0,0,1,0,0,1
land rights,0,0,0,0,0,0,1,1
land schaeffer,0,0,1,0,0,0,0,1
land subsidence,0,0,0,0,1,0,0,1
landfall estimated,0,1,0,0,0,0,0,1
landfall rebecca,1,0,0,0,0,0,0,1
landfalling hurricanes,0,1,0,0,0,0,0,1
landfill carpenter,1,0,0,0,0,0,0,1
landfill polluted,0,1,0,0,0,0,0,1
landfill similarly,1,0,0,0,0,0,0,1
landfilled someplace,1,0,0,0,0,0,0,1
landfills means,0,1,0,0,0,0,0,1
landing site,0,0,0,0,0,0,1,1
landmark groundwater,0,0,0,0,1,0,0,1
landmark pact,0,1,0,0,0,0,0,1
landmark pier,1,0,0,0,0,0,0,1
landmark provisions,0,1,0,0,0,0,0,1
landowners describe,0,0,1,0,0,0,0,1
landowners unfairly,0,0,0,0,1,0,0,1
lands include,0,0,0,0,1,0,0,1
lands similar,0,0,1,0,0,0,0,1
lands underneath,1,0,0,0,0,0,0,1
landscape forested,1,0,0,0,0,0,0,1
landscape horticulture,1,0,0,0,0,0,0,1
landscape intact,1,0,0,0,0,0,0,1
landscape pancakes,0,1,0,0,0,0,0,1
landslide marten,0,0,0,1,0,0,0,1
landslides remained,0,1,0,0,0,0,0,1
lane deeper,0,1,0,0,0,0,0,1
lane highway,0,0,0,0,1,0,0,1
langston hughes,0,1,0,0,0,0,0,1
language carries,0,0,0,1,0,0,0,1
language dies,0,0,0,1,0,0,0,1
language loss,0,0,0,1,0,0,0,1
language mankani,1,0,0,0,0,0,0,1
language training,0,1,0,0,0,0,0,1
languages djawou,1,0,0,0,0,0,0,1
languages karen,0,0,0,1,0,0,0,1
languages spoken,0,0,0,1,0,0,0,1
lankford introduced,0,1,0,0,0,0,0,1
lantrip ap,0,0,0,0,0,0,1,1
lapresse news,0,1,0,0,0,0,0,1
larger carbon,0,1,0,0,0,0,0,1
larger cities,0,0,0,0,0,1,0,1
larger community,1,0,0,0,0,0,0,1
larger companies,0,0,0,1,0,0,0,1
larger conversation,1,0,0,0,0,0,0,1
larger discussions,0,0,1,0,0,0,0,1
larger donations,0,1,0,0,0,0,0,1
larger event,1,0,0,0,0,0,0,1
larger federal,1,0,0,0,0,0,0,1
larger geography,0,1,0,0,0,0,0,1
larger impact,0,1,0,0,0,0,0,1
larger landscape,1,0,0,0,0,0,0,1
larger measures,0,1,0,0,0,0,0,1
larger pledge,0,1,0,0,0,0,0,1
larger power,0,0,0,1,0,0,0,1
larger society,0,0,0,0,1,0,0,1
larger storms,0,0,0,0,0,0,1,1
larger trend,0,0,0,0,0,1,0,1
larger trends,0,0,0,1,0,0,0,1
largest agricultural,0,0,0,0,0,1,0,1
largest barrier,1,0,0,0,0,0,0,1
largest car,0,0,0,0,0,1,0,1
largest cumulative,0,1,0,0,0,0,0,1
largest ecological,0,0,0,1,0,0,0,1
largest economies,0,1,0,0,0,0,0,1
largest energy,0,0,0,0,1,0,0,1
largest export,0,0,0,0,0,1,0,1
largest exporter,0,0,0,0,1,0,0,1
largest fires,0,0,0,1,0,0,0,1
largest gas,0,1,0,0,0,0,0,1
largest historic,0,1,0,0,0,0,0,1
largest hydroelectric,0,1,0,0,0,0,0,1
largest ice,0,1,0,0,0,0,0,1
largest industrial,0,1,0,0,0,0,0,1
largest manufacturing,0,0,0,0,0,1,0,1
largest producer,0,1,0,0,0,0,0,1
largest project,0,0,0,0,1,0,0,1
largest reservoirs,0,0,0,1,0,0,0,1
largest shareholder,0,0,0,0,1,0,0,1
largest solar,0,1,0,0,0,0,0,1
largest source,0,1,0,0,0,0,0,1
largest undisturbed,0,0,0,0,0,1,0,1
larry gurrola,0,0,0,1,0,0,0,1
larry hogan,1,0,0,0,0,0,0,1
larsen director,0,1,0,0,0,0,0,1
larson walks,0,1,0,0,0,0,0,1
larva leila,0,0,0,0,1,0,0,1
larva samples,0,0,0,0,1,0,0,1
lashof director,0,1,0,0,0,0,0,1
lasting economic,0,0,0,0,0,1,0,1
lasting fix,0,0,0,0,1,0,0,1
lasting implications,0,1,0,0,0,0,0,1
late 19th,0,1,0,0,0,0,0,1
late 20th,0,0,0,1,0,0,0,1
late 21st,0,0,0,0,0,1,0,1
late afternoon,1,0,0,0,0,0,0,1
late august,1,0,0,0,0,0,0,1
late fall,0,0,0,0,0,1,0,1
late father,0,0,0,1,0,0,0,1
late february,0,0,0,0,1,0,0,1
late frost,0,0,0,0,0,1,0,1
late july,1,0,0,0,0,0,0,1
late morning,0,1,0,0,0,0,0,1
late october,0,1,0,0,0,0,0,1
late pipes,0,0,0,1,0,0,0,1
late september,0,1,0,0,0,0,0,1
late wednesday,0,1,0,0,0,0,0,1
latin america,0,0,0,0,1,0,0,1
latin american,0,0,0,0,0,1,0,1
latin hebrew,0,1,0,0,0,0,0,1
latur earthquake,0,1,0,0,0,0,0,1
laughlin infrastructure,0,0,0,1,0,0,0,1
laughter crazy,0,1,0,0,0,0,0,1
laughter fried,0,0,0,0,1,0,0,1
laughter rebecca,0,0,0,0,0,1,0,1
laughter yeah,1,0,0,0,0,0,0,1
launch balloons,0,0,0,0,1,0,0,1
launch sites,0,0,0,0,1,0,0,1
launched citizens,0,0,0,0,1,0,0,1
launched tuesday,0,0,0,0,0,1,0,1
launches led,0,0,0,0,1,0,0,1
laura ingraham,0,0,0,0,0,1,0,1
laura lightbody,1,0,0,0,0,0,0,1
lauren herzer,0,0,0,0,0,1,0,1
lauren migaki,0,0,0,1,0,0,0,1
lauren sanchez,0,1,0,0,0,0,0,1
lauren spoke,0,0,0,0,0,1,0,1
lauren williams,0,0,0,0,0,0,1,1
laurent gillieron,0,0,0,1,0,0,0,1
lava rock,0,0,0,0,1,0,0,1
lavender jacket,0,0,0,1,0,0,0,1
law bought,1,0,0,0,0,0,0,1
law breaking,0,0,0,1,0,0,0,1
law doug,0,0,0,0,1,0,0,1
law funding,0,0,0,1,0,0,0,1
law includes,0,0,0,0,0,1,0,1
law intended,0,0,0,0,0,1,0,1
law passed,0,0,0,1,0,0,0,1
law principles,0,0,0,0,0,1,0,1
law rolling,0,0,0,1,0,0,0,1
law school,0,0,0,0,0,1,0,1
law volkswagen,0,0,0,0,0,1,0,1
lawmakers expect,0,0,0,0,1,0,0,1
lawmakers labor,0,0,0,0,0,1,0,1
lawmakers passed,0,0,0,0,0,0,1,1
lawmakers quickly,1,0,0,0,0,0,0,1
lawmakers unions,0,0,0,0,0,1,0,1
lawmakers unveiled,0,0,0,0,1,0,0,1
lawn mover,1,0,0,0,0,0,0,1
lawn removal,0,0,0,0,1,0,0,1
lawrence ap,0,0,0,0,1,0,0,1
laws apply,0,1,0,0,0,0,0,1
laws change,0,0,0,0,1,0,0,1
laws represent,0,0,0,0,0,0,1,1
laws solar,0,0,0,0,1,0,0,1
lawsuit alleges,0,0,1,0,0,0,0,1
lawsuits brought,0,0,0,1,0,0,0,1
lawsuits nationwide,0,0,0,1,0,0,0,1
lawyer antonia,1,0,0,0,0,0,0,1
lawyer named,0,0,0,0,1,0,0,1
lawyer replied,0,0,0,0,0,1,0,1
lawyers found,0,0,0,1,0,0,0,1
lax growth,1,0,0,0,0,0,0,1
lay down.that's,1,0,0,0,0,0,0,1
lay underneath,1,0,0,0,0,0,0,1
layers deep,0,1,0,0,0,0,0,1
layman's terms,0,0,0,0,0,0,1,1
leach material,0,0,0,0,1,0,0,1
lead international,0,0,0,0,0,1,0,1
lead levels,0,0,1,0,0,0,0,1
lead negotiator,0,1,0,0,0,0,0,1
lead peace,0,0,0,1,0,0,0,1
lead time,0,1,0,0,0,0,0,1
leader oregonians,1,0,0,0,0,0,0,1
leader ryan,0,1,0,0,0,0,0,1
leader sheikh,0,0,0,1,0,0,0,1
leader xi,0,1,0,0,0,0,0,1
leaders agree,0,0,0,0,0,1,0,1
leaders announced,0,0,0,0,1,0,0,1
leaders decide,0,1,0,0,0,0,0,1
leaders diplomats,0,1,0,0,0,0,0,1
leaders gather,0,1,0,0,0,0,0,1
leaders meet,0,1,0,0,0,0,0,1
leaders recently,0,0,0,0,1,0,0,1
leaders students,0,1,0,0,0,0,0,1
leaders talk,0,1,0,0,0,0,0,1
leaders voiced,0,1,0,0,0,0,0,1
leadership role,0,1,0,0,0,0,0,1
leading gop,0,0,0,0,1,0,0,1
leading mwenja,1,0,0,0,0,0,0,1
leading negotiations,0,0,0,0,1,0,0,1
leading prominent,0,0,0,0,0,1,0,1
leading scientists,0,0,1,0,0,0,0,1
leading source,0,1,0,0,0,0,0,1
leads abu,0,0,0,1,0,0,0,1
leads people,1,0,0,0,0,0,0,1
leads xcel,0,1,0,0,0,0,0,1
leaf fig,0,1,0,0,0,0,0,1
leafy green,0,0,0,0,0,1,0,1
leafy trees,0,0,0,1,0,0,0,1
leah missik,0,0,0,0,1,0,0,1
leak drilling,1,0,0,0,0,0,0,1
leak methane,0,0,0,1,0,0,0,1
leaks happened,0,0,0,1,0,0,0,1
leaks methane,0,0,0,1,0,0,0,1
leaky roof,0,1,0,0,0,0,0,1
leaning nonprofit,0,0,0,0,1,0,0,1
lear center,0,0,1,0,0,0,0,1
learn adjust,0,0,0,1,0,0,0,1
learn baseball,0,1,0,0,0,0,0,1
learn team,0,1,0,0,0,0,0,1
learning rare,0,1,0,0,0,0,0,1
leautier ceo,0,1,0,0,0,0,0,1
leave flooded,1,0,0,0,0,0,0,1
leave guantanamo,0,0,0,0,1,0,0,1
leave page,0,1,0,0,0,0,0,1
leave south,0,1,0,0,0,0,0,1
leave sudan,0,1,0,0,0,0,0,1
leave water,0,0,0,0,1,0,0,1
leaves barton,1,0,0,0,0,0,0,1
leaves brown,0,0,0,1,0,0,0,1
leaves millions,0,1,0,0,0,0,0,1
leaving eastern,0,1,0,0,0,0,0,1
leaving homes,0,1,0,0,0,0,0,1
leaving money,0,0,0,0,1,0,0,1
leaving office,0,0,0,1,0,0,0,1
leclerc analysts,0,0,0,1,0,0,0,1
led efforts,0,1,0,0,0,0,0,1
led movement,0,1,0,0,0,0,0,1
led projects,1,0,0,0,0,0,0,1
lee drove,0,0,0,0,0,0,1,1
lee gelernt,0,0,1,0,0,0,0,1
lee hale,0,0,0,0,1,0,0,1
lee hampton,0,0,0,0,0,1,0,1
lee zimmerman,0,1,0,0,0,0,0,1
leflore counties,0,1,0,0,0,0,0,1
left behind.so,0,0,0,0,1,0,0,1
left eastern,1,0,0,0,0,0,0,1
left holding,0,0,0,0,1,0,0,1
left home,0,1,0,0,0,0,0,1
left homeless,0,1,0,0,0,0,0,1
left hundreds,0,0,0,0,0,1,0,1
left intact,0,1,0,0,0,0,0,1
left labor,0,1,0,0,0,0,0,1
left leaning,1,0,0,0,0,0,0,1
left limit,0,0,0,0,0,1,0,1
left matrix,0,0,1,0,0,0,0,1
left standing,0,1,0,0,0,0,0,1
left stranded,1,0,0,0,0,0,0,1
left substantial,0,0,0,0,0,1,0,1
left thousands,1,0,0,0,0,0,0,1
left waiting,0,0,0,0,1,0,0,1
left wing,0,0,0,0,0,1,0,1
left yeah,0,0,0,0,1,0,0,1
leftist national,0,1,0,0,0,0,0,1
legal agreement,0,0,0,1,0,0,0,1
legal authority,1,0,0,0,0,0,0,1
legal battles,0,0,0,1,0,0,0,1
legal efforts,0,0,0,0,0,1,0,1
legal expert,0,0,1,0,0,0,0,1
legal fiduciary,0,0,1,0,0,0,0,1
legal grounds,0,0,0,0,1,0,0,1
legal pathways.what,0,1,0,0,0,0,0,1
legally apply,0,1,0,0,0,0,0,1
legend jean,0,1,0,0,0,0,0,1
leger fernandez,1,0,0,0,0,0,0,1
legislation establishes,0,0,0,0,1,0,0,1
legislation julia,0,0,0,0,0,0,1,1
legislation offers,0,0,0,0,0,0,1,1
legislation passed,0,0,0,1,0,0,0,1
legislation sales,0,0,0,0,0,0,1,1
legislative exchange,0,0,0,0,1,0,0,1
legislative leaders,0,1,0,0,0,0,0,1
legislative power,1,0,0,0,0,0,0,1
legislative records,1,0,0,0,0,0,0,1
legislators typically,0,0,0,0,1,0,0,1
legislature failed,0,0,0,0,1,0,0,1
legislature led,1,0,0,0,0,0,0,1
legislature realized,1,0,0,0,0,0,0,1
legitimate concerns,0,0,0,0,1,0,0,1
lemon rhome,0,1,0,0,0,0,0,1
lemos executive,0,0,0,0,1,0,0,1
lent urgency,0,0,0,0,0,1,0,1
leonard leo,0,0,0,0,1,0,0,1
leonardo munoz,0,0,0,0,1,0,0,1
leone billy,0,0,1,0,0,0,0,1
leonid polyakov,0,0,0,1,0,0,0,1
leopard 2s,0,0,0,1,0,0,0,1
lessen snow,0,0,0,1,0,0,0,1
lessened vegetation,0,0,0,1,0,0,0,1
letcher counties,0,1,0,0,0,0,0,1
letcher county,0,1,0,0,0,0,0,1
lethal storms,0,0,0,0,0,1,0,1
letter writing,0,0,0,0,0,1,0,1
letters received,0,0,1,0,0,0,0,1
lettuce fields,0,1,0,0,0,0,0,1
lettuce jennifer,0,0,0,0,0,1,0,1
lettuce parsley,0,0,0,0,0,1,0,1
letvin fema's,1,0,0,0,0,0,0,1
levee break,0,0,0,0,0,1,0,1
levee failed,0,0,0,0,0,0,1,1
levee failures,0,0,0,0,0,0,1,1
levee setbacks,1,0,0,0,0,0,0,1
levee suffered,1,0,0,0,0,0,0,1
levees canals,0,1,0,0,0,0,0,1
levees flooding,0,1,0,0,0,0,0,1
levees killing,0,1,0,0,0,0,0,1
levees stopped,0,0,0,0,0,1,0,1
level attention,0,0,1,0,0,0,0,1
level communities,0,1,0,0,0,0,0,1
level data,0,0,0,1,0,0,0,1
level drop,0,1,0,0,0,0,0,1
level drops,0,1,0,0,0,0,0,1
level helping,0,1,0,0,0,0,0,1
level makes,0,0,0,0,1,0,0,1
level organizer,0,0,0,0,1,0,0,1
level rises,0,0,0,0,0,1,0,1
level ryan,0,1,0,0,0,0,0,1
level temperatures,0,0,0,1,0,0,0,1
level winds,0,1,0,0,0,0,0,1
levels davis,0,0,0,0,1,0,0,1
levels energy,0,1,0,0,0,0,0,1
levels oberle,0,1,0,0,0,0,0,1
levels remained,0,1,0,0,0,0,0,1
levels sienna,0,0,0,0,0,0,1,1
levels stiles,0,1,0,0,0,0,0,1
levels upwards,0,0,0,0,1,0,0,1
levels venezuelans,0,0,1,0,0,0,0,1
leveraging voluntary,0,1,0,0,0,0,0,1
levine nathan,0,1,0,0,0,0,0,1
lewin president,0,0,0,0,1,0,0,1
lexington born,0,1,0,0,0,0,0,1
lg energy,0,0,0,0,0,1,0,1
lgbtq community,1,0,0,0,0,0,0,1
lges announced,0,0,0,0,0,1,0,1
li qing,0,0,0,1,0,0,0,1
liability company,0,0,1,0,0,0,0,1
liability insurance,0,0,0,1,0,0,0,1
liam castles,0,1,0,0,0,0,0,1
liane randolph,0,1,0,0,0,0,0,1
liberal activism,0,1,0,0,0,0,0,1
liberal positions,0,0,0,1,0,0,0,1
liberia sprinkles,0,0,0,1,0,0,0,1
librarian wisconsin,0,0,0,0,1,0,0,1
libya niger,0,1,0,0,0,0,0,1
libyan prisons,0,1,0,0,0,0,0,1
license earlier,0,0,0,1,0,0,0,1
license plates,0,1,0,0,0,0,0,1
lidar pulsed,0,0,0,1,0,0,0,1
lies north,0,0,0,0,1,0,0,1
liesbeth roolvink,0,0,0,0,1,0,0,1
lieutenant phillip,0,1,0,0,0,0,0,1
life amadou,1,0,0,0,0,0,0,1
life cycle,1,0,0,0,0,0,0,1
life difficult,1,0,0,0,0,0,0,1
life elizabeth,0,0,1,0,0,0,0,1
life expectancy,0,1,0,0,0,0,0,1
life experience,0,0,0,0,0,1,0,1
life flooding,0,0,0,0,0,1,0,1
life lying,1,0,0,0,0,0,0,1
life morally,0,0,0,0,1,0,0,1
life people,0,0,0,0,0,1,0,1
life rebuilding,0,0,0,0,0,1,0,1
life saving,1,0,0,0,0,0,0,1
life supporting,0,1,0,0,0,0,0,1
life thankfully,0,0,0,1,0,0,0,1
life threatening,1,0,0,0,0,0,0,1
life tough,1,0,0,0,0,0,0,1
life wilkinson,0,0,0,0,0,1,0,1
life worth,0,0,0,0,1,0,0,1
lifelong love,0,1,0,0,0,0,0,1
lifestyle choices,0,0,0,1,0,0,0,1
lifestyle day,0,0,0,0,1,0,0,1
lift millions,0,1,0,0,0,0,0,1
lift particles,1,0,0,0,0,0,0,1
lifted mandatory,0,0,0,0,0,1,0,1
light battle,0,0,0,1,0,0,0,1
light bob,0,0,1,0,0,0,0,1
light body,1,0,0,0,0,0,0,1
light brown,1,0,0,0,0,0,0,1
light carlos,0,1,0,0,0,0,0,1
light ceo,0,0,1,0,0,0,0,1
light dictated,0,0,1,0,0,0,0,1
light documents,0,0,1,0,0,0,0,1
light florida,0,0,1,0,0,0,0,1
light paid,0,0,1,0,0,0,0,1
light pollution,0,1,0,0,0,0,0,1
light post,0,1,0,0,0,0,0,1
light posts,0,1,0,0,0,0,0,1
light skinned,0,0,0,0,1,0,0,1
light wrote,0,0,1,0,0,0,0,1
light's business,0,0,1,0,0,0,0,1
lightbody project,1,0,0,0,0,0,0,1
lighting system's,0,1,0,0,0,0,0,1
lightly edited,0,0,0,0,1,0,0,1
lightning flashes,0,0,0,1,0,0,0,1
lightning operates,0,0,1,0,0,0,0,1
lightning research,0,0,1,0,0,0,0,1
lightning speed,1,0,0,0,0,0,0,1
lightning strike,0,0,1,0,0,0,0,1
lightning strikes,0,0,0,0,1,0,0,1
lights casting,0,0,0,1,0,0,0,1
lights running,0,0,0,0,1,0,0,1
likely.now la,0,0,0,0,0,0,1,1
limit carbon,1,0,0,0,0,0,0,1
limit climate,0,0,1,0,0,0,0,1
limit drilling,0,0,0,0,0,1,0,1
limit due,0,0,1,0,0,0,0,1
limit future,0,1,0,0,0,0,0,1
limit gas,0,0,0,1,0,0,0,1
limit hurricane,0,1,0,0,0,0,0,1
limit nitrogen,0,0,0,1,0,0,0,1
limit npr,0,0,0,0,1,0,0,1
limit renewable,0,0,0,0,1,0,0,1
limited amounts,0,0,0,1,0,0,0,1
limited catl,0,1,0,0,0,0,0,1
limited cellphone,1,0,0,0,0,0,0,1
limited demonstrators,0,1,0,0,0,0,0,1
limited funding,0,0,0,0,0,1,0,1
limited government,1,0,0,0,0,0,0,1
limited levers,1,0,0,0,0,0,0,1
limited liability,0,0,1,0,0,0,0,1
limited outdoor,0,0,0,0,0,1,0,1
limited public,0,1,0,0,0,0,0,1
limited reads,0,0,0,0,0,1,0,1
limited tools,1,0,0,0,0,0,0,1
limiting drilling,0,0,0,0,0,1,0,1
limiting global,0,0,0,0,1,0,0,1
limiting mechanisms,0,0,0,0,0,1,0,1
limits blasting,0,1,0,0,0,0,0,1
limits yeah,0,0,0,1,0,0,0,1
lin allowed,0,1,0,0,0,0,0,1
lin wore,0,1,0,0,0,0,0,1
lin's desire,0,1,0,0,0,0,0,1
lin's life,0,1,0,0,0,0,0,1
lin's lifelong,0,1,0,0,0,0,0,1
lin's multi,0,1,0,0,0,0,0,1
lin's vivid,0,1,0,0,0,0,0,1
lincoln neb,0,0,0,0,0,1,0,1
lincoln nebraska,0,0,0,0,0,0,1,1
line running,0,0,0,0,1,0,0,1
line science,0,0,0,1,0,0,0,1
line upgrades,0,0,0,1,0,0,0,1
lined bay,1,0,0,0,0,0,0,1
lines alan,0,1,0,0,0,0,0,1
lines critics,0,0,1,0,0,0,0,1
lines equivalent,0,0,0,0,1,0,0,1
lines formed,0,1,0,0,0,0,0,1
lines kaplan,0,1,0,0,0,0,0,1
lingering impacts,0,0,0,0,0,1,0,1
linguistic communities,0,0,0,1,0,0,0,1
linguists call,0,0,0,1,0,0,0,1
link climate,0,1,0,0,0,0,0,1
link fences,0,0,0,1,0,0,0,1
linked directly,0,0,0,0,1,0,0,1
linking climate,0,0,1,0,0,0,0,1
linking extreme,0,1,0,0,0,0,0,1
links apple,0,0,1,0,0,0,0,1
links blacktop,0,0,0,1,0,0,0,1
lion population,0,0,1,0,0,0,0,1
lions gained,0,0,1,0,0,0,0,1
lippitt afp,0,0,0,0,1,0,0,1
lips located,0,0,0,0,0,1,0,1
lips produce,0,0,0,0,0,1,0,1
liquified petroleum,0,1,0,0,0,0,0,1
lisa graves,0,0,0,0,1,0,0,1
lisa lambert,0,0,1,0,0,0,0,1
lisa lisker,0,0,0,0,1,0,0,1
lisa mabbutt,0,1,0,0,0,0,0,1
lisa ramsden,1,0,0,0,0,0,0,1
lisker lisker,0,0,0,0,1,0,0,1
list city,0,0,0,0,1,0,0,1
list item,0,0,0,0,1,0,0,1
list regions,0,0,0,0,0,1,0,1
listing plibersek,0,1,0,0,0,0,0,1
listing reflects,1,0,0,0,0,0,0,1
lists beating,0,0,0,0,0,1,0,1
lists biodiversity,0,0,1,0,0,0,0,1
literal waves,0,0,0,1,0,0,0,1
literally affect,0,1,0,0,0,0,0,1
literally beat,0,1,0,0,0,0,0,1
literally impossible,0,0,0,0,0,1,0,1
literally life,1,0,0,0,0,0,0,1
literally means,1,0,0,0,0,0,0,1
literally moving,0,1,0,0,0,0,0,1
literally water,1,0,0,0,0,0,0,1
lithium ceo,0,1,0,0,0,0,0,1
lithium david,0,1,0,0,0,0,0,1
lithium dedicated,0,1,0,0,0,0,0,1
lithium deposits,0,1,0,0,0,0,0,1
lithium hydroxide,0,1,0,0,0,0,0,1
lithium mines,0,1,0,0,0,0,0,1
lithium ore,0,1,0,0,0,0,0,1
lithium processing,0,1,0,0,0,0,0,1
lithium raw,0,1,0,0,0,0,0,1
lithium's ceo,0,1,0,0,0,0,0,1
lithium's efforts,0,1,0,0,0,0,0,1
litigation involving,0,0,1,0,0,0,0,1
litmus test,0,1,0,0,0,0,0,1
litmus tests,0,1,0,0,0,0,0,1
littered items,0,0,0,1,0,0,0,1
livable climate,0,0,0,0,1,0,0,1
live crickets,0,0,0,0,0,1,0,1
live downstream,0,0,0,1,0,0,0,1
live hill,0,1,0,0,0,0,0,1
live hunt,0,0,1,0,0,0,0,1
live oysters,1,0,0,0,0,0,0,1
live possibly,1,0,0,0,0,0,0,1
lived arctic,0,0,0,0,1,0,0,1
lived signs,0,1,0,0,0,0,0,1
lived upstairs,0,0,0,0,0,0,1,1
livelihoods losing,0,1,0,0,0,0,0,1
lives fires,0,0,0,0,1,0,0,1
lives germany,0,0,1,0,0,0,0,1
lives johnsen,0,0,0,1,0,0,0,1
lives nearby,0,0,1,0,0,0,0,1
lives obliteration,0,0,0,0,1,0,0,1
lives valeti,0,1,0,0,0,0,0,1
livestock rice,1,0,0,0,0,0,0,1
living conditions,0,0,0,0,1,0,0,1
living disaster,0,1,0,0,0,0,0,1
living nearby,0,0,1,0,0,0,0,1
living organism,0,0,0,0,0,1,0,1
living organisms,0,0,1,0,0,0,0,1
living primarily,0,0,0,0,0,1,0,1
living raising,0,0,0,0,1,0,0,1
living shorelines,1,0,0,0,0,0,0,1
living species,0,0,1,0,0,0,0,1
livingston jr,0,0,0,0,0,0,1,1
liz elliott,0,0,1,0,0,0,0,1
lng deal,0,0,1,0,0,0,0,1
loaded world,0,1,0,0,0,0,0,1
loans grants,0,0,0,0,1,0,0,1
lobbing paper,1,0,0,0,0,0,0,1
lobbying activities,0,1,0,0,0,0,0,1
lobbying campaign,0,0,1,0,0,0,0,1
lobbying documents,0,0,1,0,0,0,0,1
lobbying efforts,0,0,1,0,0,0,0,1
lobbyist jack,0,0,0,0,1,0,0,1
local action,0,1,0,0,0,0,0,1
local activists,0,0,0,0,1,0,0,1
local adaptation,0,1,0,0,0,0,0,1
local affairs,0,0,0,0,1,0,0,1
local air,0,0,1,0,0,0,0,1
local artisans,0,1,0,0,0,0,0,1
local arts,0,1,0,0,0,0,0,1
local authorities,0,1,0,0,0,0,0,1
local ballot,0,1,0,0,0,0,0,1
local bands,0,1,0,0,0,0,0,1
local builder,0,1,0,0,0,0,0,1
local businesses,0,1,0,0,0,0,0,1
local caribou,0,0,0,0,0,1,0,1
local charity,1,0,0,0,0,0,0,1
local chief,0,1,0,0,0,0,0,1
local college,1,0,0,0,0,0,0,1
local community,1,0,0,0,0,0,0,1
local concerns,0,0,0,0,1,0,0,1
local conditions,0,0,0,0,0,0,1,1
local conflicts,0,0,0,1,0,0,0,1
local control,1,0,0,0,0,0,0,1
local damages,0,0,0,0,1,0,0,1
local dangers,0,1,0,0,0,0,0,1
local drought,0,0,0,0,0,1,0,1
local economy,0,0,0,0,1,0,0,1
local ecosystems,0,0,0,0,1,0,0,1
local electric,0,1,0,0,0,0,0,1
local emergencies,0,0,0,0,0,1,0,1
local emergency,0,1,0,0,0,0,0,1
local entities,0,1,0,0,0,0,0,1
local entrepreneurs,1,0,0,0,0,0,0,1
local environmental,0,0,0,1,0,0,0,1
local faa,0,0,0,0,1,0,0,1
local families,0,0,0,0,1,0,0,1
local farmer,1,0,0,0,0,0,0,1
local fauna,0,0,0,0,0,1,0,1
local fishermen,1,0,0,0,0,0,0,1
local flooding,1,0,0,0,0,0,0,1
local forests,0,1,0,0,0,0,0,1
local humpbacks,0,0,0,0,1,0,0,1
local journalism,0,0,0,0,1,0,0,1
local knowledge,0,0,0,1,0,0,0,1
local language,1,0,0,0,0,0,0,1
local lawyer,1,0,0,0,0,0,0,1
local leaders,1,0,0,0,0,0,0,1
local legend,0,0,1,0,0,0,0,1
local markets,0,0,0,0,1,0,0,1
local mine,0,0,0,0,1,0,0,1
local mountain,0,0,1,0,0,0,0,1
local musical,0,1,0,0,0,0,0,1
local nepalese,0,1,0,0,0,0,0,1
local newspaper,0,0,1,0,0,0,0,1
local nonprofit,1,0,0,0,0,0,0,1
local nws,0,0,0,0,1,0,0,1
local offices,0,1,0,0,0,0,0,1
local organizations,0,1,0,0,0,0,0,1
local park,1,0,0,0,0,0,0,1
local political,0,1,0,0,0,0,0,1
local politicians,0,0,0,0,1,0,0,1
local politics,0,0,0,0,1,0,0,1
local population,0,0,1,0,0,0,0,1
local priest,0,0,1,0,0,0,0,1
local pushback,0,0,0,0,1,0,0,1
local rainfall,0,0,0,0,0,0,1,1
local rancher,0,0,0,0,1,0,0,1
local ranchers,0,0,0,0,1,0,0,1
local recovery,0,0,0,1,0,0,0,1
local regulators,0,0,0,0,1,0,0,1
local reluctance,1,0,0,0,0,0,0,1
local river,0,0,0,0,0,1,0,1
local sheriff's,0,0,0,0,1,0,0,1
local skies,0,0,0,0,0,1,0,1
local social,1,0,0,0,0,0,0,1
local solutions,1,0,0,0,0,0,0,1
local students,0,1,0,0,0,0,0,1
local study,0,0,1,0,0,0,0,1
local supply,0,0,0,0,0,1,0,1
local taxes,0,0,0,0,1,0,0,1
local tesco,0,0,0,0,0,1,0,1
local time,0,0,0,0,0,1,0,1
local tourism,0,0,0,0,1,0,0,1
local trout,1,0,0,0,0,0,0,1
local universities,0,1,0,0,0,0,0,1
local utility,1,0,0,0,0,0,0,1
local water,0,0,0,1,0,0,0,1
local weather,0,0,0,1,0,0,0,1
local wildlife,0,0,0,0,0,1,0,1
local women,0,1,0,0,0,0,0,1
localized flooding,0,0,0,1,0,0,0,1
localized forecasts,0,0,0,1,0,0,0,1
locally led,1,0,0,0,0,0,0,1
locally mined,0,0,0,0,0,1,0,1
locals eventually,0,0,0,0,1,0,0,1
locals translate,0,0,0,1,0,0,0,1
located declared,0,1,0,0,0,0,0,1
located inside,0,0,0,0,0,1,0,1
locations hundreds,0,0,0,0,0,1,0,1
loch ness,1,0,0,0,0,0,0,1
lock hold,0,0,0,1,0,0,0,1
locke bell,0,1,0,0,0,0,0,1
locomotive engine,0,0,0,1,0,0,0,1
loeb afp,1,0,0,0,0,0,0,1
logging loggers,0,0,0,1,0,0,0,1
logistical challenge,0,0,0,1,0,0,0,1
logistically removed,0,0,1,0,0,0,0,1
london's national,0,1,0,0,0,0,0,1
lone emperor,0,1,0,0,0,0,0,1
lonely residence,0,0,1,0,0,0,0,1
longari afp,1,0,0,0,0,0,0,1
longer.for npr,0,1,0,0,0,0,0,1
longstanding authority,0,0,0,0,0,1,0,1
longstanding challenges,0,1,0,0,0,0,0,1
longstanding frustration,1,0,0,0,0,0,0,1
longstanding pledge,0,1,0,0,0,0,0,1
longtime activist,0,0,0,0,1,0,0,1
longtime climate,0,0,0,1,0,0,0,1
longtime concerns,1,0,0,0,0,0,0,1
longtime critics,0,0,0,0,1,0,0,1
longtime political,0,0,0,0,1,0,0,1
longtime tornado,0,0,0,0,0,1,0,1
looked shocked,0,1,0,0,0,0,0,1
loom nearby,1,0,0,0,0,0,0,1
looming disaster,0,0,0,0,1,0,0,1
looming ecological,0,0,0,0,1,0,0,1
looming food,1,0,0,0,0,0,0,1
loopholes wide,0,1,0,0,0,0,0,1
loose couplings,0,0,0,1,0,0,0,1
loose rocks,0,0,0,1,0,0,0,1
loosely modeled,1,0,0,0,0,0,0,1
lopez restrepo,0,1,0,0,0,0,0,1
lopez walks,0,0,0,0,1,0,0,1
lord flickr,1,0,0,0,0,0,0,1
lorenzo river,0,0,0,1,0,0,0,1
lori stewart,1,0,0,0,0,0,0,1
los alamos,1,0,0,0,0,0,0,1
los alerces,0,1,0,0,0,0,0,1
lose carbon,0,1,0,0,0,0,0,1
lose congress,0,1,0,0,0,0,0,1
lose games,0,0,0,0,1,0,0,1
lose half,1,0,0,0,0,0,0,1
lose hope,0,0,0,0,0,1,0,1
lose rebecca,0,0,0,0,0,1,0,1
lose sensibility,1,0,0,0,0,0,0,1
lose virtually,0,0,0,1,0,0,0,1
loses money,0,0,0,0,0,1,0,1
losing homes,0,1,0,0,0,0,0,1
losing money,0,0,0,0,0,1,0,1
losing power,0,1,0,0,0,0,0,1
losing reefs,0,1,0,0,0,0,0,1
losing time,0,1,0,0,0,0,0,1
losing traction,0,0,0,0,1,0,0,1
losing trees,0,0,0,0,0,0,1,1
losing whitebark,0,0,0,0,0,1,0,1
loss crisis,1,0,0,0,0,0,0,1
loss delirium,0,0,0,0,0,1,0,1
loss due,0,0,0,1,0,0,0,1
loss observed,0,0,0,0,0,0,1,1
loss ocean,1,0,0,0,0,0,0,1
loss pollution,0,0,1,0,0,0,0,1
loss smith,0,0,0,0,0,0,1,1
losses topped,0,0,0,0,1,0,0,1
lost crops,0,0,0,0,1,0,0,1
lost homes,0,0,0,1,0,0,0,1
lost hope,0,1,0,0,0,0,0,1
lost property,0,0,0,1,0,0,0,1
lost sarah,0,1,0,0,0,0,0,1
lost sight,0,0,1,0,0,0,0,1
lost wages,0,0,0,0,1,0,0,1
lost water,0,0,0,1,0,0,0,1
lot building,0,1,0,0,0,0,0,1
lot faster,0,0,0,0,0,1,0,1
lot heavier,0,0,0,0,0,1,0,1
lot larger,0,0,1,0,0,0,0,1
lot quicker,0,0,0,1,0,0,0,1
lot softer,0,0,0,0,1,0,0,1
lot worse,0,1,0,0,0,0,0,1
louis broke,1,0,0,0,0,0,0,1
louis mo,0,0,0,0,1,0,0,1
louis native,0,0,0,0,1,0,0,1
louis post,1,0,0,0,0,0,0,1
louis topography,0,0,0,0,1,0,0,1
louise flesh,0,1,0,0,0,0,0,1
louise kelly,0,0,0,0,1,0,0,1
louise set,0,0,1,0,0,0,0,1
louisiana alabama,0,0,0,0,0,1,0,1
louisiana blocked,0,1,0,0,0,0,0,1
louisiana coast,0,1,0,0,0,0,0,1
louisiana forcing,0,0,1,0,0,0,0,1
louisiana form,1,0,0,0,0,0,0,1
louisiana photographing,0,1,0,0,0,0,0,1
louisiana share,0,1,0,0,0,0,0,1
louisiana top,0,1,0,0,0,0,0,1
louisiana tribe,1,0,0,0,0,0,0,1
louisiana's coastal,0,1,0,0,0,0,0,1
louisiana's coastline,1,0,0,0,0,0,0,1
louisville courier,1,0,0,0,0,0,0,1
louisville jefferson,0,0,0,1,0,0,0,1
louisville kentucky,0,0,0,1,0,0,0,1
louisville ky,0,1,0,0,0,0,0,1
love cold,0,0,0,0,1,0,0,1
love electric,0,1,0,0,0,0,0,1
love hate,0,0,0,1,0,0,0,1
love hope,0,0,0,1,0,0,0,1
love hybrids,0,0,0,0,1,0,0,1
love selma,0,0,0,1,0,0,0,1
loveless perform,0,1,0,0,0,0,0,1
lovers aims,0,1,0,0,0,0,0,1
loves snowboarding,0,0,0,1,0,0,0,1
low cost,0,0,0,0,1,0,0,1
low delta,0,1,0,0,0,0,0,1
low depths,0,1,0,0,0,0,0,1
low expectations,0,1,0,0,0,0,0,1
low reprocessing,1,0,0,0,0,0,0,1
low speed,0,0,0,0,1,0,0,1
low temperatures,0,0,0,0,1,0,0,1
low vulnerability,0,0,0,0,0,1,0,1
low whir,0,0,0,0,0,1,0,1
lowcountryjay price,0,1,0,0,0,0,0,1
lower colorado,0,0,0,0,0,1,0,1
lower dollar,0,0,0,0,1,0,0,1
lower emissions,0,1,0,0,0,0,0,1
lower ninth,0,1,0,0,0,0,0,1
lower rainfall,0,0,1,0,0,0,0,1
lower register,0,0,0,0,0,1,0,1
lower snowfall,0,0,0,0,1,0,0,1
lower wage,0,0,0,0,0,1,0,1
lowering energy,0,0,0,0,0,1,0,1
lowest approval,1,0,0,0,0,0,0,1
lowest exposed,0,1,0,0,0,0,0,1
lowest ground,1,0,0,0,0,0,0,1
lowest level,0,0,0,0,0,1,0,1
lowest priority,0,0,0,0,1,0,0,1
lows cities,0,0,0,1,0,0,0,1
lows jeopardizing,0,0,0,1,0,0,0,1
loyola university,0,0,0,1,0,0,0,1
lpg compressed,0,1,0,0,0,0,0,1
lu edited,0,0,1,0,0,0,0,1
lubbock wbur,0,0,0,0,0,1,0,1
lube systems,1,0,0,0,0,0,0,1
luca cari,0,1,0,0,0,0,0,1
luciano rodrigues,0,0,0,1,0,0,0,1
lucie fla,0,1,0,0,0,0,0,1
luckier camp,0,0,1,0,0,0,0,1
luckier farmers,1,0,0,0,0,0,0,1
lucky children,0,0,0,0,1,0,0,1
lucrative job,0,0,1,0,0,0,0,1
lucrative palm,0,0,0,0,0,0,1,1
ludwig krapf,0,1,0,0,0,0,0,1
luhut pandjaitan's,0,0,0,0,1,0,0,1
luiz inacio,0,1,0,0,0,0,0,1
luiz inácio,0,0,0,0,0,0,1,1
lula deliver,0,1,0,0,0,0,0,1
lula helped,0,1,0,0,0,0,0,1
lula norway,0,1,0,0,0,0,0,1
lula plan,0,1,0,0,0,0,0,1
lula promised,0,1,0,0,0,0,0,1
lula's environmental,0,1,0,0,0,0,0,1
lund's home,1,0,0,0,0,0,0,1
lung benefits,1,0,0,0,0,0,0,1
lung issues,0,0,0,0,1,0,0,1
lure bears,0,0,0,1,0,0,0,1
lure women,1,0,0,0,0,0,0,1
lush green,0,0,0,1,0,0,0,1
lush tourist,0,0,0,1,0,0,0,1
luthier half,0,1,0,0,0,0,0,1
luthiery stephanie,0,1,0,0,0,0,0,1
lying bangladesh,0,0,0,0,0,1,0,1
lying coastal,0,1,0,0,0,0,0,1
lying geography,0,0,0,0,0,1,0,1
lying south,1,0,0,0,0,0,0,1
lynn photography,0,0,1,0,0,0,0,1
lyrics encouraging,0,0,0,0,0,1,0,1
maansi srivastava,0,1,0,0,0,0,0,1
mabbutt drove,0,1,0,0,0,0,0,1
mabbutt's message,0,1,0,0,0,0,0,1
macarthur foundation,1,0,0,0,0,0,0,1
machines harm,0,0,0,1,0,0,0,1
macias noah,0,1,0,0,0,0,0,1
maciver wrote,0,0,1,0,0,0,0,1
mackle brothers,1,0,0,0,0,0,0,1
madden julian,0,0,0,1,0,0,0,1
madison square,0,1,0,0,0,0,0,1
madurai southern,0,1,0,0,0,0,0,1
mafalda duarte,0,1,0,0,0,0,0,1
magakoe afp,0,1,0,0,0,0,0,1
maggie luthar,1,0,0,0,0,0,0,1
magically pick,1,0,0,0,0,0,0,1
magnate charles,0,0,0,0,1,0,0,1
magnets magnets,0,0,0,1,0,0,0,1
magnitude earthquake,1,0,0,0,0,0,0,1
magno afp,0,0,0,0,0,0,1,1
maguindanao province,1,0,0,0,0,0,0,1
mahoney environmental,0,0,0,0,1,0,0,1
mahyuddin afp,0,0,0,0,0,0,1,1
mai npr,0,0,0,0,0,1,0,1
mai rachel,0,1,0,0,0,0,0,1
main battle,0,0,0,1,0,0,0,1
main deck,0,1,0,0,0,0,0,1
main differences,0,0,0,0,0,0,1,1
main disaster,1,0,0,0,0,0,0,1
main forces,1,0,0,0,0,0,0,1
main goals,0,0,1,0,0,0,0,1
main greenhouse,1,0,0,0,0,0,0,1
main heat,1,0,0,0,0,0,0,1
main impediment,0,1,0,0,0,0,0,1
main issue,0,0,0,0,0,1,0,1
main issues,0,0,0,0,1,0,0,1
main languages,1,0,0,0,0,0,0,1
main message,0,0,0,0,0,1,0,1
main priorities,0,1,0,0,0,0,0,1
main reason,0,0,0,0,0,1,0,1
main roads,0,1,0,0,0,0,0,1
main solution.martí,0,0,0,0,1,0,0,1
main sources,0,1,0,0,0,0,0,1
main sticking,0,1,0,0,0,0,0,1
main street,0,1,0,0,0,0,0,1
main tool,0,0,0,0,1,0,0,1
main trunk's,0,0,0,0,1,0,0,1
main types,1,0,0,0,0,0,0,1
main utilities,0,0,0,0,1,0,0,1
maine emergency,0,0,0,0,1,0,0,1
maine governor's,1,0,0,0,0,0,0,1
maine massachusetts,0,0,0,0,1,0,0,1
maine medical,0,0,0,0,1,0,0,1
maine ski,0,0,0,0,1,0,0,1
maine snow,0,0,0,0,1,0,0,1
maine specifically,1,0,0,0,0,0,0,1
maine strong,0,0,0,0,1,0,0,1
maine temperatures,0,0,0,0,1,0,0,1
maine trained,1,0,0,0,0,0,0,1
maine western,0,0,0,0,1,0,0,1
maine's north,1,0,0,0,0,0,0,1
maine's paper,1,0,0,0,0,0,0,1
mainland europe,0,0,0,0,0,1,0,1
mainstream climate,0,0,0,0,1,0,0,1
mainstream education,0,0,0,0,1,0,0,1
mainstream investors,0,0,0,0,0,0,1,1
mainstream tv,0,0,0,0,0,0,1,1
maintain food,0,1,0,0,0,0,0,1
maintain weather,0,1,0,0,0,0,0,1
maintained properly,0,0,0,1,0,0,0,1
maintained warm,0,0,1,0,0,0,0,1
maintenance creating,0,0,0,0,1,0,0,1
maintenance workers,0,1,0,0,0,0,0,1
maize stalks,1,0,0,0,0,0,0,1
majd al,0,0,1,0,0,0,0,1
majestic carvings,0,1,0,0,0,0,0,1
major banks,0,0,0,0,0,1,0,1
major carmakers,0,0,0,0,0,1,0,1
major caveat,0,0,0,0,0,1,0,1
major change,0,1,0,0,0,0,0,1
major city,0,0,1,0,0,0,0,1
major climate,0,0,0,0,0,1,0,1
major cobalt,1,0,0,0,0,0,0,1
major competitor,0,0,0,1,0,0,0,1
major culprits,0,0,1,0,0,0,0,1
major cuts,0,0,0,1,0,0,0,1
major dams,0,1,0,0,0,0,0,1
major differences,0,0,0,0,0,1,0,1
major disagreement,0,0,0,0,1,0,0,1
major driver,0,0,0,1,0,0,0,1
major drought,0,0,0,0,0,1,0,1
major earthquake,0,0,0,0,0,1,0,1
major economies,0,1,0,0,0,0,0,1
major economy,0,1,0,0,0,0,0,1
major emerging,0,1,0,0,0,0,0,1
major emitter,0,1,0,0,0,0,0,1
major emitters,0,1,0,0,0,0,0,1
major emitting,0,1,0,0,0,0,0,1
major episodes,0,0,0,1,0,0,0,1
major fertilizer,0,0,1,0,0,0,0,1
major freeway,0,0,1,0,0,0,0,1
major freeways,0,0,1,0,0,0,0,1
major freeze,0,0,0,0,1,0,0,1
major gap,0,0,0,0,0,1,0,1
major government,0,1,0,0,0,0,0,1
major highway,0,0,0,0,0,0,1,1
major highways,0,0,0,0,0,1,0,1
major ice,1,0,0,0,0,0,0,1
major impact,0,1,0,0,0,0,0,1
major investor,0,0,0,0,1,0,0,1
major market,0,0,0,0,1,0,0,1
major negotiating,0,1,0,0,0,0,0,1
major north,0,0,0,0,1,0,0,1
major outbreaks,0,0,0,0,0,1,0,1
major plans,0,1,0,0,0,0,0,1
major political,0,1,0,0,0,0,0,1
major ports,0,0,0,0,1,0,0,1
major powers,0,0,0,1,0,0,0,1
major producers,0,0,0,1,0,0,0,1
major production,1,0,0,0,0,0,0,1
major proposals,0,0,0,0,1,0,0,1
major quote,0,0,1,0,0,0,0,1
major resource,0,1,0,0,0,0,0,1
major risks,0,0,0,0,1,0,0,1
major roads,0,1,0,0,0,0,0,1
major role,1,0,0,0,0,0,0,1
major site,0,1,0,0,0,0,0,1
major snowstorms,0,0,0,1,0,0,0,1
major source,0,0,0,1,0,0,0,1
major step,0,1,0,0,0,0,0,1
major stories,1,0,0,0,0,0,0,1
major storms,0,0,0,0,1,0,0,1
major stressor,0,0,1,0,0,0,0,1
major system,0,0,0,0,1,0,0,1
major threat,0,0,1,0,0,0,0,1
major u.s,0,0,1,0,0,0,0,1
majority latino,0,0,1,0,0,0,0,1
majority people,0,0,0,1,0,0,0,1
maker lg,0,0,0,0,0,1,0,1
makers analyzed,0,0,1,0,0,0,0,1
makes climate,0,0,0,1,0,0,0,1
makes coffee,0,0,0,1,0,0,0,1
makes farming,0,1,0,0,0,0,0,1
makes landfall,0,1,0,0,0,0,0,1
makes living,0,0,0,1,0,0,0,1
makes markers,0,0,0,0,0,0,1,1
makes peace,1,0,0,0,0,0,0,1
makes renewables,0,0,0,0,1,0,0,1
makes severe,0,0,0,0,0,0,1,1
makes storm,0,1,0,0,0,0,0,1
makeshift kitchen,0,0,0,0,0,1,0,1
makeshift markets,0,0,1,0,0,0,0,1
makeup routine,1,0,0,0,0,0,0,1
malala yousafzai,0,0,0,0,1,0,0,1
malaria witnessing,1,0,0,0,0,0,0,1
malavé's house,0,1,0,0,0,0,0,1
male driven,0,0,0,0,1,0,0,1
male mountain,0,0,1,0,0,0,0,1
malecon drive,0,1,0,0,0,0,0,1
mamadou niang,0,1,0,0,0,0,0,1
mammal commission,0,0,0,0,1,0,0,1
man's body,0,1,0,0,0,0,0,1
man's determination,1,0,0,0,0,0,0,1
manage cross,0,1,0,0,0,0,0,1
manage forests,0,0,0,0,0,0,1,1
manage future,1,0,0,0,0,0,0,1
manage growth,1,0,0,0,0,0,0,1
manage landslides,0,0,0,1,0,0,0,1
manage river,0,1,0,0,0,0,0,1
managed lands,0,0,0,0,1,0,0,1
managed risky,1,0,0,0,0,0,0,1
managed susan,1,0,0,0,0,0,0,1
management act,0,0,0,0,1,0,0,1
management authority,0,1,0,0,0,0,0,1
management depends,1,0,0,0,0,0,0,1
management describes,0,0,0,0,0,1,0,1
management experts,1,0,0,0,0,0,0,1
management increasing,1,0,0,0,0,0,0,1
management laws,1,0,0,0,0,0,0,1
management personnel,0,1,0,0,0,0,0,1
management plan,0,0,0,0,1,0,0,1
management strategies,0,0,0,0,0,1,0,1
management system,1,0,0,0,0,0,0,1
management tool,0,0,1,0,0,0,0,1
manager bryan,0,1,0,0,0,0,0,1
manager eric,0,0,0,0,1,0,0,1
manager stephanie,0,0,0,1,0,0,0,1
managers legal,0,0,1,0,0,0,0,1
manages emergency,0,0,0,0,0,1,0,1
managing growth,1,0,0,0,0,0,0,1
managing guidelines,0,0,0,1,0,0,0,1
managing partner,0,0,0,0,1,0,0,1
managing producer,0,0,0,0,0,1,0,1
mandate car,0,0,0,1,0,0,0,1
mandate set,0,0,0,1,0,0,0,1
mandate weatherization,0,0,0,0,1,0,0,1
mandated water,0,0,0,0,0,1,0,1
mandatory conservation,0,0,0,0,0,1,0,1
mandatory cutbacks,1,0,0,0,0,0,0,1
mandatory evacuations,0,0,0,1,0,0,0,1
mandatory performance,0,0,0,1,0,0,0,1
mandel wrote,0,0,1,0,0,0,0,1
mandela school,1,0,0,0,0,0,0,1
mangrove lined,1,0,0,0,0,0,0,1
manhattan institute,0,0,0,0,1,0,0,1
manila philippines,1,0,0,0,0,0,0,1
manila's international,1,0,0,0,0,0,0,1
manish bapna,0,0,1,0,0,0,0,1
mankani beckons,1,0,0,0,0,0,0,1
mankani chats,1,0,0,0,0,0,0,1
mankani explains,1,0,0,0,0,0,0,1
mankani feeling,1,0,0,0,0,0,0,1
mankani messages,1,0,0,0,0,0,0,1
mankani packs,1,0,0,0,0,0,0,1
mankani quickly,1,0,0,0,0,0,0,1
mankani referring,1,0,0,0,0,0,0,1
mankani rummages,1,0,0,0,0,0,0,1
mankani shaking,1,0,0,0,0,0,0,1
mankani sits,1,0,0,0,0,0,0,1
mankani walks,1,0,0,0,0,0,0,1
mankani's challenges,1,0,0,0,0,0,0,1
mankani's feet,1,0,0,0,0,0,0,1
mankani's team,1,0,0,0,0,0,0,1
manmade climate,0,0,0,1,0,0,0,1
manu san,0,1,0,0,0,0,0,1
manuel added,0,0,0,0,0,1,0,1
manuel director,0,0,0,0,0,1,0,1
manuela lopez,0,1,0,0,0,0,0,1
manufactured homes,0,0,0,0,0,1,0,1
manufacturer caloric,0,0,0,0,1,0,0,1
manufacturer catl,0,0,0,0,1,0,0,1
manufacturers cover,0,0,0,1,0,0,0,1
manufacturers developed,0,0,0,0,1,0,0,1
manufacturers focused,0,0,0,0,1,0,0,1
manufacturers including,0,0,0,0,1,0,0,1
manufacturers lobbied,0,0,1,0,0,0,0,1
manufacturers played,0,0,1,0,0,0,0,1
manufacturers privately,0,0,1,0,0,0,0,1
manufacturers retailers,0,0,1,0,0,0,0,1
manufacturing facility,0,0,0,0,0,1,0,1
manufacturing firms,0,0,0,0,0,1,0,1
manufacturing ipod,0,1,0,0,0,0,0,1
manufacturing plant,0,0,0,0,0,1,0,1
manufacturing sector,0,0,0,0,0,1,0,1
manufacturing sectors,0,0,0,0,0,1,0,1
maori people,0,0,0,1,0,0,0,1
map luckily,0,0,0,0,0,1,0,1
maple syrup,0,0,0,0,0,1,0,1
marburg germany,0,0,0,0,0,1,0,1
marburg including,0,0,0,0,0,1,0,1
marburg outbreak,0,0,0,0,0,1,0,1
marcel fratzscher,0,0,0,0,0,1,0,1
marcela guerrero,0,0,0,1,0,0,0,1
march 1st,0,0,0,0,1,0,0,1
march harbor,0,1,0,0,0,0,0,1
march northward,0,0,0,0,1,0,0,1
march winter,0,0,0,0,0,1,0,1
marciano head,0,0,0,1,0,0,0,1
marco island,1,0,0,0,0,0,0,1
marco longari,1,0,0,0,0,0,0,1
marcos jr,1,0,0,0,0,0,0,1
marcus pollard's,0,0,0,1,0,0,0,1
mardi gras,0,1,0,0,0,0,0,1
margaret bruce,0,0,0,0,1,0,0,1
margaret elysia,0,0,0,0,1,0,0,1
margaret started,1,0,0,0,0,0,0,1
margherita pizza,0,0,0,0,0,1,0,1
marginal idea,0,0,0,0,0,1,0,1
marginalized learners,0,0,0,0,1,0,0,1
marginalized peoples,0,0,0,1,0,0,0,1
margo oge,0,0,0,0,1,0,0,1
marguerite bay,0,1,0,0,0,0,0,1
maria destroyed,0,1,0,0,0,0,0,1
maria erika,0,1,0,0,0,0,0,1
maria fiona,0,1,0,0,0,0,0,1
maria runs,0,0,0,1,0,0,0,1
maria tore,0,1,0,0,0,0,0,1
maria torres,0,1,0,0,0,0,0,1
maricopa county,0,0,0,0,1,0,0,1
maricultured tend,0,0,0,0,0,0,1,1
marie fogel,0,0,1,0,0,0,0,1
marin bristles,0,1,0,0,0,0,0,1
marin sonoma,0,0,0,1,0,0,0,1
marine activities,0,0,0,0,0,1,0,1
marine agriculture,0,0,0,0,0,0,1,1
marine animals.martí,0,0,1,0,0,0,0,1
marine authority,0,1,0,0,0,0,0,1
marine biology,0,1,0,0,0,0,0,1
marine heat,0,1,0,0,0,0,0,1
marine history,0,1,0,0,0,0,0,1
marine mammal,0,0,0,0,1,0,0,1
marine realm.martí,0,0,1,0,0,0,0,1
marine scientist,0,1,0,0,0,0,0,1
mario ariza,0,0,1,0,0,0,0,1
marisela ramos,0,0,0,0,1,0,0,1
mark berry,1,0,0,0,0,0,0,1
mark crosswhite,0,0,1,0,0,0,0,1
mark hare,0,0,0,1,0,0,0,1
mark herz,0,0,0,0,1,0,0,1
mark humans,0,1,0,0,0,0,0,1
mark mcgowan,0,0,0,0,1,0,0,1
mark safe,0,1,0,0,0,0,0,1
mark twain,0,1,0,0,0,0,0,1
marked difference,0,0,1,0,0,0,0,1
market applauded,0,0,0,0,1,0,0,1
market barely,1,0,0,0,0,0,0,1
market editorial,0,0,1,0,0,0,0,1
market forces,0,1,0,0,0,0,0,1
market garden,0,0,0,0,1,0,0,1
market including,0,0,0,0,1,0,0,1
market knowledge,0,1,0,0,0,0,0,1
market potential,0,1,0,0,0,0,0,1
market power,0,0,0,0,1,0,0,1
market price,0,0,0,0,1,0,0,1
market prices,1,0,0,0,0,0,0,1
market punished,0,0,0,0,1,0,0,1
market reform,0,0,0,0,1,0,0,1
market reforms,0,0,0,0,1,0,0,1
market research,0,0,0,0,1,0,0,1
market signals,0,1,0,0,0,0,0,1
marketing methods,0,1,0,0,0,0,0,1
markets analysts,0,1,0,0,0,0,0,1
markets initiative,0,1,0,0,0,0,0,1
markets play,0,1,0,0,0,0,0,1
markets temporarily,1,0,0,0,0,0,0,1
marking territory,1,0,0,0,0,0,0,1
markowski called,0,0,0,0,0,1,0,1
marks california's,0,0,0,1,0,0,0,1
marks world,0,0,1,0,0,0,0,1
marne titchenell,0,1,0,0,0,0,0,1
marovich getty,0,0,0,0,0,1,0,1
mars pepsico,0,1,0,0,0,0,0,1
mars system,0,1,0,0,0,0,0,1
marsh grass,0,1,0,0,0,0,0,1
marsh grasses,0,1,0,0,0,0,0,1
marshall islands,0,1,0,0,0,0,0,1
marshall managed,0,0,0,0,1,0,0,1
marshes bisected,0,1,0,0,0,0,0,1
marshy hurricane,0,1,0,0,0,0,0,1
marten geertsema,0,0,0,1,0,0,0,1
martha williams,1,0,0,0,0,0,0,1
martin ap,0,0,0,0,1,0,0,1
martínez de,0,0,0,0,1,0,0,1
martínez fears,0,1,0,0,0,0,0,1
martínez finishing,0,1,0,0,0,0,0,1
marty ralph,0,0,0,1,0,0,0,1
mary carson,0,1,0,0,0,0,0,1
mary ellen,0,0,1,0,0,0,0,1
mary mccabe,0,0,0,0,0,1,0,1
mary spicer,0,0,0,1,0,0,0,1
maryland gov,1,0,0,0,0,0,0,1
maryland massachusetts,0,0,0,0,0,1,0,1
maryland social,0,1,0,0,0,0,0,1
masdar listed,0,0,0,1,0,0,0,1
mason kozac,0,1,0,0,0,0,0,1
mass entertainment,0,0,1,0,0,0,0,1
mass event,0,1,0,0,0,0,0,1
mass exodus,1,0,0,0,0,0,0,1
mass shooter,1,0,0,0,0,0,0,1
massachusetts oregon,0,0,1,0,0,0,0,1
massachusetts senator,0,0,0,0,0,1,0,1
massachusetts vermont,0,0,0,0,1,0,0,1
masses collide,0,0,0,0,0,1,0,1
massive band,0,0,0,1,0,0,0,1
massive burden,1,0,0,0,0,0,0,1
massive climate,0,0,0,1,0,0,0,1
massive clouds,1,0,0,0,0,0,0,1
massive consequences,0,0,0,0,1,0,0,1
massive deployment,0,0,0,1,0,0,0,1
massive drought,0,1,0,0,0,0,0,1
massive economic,0,0,0,0,0,1,0,1
massive efforts,0,0,0,1,0,0,0,1
massive expanses,0,1,0,0,0,0,0,1
massive fish,0,0,0,1,0,0,0,1
massive footprint,0,0,0,0,1,0,0,1
massive game,0,0,0,0,0,1,0,1
massive glacier,0,1,0,0,0,0,0,1
massive glaciers,1,0,0,0,0,0,0,1
massive increase,0,0,0,0,0,1,0,1
massive internal,0,0,0,0,0,1,0,1
massive landslide,0,1,0,0,0,0,0,1
massive liabilities,0,1,0,0,0,0,0,1
massive melt,0,0,0,0,1,0,0,1
massive mines,0,1,0,0,0,0,0,1
massive oil,0,0,0,0,0,1,0,1
massive ongoing,0,1,0,0,0,0,0,1
massive palm,0,0,0,1,0,0,0,1
massive perks,0,0,0,1,0,0,0,1
massive rainfall,0,0,0,0,0,1,0,1
massive release,1,0,0,0,0,0,0,1
massive scale,0,1,0,0,0,0,0,1
massive sea,0,0,0,0,0,1,0,1
massive solar,0,0,0,1,0,0,0,1
massive swings,0,0,0,0,0,1,0,1
massive valleys,1,0,0,0,0,0,0,1
massive wildfires,1,0,0,0,0,0,0,1
massive willow,0,0,0,0,0,1,0,1
massive winter,0,0,0,1,0,0,0,1
master tape,0,1,0,0,0,0,0,1
matches people,0,1,0,0,0,0,0,1
mateo county,0,0,0,0,1,0,0,1
material flowing,0,0,0,1,0,0,0,1
material provided,0,0,0,0,1,0,0,1
material ralston,0,0,0,0,1,0,0,1
material streaming,0,0,0,0,1,0,0,1
materials arden,0,1,0,0,0,0,0,1
materials sound,0,1,0,0,0,0,0,1
materials surrounding,0,0,0,1,0,0,0,1
mates marking,1,0,0,0,0,0,0,1
math basic,0,1,0,0,0,0,0,1
math history,0,1,0,0,0,0,0,1
mathew stops,0,0,1,0,0,0,0,1
mathew translates,0,0,1,0,0,0,0,1
mathews translates,0,0,1,0,0,0,0,1
matrix associates,0,0,1,0,0,0,0,1
matrix ceo,0,0,1,0,0,0,0,1
matrix coverage,0,0,1,0,0,0,0,1
matrix designed,0,0,1,0,0,0,0,1
matrix documents,0,0,1,0,0,0,0,1
matrix founder,0,0,1,0,0,0,0,1
matrix joe,0,0,1,0,0,0,0,1
matrix payments,0,0,1,0,0,0,0,1
matrix quietly,0,0,1,0,0,0,0,1
matrix recently,0,0,1,0,0,0,0,1
matrix ryan,0,0,1,0,0,0,0,1
matrix shrewdly,0,0,1,0,0,0,0,1
matrix sought,0,0,1,0,0,0,0,1
matrix tami,0,0,1,0,0,0,0,1
matrix's biggest,0,0,1,0,0,0,0,1
matrix's clients,0,0,1,0,0,0,0,1
matrix's montgomery,0,0,1,0,0,0,0,1
matrix's power,0,0,1,0,0,0,0,1
matt happy,0,0,0,0,0,1,0,1
matthew carter,0,1,0,0,0,0,0,1
matthew serratto,0,0,0,1,0,0,0,1
matthew stops,0,0,1,0,0,0,0,1
matthew yglesias,0,0,0,1,0,0,0,1
maturen getty,0,0,0,0,1,0,0,1
maurice phillips,0,1,0,0,0,0,0,1
maximiliano herrera,0,0,0,1,0,0,0,1
maximize growth,0,1,0,0,0,0,0,1
maximize profits,0,0,1,0,0,0,0,1
maximum path,0,0,0,0,0,1,0,1
maximum warming,0,0,0,1,0,0,0,1
mayne told,0,1,0,0,0,0,0,1
mayo clinic,0,1,0,0,0,0,0,1
mayor drew,0,0,0,0,0,1,0,1
mayor gibson,1,0,0,0,0,0,0,1
mayor jayson,0,1,0,0,0,0,0,1
mayor matthew,0,0,0,1,0,0,0,1
mayorkas appeared,0,1,0,0,0,0,0,1
mcdonald's announced,0,1,0,0,0,0,0,1
mcdonnell getty,0,0,1,0,0,0,0,1
mcelroy's organization,0,0,0,1,0,0,0,1
mckibben created,0,0,0,0,0,1,0,1
mckibben remains,0,0,0,0,0,1,0,1
mcnairy county,0,0,0,0,0,0,1,1
mcnew afp,0,0,0,1,0,0,0,1
mcveigh wrote,0,0,0,1,0,0,0,1
mead filled,1,0,0,0,0,0,0,1
meadows calif,0,0,0,0,1,0,0,1
meager patches,0,0,0,1,0,0,0,1
meaning held,0,0,0,0,1,0,0,1
meaningful action,0,0,0,0,1,0,0,1
meaningful change,0,1,0,0,0,0,0,1
meaningful difference,0,0,0,1,0,0,0,1
meaningful extended,0,0,0,1,0,0,0,1
meaningful ira,0,0,0,0,0,0,1,1
meaningful pathway,0,1,0,0,0,0,0,1
meaningfully enforce,0,0,0,0,0,0,1,1
means adapting,0,0,1,0,0,0,0,1
means agencies,0,1,0,0,0,0,0,1
means americans,0,1,0,0,0,0,0,1
means billions,0,1,0,0,0,0,0,1
means city,1,0,0,0,0,0,0,1
means cleaning,0,0,0,1,0,0,0,1
means closely,0,0,0,0,0,1,0,1
means companies,0,0,0,1,0,0,0,1
means compensating,1,0,0,0,0,0,0,1
means cooking,0,0,0,1,0,0,0,1
means democrats,0,1,0,0,0,0,0,1
means demolishing,0,1,0,0,0,0,0,1
means deploying,0,0,0,1,0,0,0,1
means desalination,0,1,0,0,0,0,0,1
means droughts,0,0,0,0,0,1,0,1
means encouraging,0,0,0,1,0,0,0,1
means federal,0,1,0,0,0,0,0,1
means figuring,0,0,0,0,0,1,0,1
means including,1,0,0,0,0,0,0,1
means leaving,0,1,0,0,0,0,0,1
means organic,0,1,0,0,0,0,0,1
means reworking,0,1,0,0,0,0,0,1
means river,0,1,0,0,0,0,0,1
means storms,0,0,0,0,0,1,0,1
means upgrading,0,0,0,1,0,0,0,1
means wait,0,1,0,0,0,0,0,1
means water,0,0,0,1,0,0,0,1
meantime cities,0,0,0,1,0,0,0,1
meantime indonesia,0,0,0,0,1,0,0,1
measure ozone,0,0,0,0,1,0,0,1
measure sea,0,0,0,0,0,1,0,1
measure smog,0,0,0,0,1,0,0,1
measured methane,0,0,0,1,0,0,0,1
measurements scientists,0,0,1,0,0,0,0,1
measures temperature,0,0,0,0,1,0,0,1
measuring pavement,0,0,0,1,0,0,0,1
measuring water,0,1,0,0,0,0,0,1
meat eaters,0,1,0,0,0,0,0,1
meat emma,0,0,1,0,0,0,0,1
meat hunnes,0,1,0,0,0,0,0,1
meat march,0,1,0,0,0,0,0,1
meat mwenja,1,0,0,0,0,0,0,1
meat poultry,0,1,0,0,0,0,0,1
meat researchers,0,1,0,0,0,0,0,1
meat scientist,0,1,0,0,0,0,0,1
meat upside's,0,1,0,0,0,0,0,1
meat's peter,0,1,0,0,0,0,0,1
meat's pilot,0,1,0,0,0,0,0,1
meats brian,0,1,0,0,0,0,0,1
meats enter,0,1,0,0,0,0,0,1
meaty issues,0,0,0,0,1,0,0,1
mecca coming,0,0,0,1,0,0,0,1
mechanism dedicated,0,0,1,0,0,0,0,1
media artist,0,0,0,1,0,0,0,1
media attention,0,0,0,1,0,0,0,1
media center,0,1,0,0,0,0,0,1
media coverage,0,0,0,1,0,0,0,1
media grabbing,0,1,0,0,0,0,0,1
media hide,1,0,0,0,0,0,0,1
media influencers,0,0,0,0,0,1,0,1
media institute,0,1,0,0,0,0,0,1
media newsrooms,0,0,0,1,0,0,0,1
media organizations,0,0,1,0,0,0,0,1
media outlets,0,0,0,1,0,0,0,1
media post,0,1,0,0,0,0,0,1
media postings,0,0,1,0,0,0,0,1
media professor,0,0,0,0,1,0,0,1
media repeatedly,0,0,1,0,0,0,0,1
media reports,0,0,1,0,0,0,0,1
media research,0,0,0,0,0,1,0,1
media stories,0,0,0,1,0,0,0,1
media tiktokkers,0,0,0,0,0,1,0,1
media's dana,0,0,0,1,0,0,0,1
media's founder,0,0,1,0,0,0,0,1
medic corps,1,0,0,0,0,0,0,1
medical association,0,0,0,0,1,0,0,1
medical center's,1,0,0,0,0,0,0,1
medical examiner,0,1,0,0,0,0,0,1
medical examiner's,0,0,0,0,1,0,0,1
medical journal,0,1,0,0,0,0,0,1
medical officer,0,0,0,0,0,1,0,1
medical school,0,1,0,0,0,0,0,1
mediterranean region,0,0,0,0,1,0,0,1
mediterranean sea,0,1,0,0,0,0,0,1
mediterranean sea.the,0,1,0,0,0,0,0,1
medium sized,0,1,0,0,0,0,0,1
meet changing,0,0,1,0,0,0,0,1
meet demand,0,0,0,0,1,0,0,1
meet energy,1,0,0,0,0,0,0,1
meet increased,0,0,0,0,0,0,1,1
meet puerto,0,0,0,1,0,0,0,1
meet shay,0,1,0,0,0,0,0,1
meet strong,0,0,0,0,0,1,0,1
meet u.n,0,0,0,0,0,1,0,1
meeting al,0,0,0,0,0,1,0,1
meeting called,1,0,0,0,0,0,0,1
meeting coming,0,0,0,0,0,1,0,1
meeting thousands,0,1,0,0,0,0,0,1
meeting underway,0,1,0,0,0,0,0,1
meeting's agenda,0,1,0,0,0,0,0,1
meetings running,0,0,0,0,1,0,0,1
meetings underway,0,1,0,0,0,0,0,1
meetings yeah,0,0,0,0,0,0,1,1
meetings yellen,1,0,0,0,0,0,0,1
meets europe,0,1,0,0,0,0,0,1
meets president,0,0,0,0,0,1,0,1
mega food,0,1,0,0,0,0,0,1
megadrought means,0,0,0,0,1,0,0,1
megadrought plaguing,0,0,0,0,0,1,0,1
megadrought ted,1,0,0,0,0,0,0,1
megadrought water,0,0,0,0,1,0,0,1
megan bolten,0,0,1,0,0,0,0,1
megan randles,0,0,0,1,0,0,0,1
mehdi fedouach,0,0,0,0,0,1,0,1
mei castillo,0,1,0,0,0,0,0,1
mekong basins,0,0,0,0,0,0,1,1
melilla irene,0,1,0,0,0,0,0,1
melodramatic scenes,0,0,1,0,0,0,0,1
meloni convened,0,1,0,0,0,0,0,1
melt accelerates,0,1,0,0,0,0,0,1
melt acharya,0,1,0,0,0,0,0,1
melt caldas,0,0,0,1,0,0,0,1
melt process,0,1,0,0,0,0,0,1
melted rapidly,1,0,0,0,0,0,0,1
melting arctic,1,0,0,0,0,0,0,1
melting coupled,0,1,0,0,0,0,0,1
melting faster,0,1,0,0,0,0,0,1
melting giving,0,1,0,0,0,0,0,1
melting glacial,0,1,0,0,0,0,0,1
melting ice,1,0,0,0,0,0,0,1
melting quickly,0,1,0,0,0,0,0,1
melting rapidly,0,1,0,0,0,0,0,1
melting speaking,0,0,1,0,0,0,0,1
melting water,0,0,0,0,1,0,0,1
melts scientists,0,1,0,0,0,0,0,1
meltwater channels,1,0,0,0,0,0,0,1
meltwater flow,1,0,0,0,0,0,0,1
meltwater runs,0,1,0,0,0,0,0,1
memo boils,0,0,0,0,0,1,0,1
memo metaphor,0,0,0,0,0,1,0,1
memorial beat,0,1,0,0,0,0,0,1
memorial debacle,0,1,0,0,0,0,0,1
memos yeah,0,0,0,0,0,1,0,1
memphis captain,0,1,0,0,0,0,0,1
memphis jackson,0,0,0,0,0,1,0,1
memphis meats,0,1,0,0,0,0,0,1
memphis reports,0,1,0,0,0,0,0,1
memphis singing,0,1,0,0,0,0,0,1
memphis tennessee,0,0,0,0,0,0,1,1
mendez added,0,0,0,1,0,0,0,1
mendocino complex,1,0,0,0,0,0,0,1
mendocino napa,0,0,0,1,0,0,0,1
menlo park,0,0,0,0,1,0,0,1
mention briefly,0,0,0,1,0,0,0,1
mention species,0,0,1,0,0,0,0,1
mention trees,0,0,0,1,0,0,0,1
mentioned climate,0,0,0,0,0,0,1,1
mentioned previously,0,0,1,0,0,0,0,1
mentioned wildfires,0,0,0,1,0,0,0,1
menu dictating,0,1,0,0,0,0,0,1
merbok revealed,0,0,1,0,0,0,0,1
merced county,0,0,0,1,0,0,0,1
merced mayor,0,0,0,1,0,0,0,1
merchandise god,0,0,0,1,0,0,0,1
mere movement,0,1,0,0,0,0,0,1
meredith berger,0,1,0,0,0,0,0,1
meredith miotke,0,0,0,0,1,0,0,1
merritt turetsky,0,1,0,0,0,0,0,1
meryl streep,0,0,0,0,0,0,1,1
mesh bags,0,0,0,0,0,0,1,1
message board,0,0,0,0,0,1,0,1
messengers research,0,1,0,0,0,0,0,1
met doug,0,1,0,0,0,0,0,1
met sarah,0,1,0,0,0,0,0,1
metal box,0,1,0,0,0,0,0,1
metal concert,0,0,0,0,0,0,1,1
metal construction,0,0,0,1,0,0,0,1
metal detector,0,1,0,0,0,0,0,1
metal links,0,0,0,1,0,0,0,1
metal pods,0,0,0,1,0,0,0,1
metal rods,0,0,0,0,0,1,0,1
metal roof,0,1,0,0,0,0,0,1
metal shipping,0,0,0,1,0,0,0,1
metallurgical resources,1,0,0,0,0,0,0,1
metals found,0,0,0,1,0,0,0,1
meteorological society,0,0,0,0,0,1,0,1
meteorologist antoinette,0,0,0,0,0,1,0,1
meteorologist bianca,0,1,0,0,0,0,0,1
meteorologist bob,0,0,0,1,0,0,0,1
meteorologist david,0,0,0,1,0,0,0,1
meteorologist francis,0,0,0,0,1,0,0,1
meteorologist gerald,0,0,0,1,0,0,0,1
meteorologist lance,0,0,0,0,0,1,0,1
meteorologist robert,0,1,0,0,0,0,0,1
meteorologist ryan,0,0,0,1,0,0,0,1
meteorologist training,0,1,0,0,0,0,0,1
meteorologist tyler,1,0,0,0,0,0,0,1
meteorologists call,0,0,0,1,0,0,0,1
meteorologists called,0,0,0,0,0,1,0,1
meteosuisse quipped,0,0,0,1,0,0,0,1
meter chunks,0,0,0,1,0,0,0,1
meter hole,0,0,0,0,1,0,0,1
meter race,0,1,0,0,0,0,0,1
meter rise,0,0,0,0,0,1,0,1
meters hills,0,0,0,0,1,0,0,1
meters wash,1,0,0,0,0,0,0,1
methane accounts,1,0,0,0,0,0,0,1
methane alert,0,1,0,0,0,0,0,1
methane gas,0,1,0,0,0,0,0,1
methane leaks,0,1,0,0,0,0,0,1
methane levels,1,0,0,0,0,0,0,1
methane looms,0,1,0,0,0,0,0,1
methane pledge,1,0,0,0,0,0,0,1
methane reaches,1,0,0,0,0,0,0,1
methane reductions,0,1,0,0,0,0,0,1
methane strong,0,0,0,0,0,1,0,1
methane traps,1,0,0,0,0,0,0,1
methods require,0,1,0,0,0,0,0,1
meticulous manner,0,0,0,1,0,0,0,1
meticulously water,0,0,0,0,1,0,0,1
mexican border,0,0,0,1,0,0,0,1
mexico alfalfa,1,0,0,0,0,0,0,1
mexico europe,0,1,0,0,0,0,0,1
mexico helped,0,0,0,0,0,1,0,1
mexico lomnitz,0,0,0,0,0,1,0,1
mexico millions,0,0,0,0,0,1,0,1
mexico silvana,0,0,0,0,0,1,0,1
mexico stewart,1,0,0,0,0,0,0,1
mexico water,0,1,0,0,0,0,0,1
mexico's recorded,1,0,0,0,0,0,0,1
mexico's share,0,0,0,1,0,0,0,1
mia amor,0,1,0,0,0,0,0,1
mia venkat,0,0,0,1,0,0,0,1
miami based,0,1,0,0,0,0,0,1
miami tropical,0,1,0,0,0,0,0,1
michael anderson,0,0,0,0,0,0,1,1
michael baumann,0,0,0,0,1,0,0,1
michael bennet,0,0,0,0,0,0,1,1
michael burger,0,0,0,0,1,0,0,1
michael cahn,0,0,0,0,0,1,0,1
michael knowles,0,0,0,0,0,1,0,1
michael mann,0,0,0,1,0,0,0,1
michael mitchell,1,0,0,0,0,0,0,1
michael probst,0,1,0,0,0,0,0,1
michael ryan,0,0,0,0,0,1,0,1
michael wehner,0,1,0,0,0,0,0,1
michai robertson,0,1,0,0,0,0,0,1
michel martin,0,1,0,0,0,0,0,1
michelin starred,0,1,0,0,0,0,0,1
michelle krebs,0,0,0,0,1,0,0,1
michelle mccormick,0,0,0,0,1,0,0,1
michelle tias,0,0,0,0,0,1,0,1
michigan allison,0,0,0,0,1,0,0,1
michigan firefighter,0,0,0,0,1,0,0,1
michigan united,0,0,0,0,1,0,0,1
michigan university,0,0,0,0,0,1,0,1
micro paleontologist,0,0,0,0,0,1,0,1
microbes floating,1,0,0,0,0,0,0,1
micronutrients including,0,1,0,0,0,0,0,1
microphone attached,0,0,0,0,0,1,0,1
microphones called,1,0,0,0,0,0,0,1
microscopic particles,1,0,0,0,0,0,0,1
microsoft's vice,0,1,0,0,0,0,0,1
mid 1800s,0,0,0,0,0,1,0,1
mid 19th,0,0,0,1,0,0,0,1
mid 2000s,0,0,0,1,0,0,0,1
mid january,0,0,0,0,1,0,0,1
mid july,0,1,0,0,0,0,0,1
mid june,0,1,0,0,0,0,0,1
mid march,0,0,0,0,0,1,0,1
mid morning,1,0,0,0,0,0,0,1
mid november,1,0,0,0,0,0,0,1
mid september,1,0,0,0,0,0,0,1
midcentury southern,0,0,1,0,0,0,0,1
midday break,0,1,0,0,0,0,0,1
midday sunday,0,0,0,0,1,0,0,1
middle aged,0,0,0,0,0,1,0,1
middle class,0,0,0,1,0,0,0,1
middle dramatized,0,0,0,0,0,0,1,1
middle ground,1,0,0,0,0,0,0,1
middle series,0,0,0,0,0,0,1,1
mideast analyst,0,0,0,1,0,0,0,1
mideast nation,0,0,0,1,0,0,0,1
midnight left,1,0,0,0,0,0,0,1
midterm elections.so,0,1,0,0,0,0,0,1
midwest nick,0,0,0,0,0,0,1,1
midwest severe,0,0,0,0,0,1,0,1
midwest wynne,0,0,0,0,0,0,1,1
midwife clinics,1,0,0,0,0,0,0,1
midwife jahan,1,0,0,0,0,0,0,1
midwife zuberi,1,0,0,0,0,0,0,1
midwives attention,1,0,0,0,0,0,0,1
midwives dole,1,0,0,0,0,0,0,1
migaki contributed,0,0,0,1,0,0,0,1
migma thamang,0,1,0,0,0,0,0,1
migrant apprehensions,0,1,0,0,0,0,0,1
migrant camp,0,1,0,0,0,0,0,1
migrants camp,0,1,0,0,0,0,0,1
migrants continue,0,1,0,0,0,0,0,1
migrants dock,0,1,0,0,0,0,0,1
migrants fleeing,0,1,0,0,0,0,0,1
migrants legally,0,1,0,0,0,0,0,1
migrants stay,0,1,0,0,0,0,0,1
migrating internally,0,1,0,0,0,0,0,1
migration argues,0,0,0,0,1,0,0,1
migration regional,1,0,0,0,0,0,0,1
migratory schaeffer,0,0,1,0,0,0,0,1
mike anderson,0,0,0,0,0,1,0,1
mike barsotti,0,0,1,0,0,0,0,1
mike clay,0,1,0,0,0,0,0,1
mike rosen,0,1,0,0,0,0,0,1
milam lived,0,0,0,0,0,0,1,1
milan rescuers,0,1,0,0,0,0,0,1
mild day,0,0,0,1,0,0,0,1
mile drive,0,0,0,0,1,0,0,1
mile mining,0,0,0,0,1,0,0,1
mile scoop,0,1,0,0,0,0,0,1
mile thick,0,1,0,0,0,0,0,1
mile wide,0,1,0,0,0,0,0,1
miles australian,0,1,0,0,0,0,0,1
miles depinte,0,0,1,0,0,0,0,1
miles hatfield,1,0,0,0,0,0,0,1
miles northeast,0,1,0,0,0,0,0,1
miles northwest,0,1,0,0,0,0,0,1
miles southwest,0,0,0,0,1,0,0,1
miles typically,0,0,0,1,0,0,0,1
miles wide,1,0,0,0,0,0,0,1
miles yesterday,0,0,0,0,0,1,0,1
military balloons,0,0,0,0,1,0,0,1
military construction,0,1,0,0,0,0,0,1
military court,0,0,0,0,1,0,0,1
military decades,0,1,0,0,0,0,0,1
military installations,0,1,0,0,0,0,0,1
military jury,0,0,0,0,1,0,0,1
military prison,0,0,0,0,1,0,0,1
military risk,0,0,0,0,1,0,0,1
military service,0,0,0,0,1,0,0,1
military superpower,0,1,0,0,0,0,0,1
military technology,0,0,0,1,0,0,0,1
military's backlog,0,1,0,0,0,0,0,1
milk containers,1,0,0,0,0,0,0,1
milk crate,0,0,0,1,0,0,0,1
mill services,0,0,1,0,0,0,0,1
millennia living,0,0,0,0,0,1,0,1
miller's character,0,0,0,0,0,0,1,1
miller's organization,0,0,0,1,0,0,0,1
millet eventually,0,1,0,0,0,0,0,1
million brazilians,0,1,0,0,0,0,0,1
million businesses,0,0,1,0,0,0,0,1
million chargers,0,0,0,1,0,0,0,1
million check,1,0,0,0,0,0,0,1
million children,0,0,0,0,1,0,0,1
million climate,0,1,0,0,0,0,0,1
million daily,0,0,0,1,0,0,0,1
million dollar,0,1,0,0,0,0,0,1
million earlier,1,0,0,0,0,0,0,1
million eventually,0,1,0,0,0,0,0,1
million existing,0,1,0,0,0,0,0,1
million families,0,0,0,0,0,1,0,1
million farmers,1,0,0,0,0,0,0,1
million federal,0,1,0,0,0,0,0,1
million gas,0,0,0,0,0,1,0,1
million grant,0,1,0,0,0,0,0,1
million living,0,0,1,0,0,0,0,1
million metric,0,0,0,0,0,1,0,1
million multi,0,0,0,0,1,0,0,1
million plant,0,0,1,0,0,0,0,1
million population,0,0,0,0,1,0,0,1
million project,0,1,0,0,0,0,0,1
million raw,0,0,0,1,0,0,0,1
million residents,0,0,0,0,1,0,0,1
million sandbags,0,0,0,1,0,0,0,1
million signatures,0,0,0,0,0,1,0,1
million ton,0,1,0,0,0,0,0,1
milton guevara,0,0,1,0,0,0,0,1
minandar kusiong,1,0,0,0,0,0,0,1
mind sejal,0,0,0,1,0,0,0,1
minded residents,0,1,0,0,0,0,0,1
mine anjali's,0,0,0,0,1,0,0,1
mine coal,0,0,0,0,0,1,0,1
mine damaged,1,0,0,0,0,0,0,1
mine piedmont,0,1,0,0,0,0,0,1
mine reclamation,1,0,0,0,0,0,0,1
mine site,0,1,0,0,0,0,0,1
mine suddenly,0,1,0,0,0,0,0,1
mine thirty,1,0,0,0,0,0,0,1
mine typically,0,0,0,0,1,0,0,1
mine underneath,1,0,0,0,0,0,0,1
mine water,1,0,0,0,0,0,0,1
mine's life,1,0,0,0,0,0,0,1
mine's south,0,1,0,0,0,0,0,1
mined coal,1,0,0,0,0,0,0,1
mined components,0,0,0,0,0,1,0,1
miner attributes,1,0,0,0,0,0,0,1
miner lived,1,0,0,0,0,0,0,1
mineral dust,1,0,0,0,0,0,0,1
mineral harvesting,0,0,0,0,1,0,0,1
mineral reserves,0,0,0,0,1,0,0,1
mineral spodumene,0,1,0,0,0,0,0,1
minerals garcia,0,0,0,0,1,0,0,1
mines alpha,1,0,0,0,0,0,0,1
mines knowing,1,0,0,0,0,0,0,1
mines nearby,0,1,0,0,0,0,0,1
mines radhika,0,0,0,0,1,0,0,1
mingo county,1,0,0,0,0,0,0,1
mini barbecue,0,1,0,0,0,0,0,1
mini orchard,0,0,0,0,1,0,0,1
miniature golf,0,1,0,0,0,0,0,1
minimize damage,0,0,0,1,0,0,0,1
minimize flaring,0,1,0,0,0,0,0,1
minimize human,0,0,0,0,1,0,0,1
minimum standards,0,0,0,1,0,0,0,1
minimum wage,0,0,0,0,0,1,0,1
mining activity,0,0,0,0,1,0,0,1
mining companies,1,0,0,0,0,0,0,1
mining company,0,0,0,1,0,0,0,1
mining control,1,0,0,0,0,0,0,1
mining economy,0,0,0,0,1,0,0,1
mining families,0,1,0,0,0,0,0,1
mining haywood's,0,1,0,0,0,0,0,1
mining operations,1,0,0,0,0,0,0,1
mining permit,1,0,0,0,0,0,0,1
mining plastic,0,0,0,0,1,0,0,1
mining project,0,1,0,0,0,0,0,1
mining ranching,0,1,0,0,0,0,0,1
mining region,0,0,0,0,1,0,0,1
mining tunnel,0,0,0,0,1,0,0,1
mining walk,1,0,0,0,0,0,0,1
minister dmytro,0,0,0,1,0,0,0,1
minister giorgia,0,1,0,0,0,0,0,1
minister justin,0,0,0,0,0,1,0,1
minister kaimuddin,0,0,0,0,1,0,0,1
minister responsible,0,0,1,0,0,0,0,1
minister rishi,0,1,0,0,0,0,0,1
minister sameh,0,0,0,1,0,0,0,1
minister shehbaz,0,1,0,0,0,0,0,1
minister sherry,0,1,0,0,0,0,0,1
minister tanya,0,1,0,0,0,0,0,1
minister therese,0,0,0,0,0,1,0,1
minister's office,0,0,0,1,0,0,0,1
ministers secretaries,0,1,0,0,0,0,0,1
ministry spokesperson,0,0,0,0,1,0,0,1
minke whales,0,0,0,0,1,0,0,1
minor compared,1,0,0,0,0,0,0,1
minor consumption,0,0,0,0,0,1,0,1
minor damage,0,1,0,0,0,0,0,1
minor greens,0,1,0,0,0,0,0,1
minority opinion,0,0,1,0,0,0,0,1
minors giacomo,0,1,0,0,0,0,0,1
mint sneha,0,1,0,0,0,0,0,1
minus bones,0,1,0,0,0,0,0,1
minute message,0,0,0,0,0,1,0,1
minute walk,0,0,0,1,0,0,0,1
minutes average,0,0,0,1,0,0,0,1
minutes drive,0,1,0,0,0,0,0,1
minutes homeless,0,0,0,0,1,0,0,1
minutes kcrw,0,0,1,0,0,0,0,1
minutes yamada,0,0,0,0,1,0,0,1
mira 1st,0,0,0,0,1,0,0,1
miraculously appearing,0,1,0,0,0,0,0,1
miranda green,0,0,1,0,0,0,0,1
mired california,0,0,0,1,0,0,0,1
miriam kshensky,0,0,0,0,1,0,0,1
mirror bruce,0,0,0,0,1,0,0,1
misako hirai,0,0,0,0,1,0,0,1
misinformation online,0,0,0,0,1,0,0,1
misinformation spread,0,0,0,0,1,0,0,1
misinformation spreads,0,0,0,0,1,0,0,1
mislead investors,0,0,0,1,0,0,0,1
mismanaging water,0,0,0,0,0,1,0,1
miss ashley,0,0,0,0,0,1,0,1
miss earth,0,1,0,0,0,0,0,1
miss julio,0,0,0,0,0,1,0,1
miss tourism,0,1,0,0,0,0,0,1
missed huh,0,0,1,0,0,0,0,1
missed opportunity,0,0,0,0,1,0,0,1
misses skating,0,0,0,0,1,0,0,1
missile sites,0,0,0,0,1,0,0,1
missile technology,0,0,0,1,0,0,0,1
missing lin's,0,1,0,0,0,0,0,1
missing people,1,0,0,0,0,0,0,1
missing related,0,1,0,0,0,0,0,1
missing rescuers,1,0,0,0,0,0,0,1
missing roads,1,0,0,0,0,0,0,1
mission ralston,0,0,0,0,1,0,0,1
mississippi alabama,0,0,0,0,0,1,0,1
mississippi antarctic,0,1,0,0,0,0,0,1
mississippi committee,0,1,0,0,0,0,0,1
mississippi deposited,0,1,0,0,0,0,0,1
mississippi experts,0,0,0,0,0,1,0,1
mississippi history,0,0,0,0,0,1,0,1
mississippi residents,0,0,0,0,0,0,1,1
mississippi scott,0,0,0,0,0,1,0,1
mississippi tornado,0,0,0,0,0,1,0,1
mississippi valley,0,0,0,0,0,0,1,1
missouri cities,0,0,0,0,0,1,0,1
missouri illinois,0,0,0,0,1,0,0,1
missouri tornado,0,0,0,0,0,1,0,1
misspent funds,0,0,0,0,0,0,1,1
mistaken fanning,0,0,1,0,0,0,0,1
mistich brings,1,0,0,0,0,0,0,1
mistich npr,1,0,0,0,0,0,0,1
misunderstood creature,1,0,0,0,0,0,0,1
mit studies,0,0,0,0,1,0,0,1
mitchell getty,0,1,0,0,0,0,0,1
mitchell jelani,1,0,0,0,0,0,0,1
mitigate anymore,1,0,0,0,0,0,0,1
mitigate damages,0,1,0,0,0,0,0,1
mitigate environmental,0,1,0,0,0,0,0,1
mitigate flooding,1,0,0,0,0,0,0,1
mitigate impacts,0,0,0,0,1,0,0,1
mitigation center,0,0,1,0,0,0,0,1
mitigation funds,0,0,0,0,0,1,0,1
mitigation measures,0,0,1,0,0,0,0,1
mitigation programs,1,0,0,0,0,0,0,1
mitigation projects,0,1,0,0,0,0,0,1
mitigation staff,1,0,0,0,0,0,0,1
mitigation tactics,1,0,0,0,0,0,0,1
mitigation tool,0,1,0,0,0,0,0,1
mitt romney's,0,0,0,0,1,0,0,1
mixed bag,0,0,1,0,0,0,0,1
mixed media,0,0,0,1,0,0,0,1
mixing bowl,0,1,0,0,0,0,0,1
mixing cow,0,0,0,0,0,1,0,1
mixing hydrogen,0,1,0,0,0,0,0,1
mmm hmm,0,0,0,0,1,0,0,1
mobile processing,0,1,0,0,0,0,0,1
mobile ultrasound,1,0,0,0,0,0,0,1
mobile water,0,0,0,0,0,1,0,1
mobilized immediately,0,1,0,0,0,0,0,1
mobilized national,0,0,0,0,1,0,0,1
mobilized roughly,0,1,0,0,0,0,0,1
mobilizing sympathizers,0,1,0,0,0,0,0,1
mod means,0,1,0,0,0,0,0,1
mode dealing,0,1,0,0,0,0,0,1
model called,0,0,0,0,1,0,0,1
model ordinances,0,0,0,0,1,0,0,1
model severe,0,0,0,0,0,0,1,1
model simulations,0,0,0,1,0,0,0,1
modeling analysis,0,0,0,0,0,1,0,1
modeling charted,0,0,0,1,0,0,0,1
models fan,1,0,0,0,0,0,0,1
models global,0,0,0,0,1,0,0,1
models remain,0,0,0,0,0,1,0,1
models triple,0,0,0,0,0,1,0,1
moderate income,0,0,0,1,0,0,0,1
moderate levels,0,0,0,0,0,1,0,1
modern boilers,1,0,0,0,0,0,0,1
modern culture,1,0,0,0,0,0,0,1
modern day,0,0,0,0,0,1,0,1
modern demands,0,0,0,1,0,0,0,1
modern history,1,0,0,0,0,0,0,1
modern land,1,0,0,0,0,0,0,1
modern world,0,0,0,1,0,0,0,1
modernize arizona's,0,0,0,0,1,0,0,1
modest rise,1,0,0,0,0,0,0,1
modest success,0,1,0,0,0,0,0,1
moench counted,0,0,0,0,1,0,0,1
moench president,0,0,0,0,1,0,0,1
mofty ap,0,1,0,0,0,0,0,1
mohamed jumped,0,1,0,0,0,0,0,1
mohamed nasr,0,1,0,0,0,0,0,1
mohamed sits,0,1,0,0,0,0,0,1
mohammed bin,0,0,0,1,0,0,0,1
moises castillo,1,0,0,0,0,0,0,1
moisture channeling,0,0,0,0,0,1,0,1
moisture hints,0,0,0,1,0,0,0,1
moisture nick,0,0,1,0,0,0,0,1
molecule found,0,0,0,0,0,1,0,1
moment listen,1,0,0,0,0,0,0,1
moment mwenja,1,0,0,0,0,0,0,1
momentary political,0,1,0,0,0,0,0,1
mona blue,0,1,0,0,0,0,0,1
monday approved,0,0,0,0,0,1,0,1
monday biden,1,0,0,0,0,0,0,1
monday interview,0,0,0,1,0,0,0,1
monday night,0,0,0,0,0,1,0,1
monday predicts,0,0,0,1,0,0,0,1
monday researchers,0,0,0,1,0,0,0,1
monday troy,0,0,0,1,0,0,0,1
monday warning,0,1,0,0,0,0,0,1
monday's announcement,0,0,0,0,0,1,0,1
monday's hearing,0,0,0,0,0,1,0,1
monday's journal,0,0,0,1,0,0,0,1
monday's oral,0,0,0,0,0,1,0,1
monetary policy,0,1,0,0,0,0,0,1
money britt,0,0,1,0,0,0,0,1
money building,0,0,1,0,0,0,0,1
money crosstalk,1,0,0,0,0,0,0,1
money diversifying,1,0,0,0,0,0,0,1
money extra,0,1,0,0,0,0,0,1
money finances,0,1,0,0,0,0,0,1
money flow,0,1,0,0,0,0,0,1
money heading,0,0,0,0,1,0,0,1
money israel,0,1,0,0,0,0,0,1
money organization,0,0,0,0,1,0,0,1
money power,0,0,0,1,0,0,0,1
money reid,0,1,0,0,0,0,0,1
money reported,0,0,0,0,0,1,0,1
money tied,0,0,0,0,0,0,1,1
money times,0,0,0,0,0,0,1,1
money twitter,0,0,1,0,0,0,0,1
money wealthier,0,1,0,0,0,0,0,1
money's paddy,0,0,0,1,0,0,0,1
moneymaking animal,0,0,0,0,1,0,0,1
mongering emails,0,0,1,0,0,0,0,1
monica medina,0,0,0,0,1,0,0,1
monica range,0,0,1,0,0,0,0,1
monitor water,0,0,0,0,0,1,0,1
monitoring stations,0,0,0,1,0,0,0,1
monitors tim,0,0,0,1,0,0,0,1
monkeys originally,0,0,0,0,0,1,0,1
monoxide oxides,0,0,0,0,1,0,0,1
monoxide poisoning,1,0,0,0,0,0,0,1
monroe n.j,0,0,0,0,1,0,0,1
monschauer energy,0,0,0,0,0,0,1,1
monsoonal rains,1,0,0,0,0,0,0,1
monster storm,1,0,0,0,0,0,0,1
montana live,0,0,0,0,0,1,0,1
montana lobbycard,0,0,1,0,0,0,0,1
montana south,0,0,0,0,1,0,0,1
montana watching,0,0,0,0,1,0,0,1
monte dam,0,1,0,0,0,0,0,1
montebello patrick,0,0,0,0,0,1,0,1
montecito killing,0,0,0,1,0,0,0,1
montecito mudslides,0,0,0,1,0,0,0,1
montecito occurred,0,0,0,1,0,0,0,1
montecito resident,0,0,0,1,0,0,0,1
montecito tragedy,0,0,0,1,0,0,0,1
monterey counties,0,0,0,1,0,0,0,1
monterrey metropolitan,0,0,0,0,0,1,0,1
montes carro,0,0,0,1,0,0,0,1
montgomery alabama's,0,0,1,0,0,0,0,1
montgomery kyle,0,0,0,1,0,0,0,1
montgomery office,0,0,1,0,0,0,0,1
montgomery toure,0,0,0,1,0,0,0,1
month alabama,0,0,1,0,0,0,0,1
month cox,0,0,0,0,1,0,0,1
month crosstalk,0,1,0,0,0,0,0,1
month earlier,0,0,0,0,0,1,0,1
month found,0,0,0,0,0,0,1,1
month outages,1,0,0,0,0,0,0,1
month period,0,1,0,0,0,0,0,1
month poland's,0,0,0,0,0,1,0,1
month proceeds,0,0,0,0,1,0,0,1
month's climate,0,0,1,0,0,0,0,1
month's worth,0,0,0,0,0,1,0,1
monthly visitors,0,0,1,0,0,0,0,1
months afterward,0,0,0,1,0,0,0,1
months ago.martí,0,0,0,0,1,0,0,1
months attorney,0,0,0,1,0,0,0,1
months earlier,0,0,0,0,0,1,0,1
months previous,0,1,0,0,0,0,0,1
months researching,0,0,0,0,1,0,0,1
months shareholders,0,0,0,0,0,0,1,1
months sleeping,0,1,0,0,0,0,0,1
montreal canada,0,0,1,0,0,0,0,1
montreal china,0,0,1,0,0,0,0,1
montreal negotiators,0,0,1,0,0,0,0,1
monumentally challenging,0,0,1,0,0,0,0,1
moody's rms,0,0,0,0,1,0,0,1
moomal mallah,1,0,0,0,0,0,0,1
moore oklahoma,0,0,0,0,0,1,0,1
mora county,1,0,0,0,0,0,0,1
mora n.m,1,0,0,0,0,0,0,1
moral heart,0,1,0,0,0,0,0,1
moral imperative,0,0,1,0,0,0,0,1
moral mistake,0,0,0,0,1,0,0,1
moral weight,0,0,0,1,0,0,0,1
morgan explains,0,1,0,0,0,0,0,1
morgan fetched,0,1,0,0,0,0,0,1
morin afp,1,0,0,0,0,0,0,1
morning ayesha,0,1,0,0,0,0,0,1
morning biedul,0,0,0,0,1,0,0,1
morning carly,0,0,0,0,1,0,0,1
morning carrie,0,0,0,1,0,0,0,1
morning edition's,0,1,0,0,0,0,0,1
morning eleanor,0,0,0,1,0,0,0,1
morning forced,0,0,0,1,0,0,0,1
morning hey,0,0,0,0,0,0,1,1
morning hours,0,0,0,0,0,0,1,1
morning included,0,0,0,0,1,0,0,1
morning john,0,1,0,0,0,0,0,1
morning kayaking,0,0,0,1,0,0,0,1
morning kyle,0,0,1,0,0,0,0,1
morning michael,0,0,0,0,0,0,1,1
morning pt,0,0,0,0,1,0,0,1
morning scott,0,0,0,1,0,0,0,1
morning shortly,0,1,0,0,0,0,0,1
morning tuesday,0,1,0,0,0,0,0,1
moroccan authorities,0,1,0,0,0,0,0,1
moroccan beach,0,1,0,0,0,0,0,1
moroccan officials,0,1,0,0,0,0,0,1
moroccan police,0,1,0,0,0,0,0,1
morocco melilla,0,1,0,0,0,0,0,1
morocco ricci,0,1,0,0,0,0,0,1
morris county,0,1,0,0,0,0,0,1
mortality events,0,0,0,0,1,0,0,1
mortality rates,1,0,0,0,0,0,0,1
mortgage brokers,0,0,0,0,0,1,0,1
mortgage rates,0,0,0,0,0,1,0,1
mose buchele,0,0,0,0,1,0,0,1
moses arranged,0,1,0,0,0,0,0,1
moses nderitu,0,1,0,0,0,0,0,1
mosque domes,1,0,0,0,0,0,0,1
mosquitoes bearing,1,0,0,0,0,0,0,1
mosquitoes spread,0,0,0,1,0,0,0,1
moth grubs,0,0,0,0,0,1,0,1
mother explains,1,0,0,0,0,0,0,1
mother michelle,0,0,0,0,0,1,0,1
mother rhino,0,1,0,0,0,0,0,1
mother survived,1,0,0,0,0,0,0,1
mother's boyfriend,0,0,0,0,0,0,1,1
mother's hometown,1,0,0,0,0,0,0,1
mothers who've,1,0,0,0,0,0,0,1
motivate people,0,0,0,1,0,0,0,1
motivations holt,0,0,0,1,0,0,0,1
motives driving,0,0,1,0,0,0,0,1
motor lopez,0,0,0,0,1,0,0,1
motor north,0,0,0,0,1,0,0,1
motor rigged,1,0,0,0,0,0,0,1
motorcycle taxis,1,0,0,0,0,0,0,1
motors disclosed,0,0,1,0,0,0,0,1
motors honda,0,0,0,0,0,1,0,1
mound's edge,1,0,0,0,0,0,0,1
mounds built,1,0,0,0,0,0,0,1
mount kiliminjaro,0,1,0,0,0,0,0,1
mountain communities,0,0,0,0,0,1,0,1
mountain crosstalk,0,0,0,0,0,1,0,1
mountain foothills,0,1,0,0,0,0,0,1
mountain ranges,0,0,0,1,0,0,0,1
mountain requiring,0,1,0,0,0,0,0,1
mountain runoff,0,1,0,0,0,0,0,1
mountain trails,0,1,0,0,0,0,0,1
mountain trekking,0,1,0,0,0,0,0,1
mountainous island,0,1,0,0,0,0,0,1
mountains climb,0,1,0,0,0,0,0,1
mountains conservancy,0,0,1,0,0,0,0,1
mountains creates,0,0,1,0,0,0,0,1
mountains disappearing,0,1,0,0,0,0,0,1
mountains east,0,0,0,0,0,1,0,1
mountains means,0,0,0,0,0,1,0,1
mountains north,0,0,0,0,1,0,0,1
mountains northeast,0,0,0,0,1,0,0,1
mountains rainfall,0,0,0,0,1,0,0,1
mountains verdugo,0,0,1,0,0,0,0,1
mounting losses,0,1,0,0,0,0,0,1
moura paulamoura_san,0,0,0,0,0,1,0,1
moura wbur,0,0,0,0,0,1,0,1
mouse game,0,1,0,0,0,0,0,1
moussa walked,0,0,1,0,0,0,0,1
move aggressively,0,0,0,0,0,1,0,1
move colorado,0,1,0,0,0,0,0,1
move entire,0,0,0,0,0,1,0,1
move hurt,1,0,0,0,0,0,0,1
move indonesia,0,0,0,0,1,0,0,1
move markets,1,0,0,0,0,0,0,1
move money,0,1,0,0,0,0,0,1
move prices,1,0,0,0,0,0,0,1
move.in participating,0,0,0,0,1,0,0,1
moved close,0,0,0,1,0,0,0,1
movement bangladeshis,1,0,0,0,0,0,0,1
movements pattie,1,0,0,0,0,0,0,1
moves east,0,0,0,0,0,1,0,1
movie roma,0,0,1,0,0,0,0,1
movie starring,0,1,0,0,0,0,0,1
moving downward,0,0,0,1,0,0,0,1
moving emergency,0,0,0,0,0,1,0,1
moving northward,0,0,0,0,0,1,0,1
moving past,0,1,0,0,0,0,0,1
moving river,0,0,0,1,0,0,0,1
moving storm,1,0,0,0,0,0,0,1
moving target,0,0,0,0,0,1,0,1
mph based,0,0,0,0,0,1,0,1
mph nicole,0,1,0,0,0,0,0,1
mubadala abu,0,0,0,1,0,0,0,1
mubadala invested,0,0,0,1,0,0,0,1
much.for npr,0,1,0,0,0,0,0,1
mucous membranes,0,0,0,0,0,1,0,1
mud biedul,0,0,0,0,1,0,0,1
mud clinging,0,1,0,0,0,0,0,1
mud denia,0,0,0,0,0,0,1,1
mud slides,0,0,0,0,1,0,0,1
mud washed,0,1,0,0,0,0,0,1
muddy light,1,0,0,0,0,0,0,1
muddy mess,0,0,0,0,0,1,0,1
muddy mound,1,0,0,0,0,0,0,1
muddy shore,1,0,0,0,0,0,0,1
muddy tract,0,0,0,0,0,1,0,1
mudhole destroying,0,1,0,0,0,0,0,1
mudslides damaged,0,0,0,0,0,1,0,1
mudslides earlier,0,0,0,1,0,0,0,1
mudslides flash,0,0,0,1,0,0,0,1
mudslides hit,0,0,0,1,0,0,0,1
mudslides power,0,0,0,1,0,0,0,1
mudslides roared,0,0,0,1,0,0,0,1
muhammad shehbaz,0,1,0,0,0,0,0,1
mulch shredded,1,0,0,0,0,0,0,1
mulekatete communications,0,0,0,0,1,0,0,1
muller landau,0,0,1,0,0,0,0,1
multi faceted,0,1,0,0,0,0,0,1
multi hour,0,1,0,0,0,0,0,1
multi million,0,1,0,0,0,0,0,1
multi organ,0,0,0,0,0,1,0,1
multi pronged,0,0,0,0,0,1,0,1
multibillionaire businessman,1,0,0,0,0,0,0,1
multiday precipitation,0,0,0,0,1,0,0,1
multidecade dry,0,0,1,0,0,0,0,1
multidisciplinary team,0,1,0,0,0,0,0,1
multilateral agenda,0,1,0,0,0,0,0,1
multilateral development,0,1,0,0,0,0,0,1
multinationals win.martí,0,0,0,0,0,1,0,1
multiple atmospheric,0,0,0,0,0,0,1,1
multiple buildings,1,0,0,0,0,0,0,1
multiple continents.our,0,1,0,0,0,0,0,1
multiple counties,0,1,0,0,0,0,0,1
multiple countries,0,1,0,0,0,0,0,1
multiple crops,0,1,0,0,0,0,0,1
multiple devastating,0,0,0,0,1,0,0,1
multiple fences,0,1,0,0,0,0,0,1
multiple fixes,0,0,0,1,0,0,0,1
multiple inquiries,0,0,0,0,1,0,0,1
multiple reasons,0,0,0,0,1,0,0,1
multiple regulators,1,0,0,0,0,0,0,1
multiple sets,0,1,0,0,0,0,0,1
multiple storms,0,0,0,1,0,0,0,1
multiple types,1,0,0,0,0,0,0,1
multiple u.s,0,0,1,0,0,0,0,1
multiple world,0,1,0,0,0,0,0,1
multiplier exacerbating,1,0,0,0,0,0,0,1
multiplier opponents,1,0,0,0,0,0,0,1
multiyear drought,0,0,0,1,0,0,0,1
mumbai hey,0,1,0,0,0,0,0,1
municipal clay,0,0,0,1,0,0,0,1
municipal employee,0,1,0,0,0,0,0,1
municipal utility,0,0,0,1,0,0,0,1
municipal water,0,0,0,1,0,0,0,1
munoz afp,0,0,0,0,1,0,0,1
mural inches,0,0,0,1,0,0,0,1
mural painted,0,0,0,1,0,0,0,1
murillo told,1,0,0,0,0,0,0,1
murky blue,0,0,0,1,0,0,0,1
murky surroundings,0,0,0,0,0,1,0,1
muscle biologist,0,1,0,0,0,0,0,1
museum artwork,0,0,1,0,0,0,0,1
museum grounds,0,1,0,0,0,0,0,1
mushroom glaze,0,1,0,0,0,0,0,1
music community,0,1,0,0,0,0,0,1
music composed,0,0,0,1,0,0,0,1
music legend,0,1,0,0,0,0,0,1
music minded,0,1,0,0,0,0,0,1
music rubbery,0,0,1,0,0,0,0,1
music scene,0,1,0,0,0,0,0,1
musical communities,0,1,0,0,0,0,0,1
musicians dwight,0,1,0,0,0,0,0,1
musk's spacex,1,0,0,0,0,0,0,1
muslim autonomous,1,0,0,0,0,0,0,1
muslim call,0,1,0,0,0,0,0,1
muslims living,0,1,0,0,0,0,0,1
mussels crabs,1,0,0,0,0,0,0,1
muthogo hopes,1,0,0,0,0,0,0,1
mwenja referring,1,0,0,0,0,0,0,1
mwenja's neighbors,1,0,0,0,0,0,0,1
myakka river,1,0,0,0,0,0,0,1
myakka rivers,1,0,0,0,0,0,0,1
myer told,0,1,0,0,0,0,0,1
myers florida,1,0,0,0,0,0,0,1
mysterious items,0,0,0,0,0,0,1,1
mythical river,1,0,0,0,0,0,0,1
mythology muslims,0,1,0,0,0,0,0,1
n.c david,0,1,0,0,0,0,0,1
n.c days,0,0,0,0,1,0,0,1
n.c lithium,0,1,0,0,0,0,0,1
n.j delaware,0,0,0,1,0,0,0,1
n.y avengers,0,0,0,1,0,0,0,1
n.y jeffrey,0,0,0,1,0,0,0,1
n.y junior,0,0,0,1,0,0,0,1
n'dar ricci,0,1,0,0,0,0,0,1
nabisco easy,0,0,0,1,0,0,0,1
nackstrand afp,0,1,0,0,0,0,0,1
nadel executive,0,0,0,0,0,0,1,1
nador door,0,1,0,0,0,0,0,1
nadu tsunami,0,1,0,0,0,0,0,1
nagel started,0,1,0,0,0,0,0,1
naguib sinarimbo,1,0,0,0,0,0,0,1
nairobi based,1,0,0,0,0,0,0,1
nairobi national,0,1,0,0,0,0,0,1
nairobi water,0,0,0,0,0,1,0,1
nalik heard,0,0,0,1,0,0,0,1
named hayabusa,0,0,0,0,0,1,0,1
named icefin,0,0,0,0,1,0,0,1
named jason,0,0,0,0,1,0,0,1
named malecon,0,1,0,0,0,0,0,1
named matador,0,1,0,0,0,0,0,1
named president,0,0,0,1,0,0,0,1
named steven,0,1,0,0,0,0,0,1
named susan,0,0,0,0,1,0,0,1
named thierry,0,0,0,0,0,1,0,1
nancy solomon,0,0,0,0,1,0,0,1
nancy stroud,1,0,0,0,0,0,0,1
naomi oreskes,0,0,0,0,1,0,0,1
napa marin,0,0,0,1,0,0,0,1
napa mariposa,0,0,0,1,0,0,0,1
naples prefect,0,1,0,0,0,0,0,1
nariman el,0,1,0,0,0,0,0,1
narrative helped,0,0,0,1,0,0,0,1
narrow boats,0,0,0,0,1,0,0,1
narrow dirt,1,0,0,0,0,0,0,1
narrow furry,0,0,1,0,0,0,0,1
narrow rivers,0,0,0,0,0,1,0,1
narrow riverside,0,1,0,0,0,0,0,1
narrow violently,0,0,0,0,0,1,0,1
narrow winding,0,1,0,0,0,0,0,1
narrowly avoided,0,1,0,0,0,0,0,1
narrowly escaped,0,1,0,0,0,0,0,1
narrowly missed,1,0,0,0,0,0,0,1
nasa announced,1,0,0,0,0,0,0,1
nasa app,0,0,0,1,0,0,0,1
nasa coordinate,0,0,0,1,0,0,0,1
nasa coordinator,0,0,0,1,0,0,0,1
nasa hide,0,1,0,0,0,0,0,1
nasa instrument,1,0,0,0,0,0,0,1
nasa shared,1,0,0,0,0,0,0,1
nasa slack,0,0,0,1,0,0,0,1
nasa's earth,0,0,0,0,1,0,0,1
nascent cultivated,0,1,0,0,0,0,0,1
naselroad examines,0,1,0,0,0,0,0,1
naselroad luthier,0,1,0,0,0,0,0,1
nashville ashley,0,0,0,0,0,1,0,1
nasr egypt's,0,1,0,0,0,0,0,1
nasuri saidu,0,0,1,0,0,0,0,1
natalie mahowald,0,0,0,1,0,0,0,1
nate anytime,0,0,0,0,0,1,0,1
nate hey,0,0,1,0,0,0,0,1
nate rott's,0,1,0,0,0,0,0,1
nathan stay,0,0,0,0,0,1,0,1
nathaniel reed,1,0,0,0,0,0,0,1
nation adopts,0,0,0,1,0,0,0,1
nation authorities,0,0,0,1,0,0,0,1
nation cassells,0,1,0,0,0,0,0,1
nation germany.martí,0,0,0,0,0,1,0,1
nation reliant,0,0,0,1,0,0,0,1
nation reservation,0,0,0,0,0,1,0,1
nation sunday,1,0,0,0,0,0,0,1
nation's freight,0,0,0,0,0,1,0,1
nation's wealthiest,0,0,1,0,0,0,0,1
nation's worst,0,0,0,0,0,1,0,1
national adaptation,0,0,0,0,1,0,0,1
national advertiser,0,0,1,0,0,0,0,1
national analysis,0,0,0,1,0,0,0,1
national association,1,0,0,0,0,0,0,1
national basis,0,0,0,1,0,0,0,1
national boundaries,0,0,0,0,1,0,0,1
national capital,0,0,0,0,1,0,0,1
national cemetery,0,0,0,0,1,0,0,1
national center,1,0,0,0,0,0,0,1
national collection,0,0,0,1,0,0,0,1
national community,1,0,0,0,0,0,0,1
national conservative,0,0,0,0,1,0,0,1
national debts,0,1,0,0,0,0,0,1
national disaster,1,0,0,0,0,0,0,1
national drought,0,0,1,0,0,0,0,1
national emissions,1,0,0,0,0,0,0,1
national gallery,0,1,0,0,0,0,0,1
national governments,1,0,0,0,0,0,0,1
national headlines,0,1,0,0,0,0,0,1
national heritage,0,1,0,0,0,0,0,1
national historic,0,0,0,0,1,0,0,1
national historical,1,0,0,0,0,0,0,1
national institute,0,0,0,0,1,0,0,1
national lab,0,0,0,0,1,0,0,1
national meeting,0,0,1,0,0,0,0,1
national museum,0,1,0,0,0,0,0,1
national network,0,0,0,0,1,0,0,1
national oceanographic,0,0,0,0,0,1,0,1
national policies,0,1,0,0,0,0,0,1
national public,0,0,0,0,1,0,0,1
national regulations,0,0,0,0,0,1,0,1
national representatives,0,1,0,0,0,0,0,1
national science,0,0,0,0,1,0,0,1
national significance,0,0,0,1,0,0,0,1
national snow,0,0,0,0,1,0,0,1
national sources,0,0,0,0,1,0,0,1
national sustainable,0,0,0,0,0,0,1,1
national temperatures,0,0,0,0,0,1,0,1
national toboggan,0,0,0,0,1,0,0,1
national treasury,1,0,0,0,0,0,0,1
national update,0,0,0,1,0,0,0,1
national vehicle,0,0,0,0,1,0,0,1
national wildlife,0,0,1,0,0,0,0,1
nationalist party,0,0,0,0,0,1,0,1
nationality sexual,0,0,0,0,1,0,0,1
nationally determined,0,1,0,0,0,0,0,1
nationally strategic,0,0,0,0,1,0,0,1
nationally successful,0,1,0,0,0,0,0,1
nationally truck,0,0,1,0,0,0,0,1
nations accountable,0,1,0,0,0,0,0,1
nations agreed,0,1,0,0,0,0,0,1
nations ambassador,0,1,0,0,0,0,0,1
nations announced,0,1,0,0,0,0,0,1
nations biodiversity,0,0,1,0,0,0,0,1
nations china,0,1,0,0,0,0,0,1
nations convention,0,0,1,0,0,0,0,1
nations deal,0,1,0,0,0,0,0,1
nations documenting,0,1,0,0,0,0,0,1
nations estimates,0,1,0,0,0,0,0,1
nations fail,0,0,1,0,0,0,0,1
nations framework,0,1,0,0,0,0,0,1
nations gather,0,0,0,0,0,1,0,1
nations gore,0,1,0,0,0,0,0,1
nations industrialized,0,1,0,0,0,0,0,1
nations intergovernmental,0,0,0,1,0,0,0,1
nations meet,0,0,0,0,0,1,0,1
nations meeting,0,0,0,1,0,0,0,1
nations meetings,0,1,0,0,0,0,0,1
nations mobilized,0,1,0,0,0,0,0,1
nations offers,0,0,0,0,0,1,0,1
nations plan,0,1,0,0,0,0,0,1
nations pledges,1,0,0,0,0,0,0,1
nations prepare,0,1,0,0,0,0,0,1
nations recently,0,0,0,0,0,0,1,1
nations reports,0,0,0,0,0,1,0,1
nations resident,0,0,0,0,1,0,0,1
nations u.n,0,0,0,0,0,1,0,1
nations warned,0,1,0,0,0,0,0,1
nationwide claiming,0,0,0,1,0,0,0,1
nationwide events,0,0,0,0,0,1,0,1
nationwide program,0,0,0,0,1,0,0,1
native alaskan,0,0,0,0,0,1,0,1
native americans,0,0,1,0,0,0,0,1
native growth,1,0,0,0,0,0,0,1
native leaders,0,0,0,0,0,1,0,1
native pape,0,0,0,0,1,0,0,1
native rights,0,0,0,0,0,1,0,1
native speakers,0,0,0,1,0,0,0,1
native told,1,0,0,0,0,0,0,1
native tribal,0,0,1,0,0,0,0,1
native village,0,0,0,0,0,1,0,1
natural barriers,1,0,0,0,0,0,0,1
natural benefits,0,0,0,0,0,0,1,1
natural defenses,0,0,0,0,0,0,1,1
natural desert,1,0,0,0,0,0,0,1
natural disaster,0,0,1,0,0,0,0,1
natural ecosystem,0,0,0,1,0,0,0,1
natural environment,0,0,0,1,0,0,0,1
natural experiment,0,0,1,0,0,0,0,1
natural forest,0,0,0,1,0,0,0,1
natural habitat,0,0,1,0,0,0,0,1
natural hazards,0,0,0,1,0,0,0,1
natural process,1,0,0,0,0,0,0,1
natural processes,1,0,0,0,0,0,0,1
natural sources,1,0,0,0,0,0,0,1
natural space,0,0,0,1,0,0,0,1
natural sponges,0,0,0,0,0,1,0,1
natural surfaces,0,0,0,1,0,0,0,1
natural systems,0,0,0,0,1,0,0,1
natural topography,0,0,0,0,1,0,0,1
natural weather,0,0,0,1,0,0,0,1
naturally extreme,0,0,0,1,0,0,0,1
naturally frozen,0,0,0,0,1,0,0,1
naturally resistant,0,0,0,0,0,1,0,1
nature adam,0,0,0,0,0,1,0,1
nature based,0,1,0,0,0,0,0,1
nature changing,0,1,0,0,0,0,0,1
nature dry,0,0,1,0,0,0,0,1
nature equivalent,0,0,1,0,0,0,0,1
nature grew,0,1,0,0,0,0,0,1
nature lists,1,0,0,0,0,0,0,1
nature related,0,0,1,0,0,0,0,1
nature released,0,1,0,0,0,0,0,1
nature schaeffer,0,0,1,0,0,0,0,1
nature told,0,0,1,0,0,0,0,1
nature u.s,0,0,0,0,1,0,0,1
nature woodhouse,0,0,0,0,0,1,0,1
nature's decline,0,0,1,0,0,0,0,1
nature's ultimate,0,0,0,0,0,1,0,1
nausea vomiting,0,0,0,0,0,1,0,1
navajo chapter,0,1,0,0,0,0,0,1
navajo treaty,0,0,0,0,0,1,0,1
naval blockade,1,0,0,0,0,0,0,1
naval shipyard,0,1,0,0,0,0,0,1
naval station,0,1,0,0,0,0,0,1
navigating dangerous,0,0,0,0,1,0,0,1
navigating flooded,0,0,0,1,0,0,0,1
navy base,0,1,0,0,0,0,0,1
navy figure,0,1,0,0,0,0,0,1
nazis killed,0,0,0,1,0,0,0,1
nderitu happened,0,1,0,0,0,0,0,1
nearby bodegas,0,0,0,1,0,0,0,1
nearby cities,0,0,0,0,1,0,0,1
nearby creeks,0,0,0,0,0,1,0,1
nearby donkey,1,0,0,0,0,0,0,1
nearby empty,1,0,0,0,0,0,0,1
nearby family,0,0,0,0,0,0,1,1
nearby farms,1,0,0,0,0,0,0,1
nearby glacial,0,1,0,0,0,0,0,1
nearby hives,0,0,0,1,0,0,0,1
nearby homeless,0,0,0,1,0,0,0,1
nearby hospitals,1,0,0,0,0,0,0,1
nearby hub,1,0,0,0,0,0,0,1
nearby lake,1,0,0,0,0,0,0,1
nearby levee,1,0,0,0,0,0,0,1
nearby mining,1,0,0,0,0,0,0,1
nearby mountain,0,0,0,1,0,0,0,1
nearby mountains,0,1,0,0,0,0,0,1
nearby restaurants,1,0,0,0,0,0,0,1
nearby river,0,0,0,0,1,0,0,1
nearby swamp,0,1,0,0,0,0,0,1
nearby town,0,1,0,0,0,0,0,1
nearby towns,0,0,0,0,0,1,0,1
nearby tree,0,0,0,1,0,0,0,1
nearby villages,1,0,0,0,0,0,0,1
nearest j.h.s,0,0,0,1,0,0,0,1
neat green,0,1,0,0,0,0,0,1
neat sum,0,1,0,0,0,0,0,1
nebraska medical,0,0,1,0,0,0,0,1
nebraska native,1,0,0,0,0,0,0,1
nebraska rees,0,0,0,0,0,0,1,1
necessarily contribute,0,1,0,0,0,0,0,1
necessarily displaced,0,0,0,1,0,0,0,1
necessarily shifting,0,0,0,0,0,0,1,1
necessarily stay,0,0,0,0,1,0,0,1
necessarily tall,1,0,0,0,0,0,0,1
necessarily vanos,0,0,0,1,0,0,0,1
neck burns,0,0,0,0,1,0,0,1
needed.for npr,0,0,0,0,0,1,0,1
needle biopsy,0,1,0,0,0,0,0,1
needless obstacles,0,0,0,1,0,0,0,1
neela banerjee,0,1,0,0,0,0,0,1
negative impacts,0,1,0,0,0,0,0,1
negative temperatures,0,0,0,0,1,0,0,1
negatively affect,0,1,0,0,0,0,0,1
negotiating aid,0,1,0,0,0,0,0,1
negotiating clout,0,1,0,0,0,0,0,1
negotiating item,0,1,0,0,0,0,0,1
negotiation skills,0,0,0,1,0,0,0,1
negotiations absolutely,1,0,0,0,0,0,0,1
negotiations centers,0,1,0,0,0,0,0,1
negotiations closely,0,0,0,0,1,0,0,1
negotiations concerned,0,1,0,0,0,0,0,1
negotiations hope,0,0,0,1,0,0,0,1
negotiations rolled,0,1,0,0,0,0,0,1
negotiations scheduled,0,1,0,0,0,0,0,1
negotiations scientists,0,0,0,0,0,1,0,1
negotiations suspended,0,0,0,0,1,0,0,1
negotiations wednesday,0,0,1,0,0,0,0,1
negotiators reached,0,0,1,0,0,0,0,1
neighbor nur,0,0,0,0,0,1,0,1
neighbor's corn,1,0,0,0,0,0,0,1
neighbor's doors,0,0,0,0,0,1,0,1
neighbor's yard,1,0,0,0,0,0,0,1
neighborhood activist,0,0,0,0,1,0,0,1
neighborhood activists,0,0,0,0,1,0,0,1
neighborhood baseball,0,1,0,0,0,0,0,1
neighborhood borough,0,0,0,1,0,0,0,1
neighborhood collected,0,0,0,0,1,0,0,1
neighborhood cooler,0,0,0,1,0,0,0,1
neighborhood disproportionately,0,0,1,0,0,0,0,1
neighborhood filled,0,1,0,0,0,0,0,1
neighborhood heartbreak,0,1,0,0,0,0,0,1
neighborhood home,0,0,1,0,0,0,0,1
neighborhood mohamed,0,0,0,1,0,0,0,1
neighborhood yeah,1,0,0,0,0,0,0,1
neighborhood's power,0,1,0,0,0,0,0,1
neighborhoods blocks,0,0,0,1,0,0,0,1
neighborhoods flooded,0,0,0,1,0,0,0,1
neighboring bryan,0,1,0,0,0,0,0,1
neighboring navajo,0,1,0,0,0,0,0,1
neighboring town,0,1,0,0,0,0,0,1
neighboring valley,0,1,0,0,0,0,0,1
neighbors fatima,0,0,0,0,0,1,0,1
neighbors hunkering,0,0,0,1,0,0,0,1
neighbors nephew,0,0,0,0,0,1,0,1
neighbors patched,0,1,0,0,0,0,0,1
neighbors planted,1,0,0,0,0,0,0,1
neighbors sam,0,0,0,0,1,0,0,1
neil gorsuch,0,0,0,0,0,1,0,1
neil tevault,0,1,0,0,0,0,0,1
nelson evacuated,0,0,0,0,0,1,0,1
nemeth director,0,0,0,1,0,0,0,1
nepal snow,0,1,0,0,0,0,0,1
nepal's rolwaling,0,1,0,0,0,0,0,1
nepalese tourists,0,1,0,0,0,0,0,1
nephew attempted,1,0,0,0,0,0,0,1
nervous chuckle,0,0,0,1,0,0,0,1
nespresso corporations,0,0,0,1,0,0,0,1
nespresso owned,0,0,0,1,0,0,0,1
nespresso spends,0,0,0,1,0,0,0,1
nespresso usa,0,0,0,1,0,0,0,1
nestle makes,0,0,0,1,0,0,0,1
net entanglements,0,0,0,0,1,0,0,1
net measuring,0,0,0,1,0,0,0,1
nets npr,0,0,0,0,1,0,0,1
network makes,0,0,0,0,1,0,0,1
network's anna,0,0,0,0,0,1,0,1
neurological development,0,0,0,0,1,0,0,1
neutral city,0,0,0,1,0,0,0,1
neutral electric,0,1,0,0,0,0,0,1
neutral future,0,1,0,0,0,0,0,1
nevada backcountry,0,0,0,0,1,0,0,1
nevada border,0,0,0,0,1,0,0,1
nevada conifer,0,0,0,0,0,1,0,1
nevada mountain,0,0,0,1,0,0,0,1
nevada upwards,0,0,0,0,0,1,0,1
newly built,1,0,0,0,0,0,0,1
newly desalted,0,0,0,1,0,0,0,1
newly elected,1,0,0,0,0,0,0,1
newly exposed,0,1,0,0,0,0,0,1
newly identified,1,0,0,0,0,0,0,1
newly installed,1,0,0,0,0,0,0,1
newly liberated,0,1,0,0,0,0,0,1
newly named,0,0,0,1,0,0,0,1
newly proposed,0,0,0,0,1,0,0,1
newly released,0,0,0,1,0,0,0,1
newly repaired,0,1,0,0,0,0,0,1
news agency,0,1,0,0,0,0,0,1
news agenda,0,0,1,0,0,0,0,1
news boise,1,0,0,0,0,0,0,1
news cameras,0,1,0,0,0,0,0,1
news dubai,0,0,0,1,0,0,0,1
news emerged,0,0,1,0,0,0,0,1
news floodlight,0,0,1,0,0,0,0,1
news juana,0,0,0,1,0,0,0,1
news launched,0,0,1,0,0,0,0,1
news miami,0,0,1,0,0,0,0,1
news network's,0,0,0,0,0,1,0,1
news norfolk,0,1,0,0,0,0,0,1
news organization,0,0,0,0,1,0,0,1
news owner,0,0,1,0,0,0,0,1
news phoenix,1,0,0,0,0,0,0,1
news port,0,1,0,0,0,0,0,1
news portland,0,1,0,0,0,0,0,1
news published,0,0,0,1,0,0,0,1
news ran,0,0,0,1,0,0,0,1
news read,0,0,1,0,0,0,0,1
news reports,0,0,0,0,0,1,0,1
news runs,0,0,1,0,0,0,0,1
news service,0,1,0,0,0,0,0,1
news story,0,0,0,1,0,0,0,1
news ventura,0,0,0,0,0,1,0,1
newsletter subscribers,0,0,1,0,0,0,0,1
newsom applauded,0,0,0,0,0,1,0,1
newsom credited,0,0,1,0,0,0,0,1
newsom issued,0,0,0,0,0,1,0,1
newsom pushed,0,1,0,0,0,0,0,1
newsom visited,0,0,0,1,0,0,0,1
newsom's office,0,0,0,0,0,1,0,1
newspaper industry,0,0,1,0,0,0,0,1
newsroom staffs,0,0,1,0,0,0,0,1
ngo germanwatch,0,0,0,1,0,0,0,1
niaz ahmed,0,0,0,0,0,1,0,1
nic carter,0,0,0,0,0,1,0,1
nicaragua vice,1,0,0,0,0,0,0,1
nicaragua's central,1,0,0,0,0,0,0,1
nicaragua's disaster,1,0,0,0,0,0,0,1
nice community,0,0,0,0,0,1,0,1
nice mulch,1,0,0,0,0,0,0,1
nice sitting,0,1,0,0,0,0,0,1
nice weather,0,0,0,1,0,0,0,1
niche friedrich,0,1,0,0,0,0,0,1
nichola clark,0,0,0,0,1,0,0,1
nick jordan,0,0,1,0,0,0,0,1
nick rohlman,0,0,0,0,0,0,1,1
nickel industry,0,0,0,0,1,0,0,1
nickel reserves,0,0,0,0,1,0,0,1
nicole churned,0,1,0,0,0,0,0,1
nicole developed,0,1,0,0,0,0,0,1
nicole form,0,1,0,0,0,0,0,1
nicole joe,0,1,0,0,0,0,0,1
nicole miami,0,1,0,0,0,0,0,1
nicole passed,0,1,0,0,0,0,0,1
niger nigeria,0,0,1,0,0,0,0,1
night brian,0,0,0,0,1,0,0,1
night bundled,0,0,0,0,1,0,0,1
night delaware,0,0,0,0,0,0,1,1
night destroying,0,0,0,1,0,0,0,1
night hit,0,0,0,0,1,0,0,1
night homeless,0,0,0,0,1,0,0,1
night southwest's,0,0,1,0,0,0,0,1
nightmare campbell,0,0,0,1,0,0,0,1
nightmare imagine,0,0,0,0,1,0,0,1
nightmarish story,1,0,0,0,0,0,0,1
nighttime arrival,0,0,0,0,0,1,0,1
nighttime lighting,0,1,0,0,0,0,0,1
nighttime strikes,0,0,0,0,0,1,0,1
nighttime supercells,0,0,0,0,0,1,0,1
nikita nineza,0,0,0,0,1,0,0,1
nima sherpa,0,1,0,0,0,0,0,1
nimble business,0,1,0,0,0,0,0,1
nimby ism,0,0,0,1,0,0,0,1
nina natural,0,0,0,1,0,0,0,1
niña weather,0,1,0,0,0,0,0,1
nineteen people,0,0,0,1,0,0,0,1
ning lin,0,0,0,0,1,0,0,1
nitrogen oxide,0,0,0,0,0,1,0,1
nitrogen phosphorus,1,0,0,0,0,0,0,1
nitrogen trace,0,0,0,0,1,0,0,1
nixon republican,1,0,0,0,0,0,0,1
noaa climate.gov,0,0,0,0,0,1,0,1
noaa compares,0,0,0,0,0,1,0,1
noaa defines,0,0,0,0,0,1,0,1
noaa fisheries,0,0,0,0,1,0,0,1
noaa hopes,0,1,0,0,0,0,0,1
noaa kapnick,0,1,0,0,0,0,0,1
noaa moves,0,0,0,1,0,0,0,1
noaa nssl,1,0,0,0,0,0,0,1
noaa scientists,0,1,0,0,0,0,0,1
noaa's administrator,0,0,0,1,0,0,0,1
noaa's office,0,0,0,1,0,0,0,1
noah diffenbaugh,0,0,0,1,0,0,0,1
noah kaufman,0,0,0,0,1,0,0,1
nogi afp,0,0,0,0,1,0,0,1
noise generated,0,0,0,0,1,0,0,1
noises odors,0,0,0,0,0,1,0,1
noisy crowd,1,0,0,0,0,0,0,1
noisy demonstration,1,0,0,0,0,0,0,1
noisy super,0,0,0,1,0,0,0,1
noisy yeah,0,0,0,1,0,0,0,1
nominated sultan,0,0,0,1,0,0,0,1
nominee's position,0,0,0,1,0,0,0,1
nongovernmental organizations,0,1,0,0,0,0,0,1
nonpartisan pew,0,0,0,0,1,0,0,1
nonpartisan research,0,0,0,1,0,0,0,1
nonprofit called,0,0,0,0,1,0,0,1
nonprofit city,0,0,0,1,0,0,0,1
nonprofit earthjustice,0,0,0,0,0,1,0,1
nonprofit environmental,0,0,0,0,1,0,0,1
nonprofit germanwatch,0,0,1,0,0,0,0,1
nonprofit interamerican,0,0,0,0,1,0,0,1
nonprofit newsroom,0,0,1,0,0,0,0,1
nonprofit policy,0,1,0,0,0,0,0,1
nonprofit received,0,0,1,0,0,0,0,1
nonprofit run,0,0,1,0,0,0,0,1
nonprofit supported,0,0,0,0,1,0,0,1
nonprofit traveled,1,0,0,0,0,0,0,1
nonprofits africa,0,1,0,0,0,0,0,1
nonprofits linked,0,0,1,0,0,0,0,1
noon saturday,1,0,0,0,0,0,0,1
noor bin,0,0,0,0,0,1,0,1
noor hussain,1,0,0,0,0,0,0,1
nord stream,0,0,1,0,0,0,0,1
norfolk called,0,0,0,0,1,0,0,1
norfolk colonel,0,1,0,0,0,0,0,1
norfolk naval,0,1,0,0,0,0,0,1
normal duties,0,1,0,0,0,0,0,1
normal jet,0,0,0,1,0,0,0,1
normal operation,0,0,1,0,0,0,0,1
normal operations,0,1,0,0,0,0,0,1
normal schnarr,0,0,1,0,0,0,0,1
normal yeah,0,0,0,1,0,0,0,1
norman lear,0,0,1,0,0,0,0,1
north atlantic,0,0,0,0,1,0,0,1
north carolina's,0,1,0,0,0,0,0,1
north los,0,0,0,0,1,0,0,1
north mid,0,0,0,0,0,1,0,1
north oblivious,0,0,0,0,0,1,0,1
north overnight,0,1,0,0,0,0,0,1
north pacific,0,0,1,0,0,0,0,1
north research,0,0,0,0,1,0,0,1
north sea,1,0,0,0,0,0,0,1
northeast breaking,0,0,0,0,1,0,0,1
northeast killing,0,0,0,0,0,0,1,1
northeast oregon,0,0,0,0,0,1,0,1
northeast texas,0,1,0,0,0,0,0,1
northeast winter,0,0,0,0,1,0,0,1
northern border,0,0,0,0,0,1,0,1
northern british,0,0,0,1,0,0,0,1
northern canada,0,0,0,0,1,0,0,1
northern edge,0,1,0,0,0,0,0,1
northern europe,1,0,0,0,0,0,0,1
northern hemisphere,0,0,0,1,0,0,0,1
northern ireland,0,0,0,1,0,0,0,1
northern nigeria,0,0,1,0,0,0,0,1
northward recent,0,0,0,0,0,1,0,1
northwest arizona,0,0,0,0,1,0,0,1
northwest arkansas,0,1,0,0,0,0,0,1
northwest kagera,0,0,0,0,0,1,0,1
northwest news,0,0,0,0,0,1,0,1
northwest oregon,0,0,1,0,0,0,0,1
northwest region,0,0,1,0,0,0,0,1
northwest territory,0,0,0,0,1,0,0,1
northwestern border,0,0,0,0,0,1,0,1
northwestern montana,0,0,0,0,0,1,0,1
nose run,0,0,1,0,0,0,0,1
notable absences,0,1,0,0,0,0,0,1
notably fuller,0,0,0,0,1,0,0,1
notably wildfires,0,0,0,1,0,0,0,1
note current,1,0,0,0,0,0,0,1
notes salvador,0,1,0,0,0,0,0,1
notes similar,0,0,0,1,0,0,0,1
notice polluted,1,0,0,0,0,0,0,1
noticed nature,0,1,0,0,0,0,0,1
notoriously unreliable,0,1,0,0,0,0,0,1
notre dame,0,0,0,0,0,1,0,1
noveleta town,1,0,0,0,0,0,0,1
november day,0,0,0,1,0,0,0,1
november december,0,1,0,0,0,0,0,1
november ruled,0,0,1,0,0,0,0,1
november's global,0,0,0,1,0,0,0,1
nowadays nowadays,0,1,0,0,0,0,0,1
npr alpha,1,0,0,0,0,0,0,1
npr article,0,1,0,0,0,0,0,1
npr barconie,0,0,0,1,0,0,0,1
npr britt,0,0,1,0,0,0,0,1
npr calling,1,0,0,0,0,0,0,1
npr china,0,0,0,0,1,0,0,1
npr coal,1,0,0,0,0,0,0,1
npr colleague,0,1,0,0,0,0,0,1
npr correspondent,0,0,0,0,1,0,0,1
npr drew,0,0,1,0,0,0,0,1
npr fire,0,0,1,0,0,0,0,1
npr found,1,0,0,0,0,0,0,1
npr host,0,0,0,0,1,0,0,1
npr industry,1,0,0,0,0,0,0,1
npr investigative,1,0,0,0,0,0,0,1
npr network,0,0,0,0,1,0,0,1
npr people,0,0,0,0,0,1,0,1
npr reached,0,1,0,0,0,0,0,1
npr reported,0,0,0,1,0,0,0,1
npr requested,1,0,0,0,0,0,0,1
npr series,0,1,0,0,0,0,0,1
npr spoke,0,0,0,0,1,0,0,1
npr ssp,0,1,0,0,0,0,0,1
npr tree,0,0,1,0,0,0,0,1
npr u.s,0,1,0,0,0,0,0,1
npr upside,0,1,0,0,0,0,0,1
npr visited,0,1,0,0,0,0,0,1
npr west,0,0,0,0,0,1,0,1
npr's ailsa,0,0,0,0,1,0,0,1
npr's allison,0,1,0,0,0,0,0,1
npr's daily,1,0,0,0,0,0,0,1
npr's daniel,0,1,0,0,0,0,0,1
npr's dave,1,0,0,0,0,0,0,1
npr's david,0,0,1,0,0,0,0,1
npr's debbie,0,0,0,0,0,1,0,1
npr's greg,0,1,0,0,0,0,0,1
npr's jeff,0,0,0,1,0,0,0,1
npr's katia,0,1,0,0,0,0,0,1
npr's michael,0,0,0,0,0,0,1,1
npr's michel,0,1,0,0,0,0,0,1
npr's paris,0,0,0,1,0,0,0,1
npr's picture,0,1,0,0,0,0,0,1
npr's planet,0,0,0,1,0,0,0,1
npr's quil,0,1,0,0,0,0,0,1
npr's seyma,0,0,0,0,0,1,0,1
npr's short,1,0,0,0,0,0,0,1
npr's ximena,0,0,0,0,0,0,1,1
nsf's cutler,0,0,0,0,1,0,0,1
nssl hide,1,0,0,0,0,0,0,1
nuanced question,0,1,0,0,0,0,0,1
nuclear weapon,0,0,0,0,1,0,0,1
nuclear weapons,0,0,0,0,1,0,0,1
nudge developers,0,1,0,0,0,0,0,1
nursing job,0,0,0,0,1,0,0,1
nurtured networks,0,0,0,0,1,0,0,1
nutrient animal,0,0,0,0,0,1,0,1
nutrient dense,0,1,0,0,0,0,0,1
nutrient rich,0,0,1,0,0,0,0,1
nutrients including,1,0,0,0,0,0,0,1
nutrition susan,0,1,0,0,0,0,0,1
nutritional biochemists,0,1,0,0,0,0,0,1
nuys airport,0,0,1,0,0,0,0,1
nuys multiple,0,0,1,0,0,0,0,1
nws balloons,0,0,0,0,1,0,0,1
nws issued,0,0,0,0,0,1,0,1
nws reported,0,0,0,0,1,0,0,1
nws san,0,0,0,0,1,0,0,1
nws tweeted,0,0,0,1,0,0,0,1
o'connor refers,0,0,0,0,0,1,0,1
o'donnell testified,0,0,0,0,0,0,1,1
o'donnell told,0,0,0,0,0,0,1,1
o'lakes speaking,0,0,0,1,0,0,0,1
o'neil ap,0,0,0,1,0,0,0,1
oakland recently,0,0,0,1,0,0,0,1
oaks simi,0,0,0,1,0,0,0,1
oases.this past,1,0,0,0,0,0,0,1
obama halted,0,0,0,0,0,1,0,1
obama reflected,1,0,0,0,0,0,0,1
obama's decision,0,0,0,0,0,1,0,1
obama's trip,1,0,0,0,0,0,0,1
oberle director,0,1,0,0,0,0,0,1
obispo county,0,0,0,1,0,0,0,1
object carried,0,1,0,0,0,0,0,1
objects bobbing,0,0,0,0,0,0,1,1
obliterated local,0,0,0,0,0,1,0,1
observations diffenbaugh,0,0,0,1,0,0,0,1
observatory francis,0,0,0,0,1,0,0,1
observatory overnight,0,0,0,0,1,0,0,1
observe traditional,0,0,1,0,0,0,0,1
observed sea,0,1,0,0,0,0,0,1
observers scan,0,0,1,0,0,0,0,1
observers widely,0,0,0,1,0,0,0,1
obsessed food,0,1,0,0,0,0,0,1
obstructive pulmonary,0,0,0,1,0,0,0,1
obtain flood,1,0,0,0,0,0,0,1
obtaining crucial,1,0,0,0,0,0,0,1
occasional distributions,0,0,1,0,0,0,0,1
occasional ridicule,0,0,0,0,0,1,0,1
occasionally develop,0,1,0,0,0,0,0,1
occasionally surpassed,0,0,0,1,0,0,0,1
occasionally vegetables,0,0,0,0,0,1,0,1
occidental college,0,0,0,0,0,1,0,1
occidental fire,0,0,0,1,0,0,0,1
occupational health,0,0,0,1,0,0,0,1
occupying roads,0,0,1,0,0,0,0,1
occur collapse,0,1,0,0,0,0,0,1
occur indigenous,0,0,0,0,0,0,1,1
occur naturally,0,0,0,1,0,0,0,1
occur weeks,0,0,0,1,0,0,0,1
occurs naturally,0,1,0,0,0,0,0,1
ocean acidification,1,0,0,0,0,0,0,1
ocean action,0,0,0,0,1,0,0,1
ocean captains,0,0,0,0,1,0,0,1
ocean compared,0,0,0,1,0,0,0,1
ocean desalination,0,0,0,1,0,0,0,1
ocean flooded,0,0,1,0,0,0,0,1
ocean interface,0,0,0,0,1,0,0,1
ocean issues,0,0,0,0,1,0,0,1
ocean kris,0,0,1,0,0,0,0,1
ocean lakes,0,0,1,0,0,0,0,1
ocean lease,0,0,0,0,0,1,0,1
ocean lies,0,0,0,0,1,0,0,1
ocean mira,0,0,0,0,1,0,0,1
ocean plans,0,0,0,0,0,1,0,1
ocean rim,1,0,0,0,0,0,0,1
ocean sala,0,1,0,0,0,0,0,1
ocean temp,0,0,0,0,0,0,1,1
ocean themed,0,0,0,0,0,1,0,1
ocean transported,0,0,0,1,0,0,0,1
ocean voices,0,0,0,0,1,0,0,1
ocean water,0,0,1,0,0,0,0,1
ocean waves,0,0,0,0,1,0,0,1
ocean's surface,0,0,0,0,0,1,0,1
oceanic science,0,0,1,0,0,0,0,1
oceanic sciences,0,0,0,0,1,0,0,1
oceanographer wolfgang,1,0,0,0,0,0,0,1
oceans environment,0,0,0,1,0,0,0,1
oceans expert,0,0,0,0,1,0,0,1
oceans fundamentally,0,0,1,0,0,0,0,1
oceans governance,0,0,0,0,1,0,0,1
oceans produce,1,0,0,0,0,0,0,1
oceans treaty,0,0,0,0,1,0,0,1
ochlockonee river,0,1,0,0,0,0,0,1
october fema,1,0,0,0,0,0,0,1
october november,0,1,0,0,0,0,0,1
october people,0,1,0,0,0,0,0,1
october u.s,0,1,0,0,0,0,0,1
odd sight,0,1,0,0,0,0,0,1
odds slim,0,1,0,0,0,0,0,1
odds worse,0,0,0,0,0,1,0,1
odisho getty,0,0,0,0,1,0,0,1
offer clashing,0,0,1,0,0,0,0,1
offer communities,1,0,0,0,0,0,0,1
offer grants,0,1,0,0,0,0,0,1
offer houser,0,0,0,0,1,0,0,1
offer hybrid,0,0,0,0,1,0,0,1
offer infrared,0,0,0,0,1,0,0,1
offer investors,0,1,0,0,0,0,0,1
offer opportunities,1,0,0,0,0,0,0,1
offer organized,0,0,0,0,1,0,0,1
offer safe,0,0,1,0,0,0,0,1
offered anjali,0,0,0,0,1,0,0,1
offered walaa,0,0,0,0,1,0,0,1
offering assistance,0,1,0,0,0,0,0,1
offering buyouts,0,0,0,0,0,1,0,1
offering cleaner,0,0,1,0,0,0,0,1
offering sandbags,0,1,0,0,0,0,0,1
offering services,0,0,0,1,0,0,0,1
offers daily,1,0,0,0,0,0,0,1
offers hints,0,0,0,1,0,0,0,1
offers ideal,0,0,0,0,0,1,0,1
offers visitors,0,1,0,0,0,0,0,1
office added,0,0,0,0,1,0,0,1
office failed,0,0,0,1,0,0,0,1
office katia,0,1,0,0,0,0,0,1
office kristyna,1,0,0,0,0,0,0,1
office notes,0,0,0,0,1,0,0,1
office perkins,0,0,1,0,0,0,0,1
office pledging,0,0,0,1,0,0,0,1
office previously,0,0,0,0,0,0,1,1
office scenes,0,0,0,1,0,0,0,1
office simon,1,0,0,0,0,0,0,1
office tied,0,0,0,1,0,0,0,1
office's oversight,0,0,0,0,0,0,1,1
officer applauded,0,0,0,0,0,1,0,1
officer stands,0,0,1,0,0,0,0,1
offices valeti,0,1,0,0,0,0,0,1
official death,0,1,0,0,0,0,0,1
official decision,0,1,0,0,0,0,0,1
official fire,0,0,1,0,0,0,0,1
official government,0,1,0,0,0,0,0,1
official limit,0,0,0,1,0,0,0,1
official measurements,0,0,1,0,0,0,0,1
official media,1,0,0,0,0,0,0,1
official negotiations,0,1,0,0,0,0,0,1
official paperwork,0,0,0,0,1,0,0,1
official proposal,0,1,0,0,0,0,0,1
official records,0,0,0,1,0,0,0,1
official reports,0,0,0,1,0,0,0,1
official running,0,0,0,0,1,0,0,1
official speaking,0,0,0,0,0,1,0,1
official tally,1,0,0,0,0,0,0,1
official temperature,0,0,0,1,0,0,0,1
official updates,0,1,0,0,0,0,0,1
official weather,0,1,0,0,0,0,0,1
officially attributed,0,1,0,0,0,0,0,1
officially confirmed,0,0,0,0,1,0,0,1
officially hit,0,1,0,0,0,0,0,1
officially tallied,0,1,0,0,0,0,0,1
officials absolutely,0,1,0,0,0,0,0,1
officials bear,0,1,0,0,0,0,0,1
officials closed,0,1,0,0,0,0,0,1
officials emphasize,0,0,0,0,1,0,0,1
officials environmentalists,0,0,0,0,1,0,0,1
officials experts,0,1,0,0,0,0,0,1
officials hope,0,1,0,0,0,0,0,1
officials misled,1,0,0,0,0,0,0,1
officials planned,0,0,0,0,1,0,0,1
officials pledged,1,0,0,0,0,0,0,1
officials proudly,0,0,0,0,1,0,0,1
officials recently,0,0,0,0,0,1,0,1
officials told,0,0,0,0,1,0,0,1
officials urge,0,0,0,1,0,0,0,1
officials warned,0,0,0,0,1,0,0,1
officials welcomed,0,0,0,0,1,0,0,1
offset credits,0,1,0,0,0,0,0,1
offset planet,0,1,0,0,0,0,0,1
offset schemes,0,1,0,0,0,0,0,1
offsets experts,0,0,0,0,1,0,0,1
oft misunderstood,1,0,0,0,0,0,0,1
ogunseitan ph.d,0,0,0,0,0,1,0,1
ohio childhood,0,1,0,0,0,0,0,1
ohio kentucky,0,0,0,0,1,0,0,1
ohio reached,0,0,0,0,1,0,0,1
ohio thompson,0,0,0,0,1,0,0,1
oil calls,0,1,0,0,0,0,0,1
oil coal,0,1,0,0,0,0,0,1
oil commonly,0,0,0,0,0,0,1,1
oil country,0,1,0,0,0,0,0,1
oil crisis,0,1,0,0,0,0,0,1
oil depots,0,1,0,0,0,0,0,1
oil development,0,0,0,0,0,1,0,1
oil diplomacy,1,0,0,0,0,0,0,1
oil disaster,0,1,0,0,0,0,0,1
oil exploration,0,0,0,0,0,1,0,1
oil extracted,0,1,0,0,0,0,0,1
oil firm,0,0,0,1,0,0,0,1
oil gas,0,0,1,0,0,0,0,1
oil giant,0,0,0,0,0,1,0,1
oil inside,0,0,0,0,0,1,0,1
oil licenses,0,1,0,0,0,0,0,1
oil market,0,0,0,0,0,1,0,1
oil pipeline,0,0,0,0,0,1,0,1
oil producer,0,0,0,1,0,0,0,1
oil producers,1,0,0,0,0,0,0,1
oil producing,0,0,0,1,0,0,0,1
oil profits,0,1,0,0,0,0,0,1
oil rig,1,0,0,0,0,0,0,1
oil spill,0,1,0,0,0,0,0,1
oil started,0,1,0,0,0,0,0,1
oil suffocated,0,1,0,0,0,0,0,1
oil terminals,0,1,0,0,0,0,0,1
oil yamada,0,0,0,0,1,0,0,1
okla idabel,0,1,0,0,0,0,0,1
okla lm,0,1,0,0,0,0,0,1
okla residents,0,1,0,0,0,0,0,1
oklahoma arkansas,0,0,0,0,0,1,0,1
oklahoma ashley,0,0,0,0,0,1,0,1
oklahoma border,0,1,0,0,0,0,0,1
oklahoma gov,0,1,0,0,0,0,0,1
oklahoma highway,0,1,0,0,0,0,0,1
oklahoma tornado,0,0,0,0,0,1,0,1
oklahoma weather,0,1,0,0,0,0,0,1
okra partially,0,0,0,0,0,1,0,1
ola belle,0,1,0,0,0,0,0,1
olaf scholz's,0,0,1,0,0,0,0,1
old's home,0,0,0,0,0,0,1,1
olivia irvin,1,0,0,0,0,0,0,1
olivier morin,1,0,0,0,0,0,0,1
olympic ice,0,1,0,0,0,0,0,1
olympic swimming,0,0,0,1,0,0,0,1
omar el,0,0,0,1,0,0,0,1
ominous sight,0,0,0,0,1,0,0,1
ominous sign,1,0,0,0,0,0,0,1
omnipresent slow,0,0,0,0,0,1,0,1
omong kosong,0,0,0,0,1,0,0,1
one's fingers,0,0,0,1,0,0,0,1
ongoing bipartisan,0,0,0,0,1,0,0,1
ongoing challenge,0,1,0,0,0,0,0,1
ongoing coverage,0,0,0,1,0,0,0,1
ongoing drought,0,0,0,0,0,1,0,1
ongoing efforts,0,0,0,0,0,1,0,1
ongoing environmental,0,1,0,0,0,0,0,1
ongoing heat,0,0,1,0,0,0,0,1
ongoing hunger,0,1,0,0,0,0,0,1
ongoing reservoir,1,0,0,0,0,0,0,1
ongoing threats,0,0,0,1,0,0,0,1
ongoing u.s,0,0,0,0,1,0,0,1
ongoing viability,0,0,1,0,0,0,0,1
ongoing war,1,0,0,0,0,0,0,1
online campaign,0,0,0,0,1,0,0,1
online discussions,0,0,0,0,0,1,0,1
online gambling,0,0,0,0,1,0,0,1
online news,0,0,1,0,0,0,0,1
online npr's,0,0,0,0,0,1,0,1
online press,0,0,1,0,0,0,0,1
online quicker,0,1,0,0,0,0,0,1
online smears,0,0,1,0,0,0,0,1
online.for npr,1,0,0,0,0,0,0,1
onshore charter,1,0,0,0,0,0,0,1
onshore winds,0,1,0,0,0,0,0,1
ontario claiming,0,0,0,0,0,1,0,1
ontario government,0,0,0,0,0,1,0,1
ontario's automotive,0,0,0,0,0,1,0,1
ontario's minister,0,0,0,0,0,1,0,1
ontario's provincial,0,0,0,0,0,1,0,1
opb hide,1,0,0,0,0,0,0,1
openly acknowledges,0,0,1,0,0,0,0,1
openly call,0,0,0,1,0,0,0,1
operated snowplow,0,0,0,0,1,0,0,1
operates robert,0,0,0,1,0,0,0,1
operating officer,0,1,0,0,0,0,0,1
operating upstream,0,0,0,0,0,1,0,1
operation charlotte,0,1,0,0,0,0,0,1
operation david,0,1,0,0,0,0,0,1
operation matrix,0,0,1,0,0,0,0,1
operation naselroad,0,1,0,0,0,0,0,1
operation restrictions,0,0,1,0,0,0,0,1
operations helping,0,1,0,0,0,0,0,1
operations methane,0,1,0,0,0,0,0,1
operations normal,0,1,0,0,0,0,0,1
operations stephanie,0,1,0,0,0,0,0,1
operative named,0,0,0,0,1,0,0,1
operators including,0,1,0,0,0,0,0,1
opinion column,0,0,0,0,0,1,0,1
opinion gains,0,0,1,0,0,0,0,1
opinions tend,0,1,0,0,0,0,0,1
opponent kari,0,0,0,0,1,0,0,1
opportunities africa,0,1,0,0,0,0,0,1
opportunities investors,0,0,0,0,0,0,1,1
opportunity talk,0,0,0,0,1,0,0,1
oppose ambitious,0,0,1,0,0,0,0,1
oppose clean,0,0,1,0,0,0,0,1
opposed climate,0,0,1,0,0,0,0,1
opposed demands,0,1,0,0,0,0,0,1
opposed paying,0,1,0,0,0,0,0,1
opposes offshore,0,0,0,0,1,0,0,1
opposing clean,0,0,0,0,1,0,0,1
opposition boise,0,0,0,0,1,0,0,1
opposition chad,0,1,0,0,0,0,0,1
opposition civic,0,0,0,0,0,1,0,1
opposition ralston's,0,0,0,0,1,0,0,1
opposition strategies,0,0,0,0,1,0,0,1
oppressed peoples,0,0,0,1,0,0,0,1
optimistic doreen,1,0,0,0,0,0,0,1
option left,1,0,0,0,0,0,0,1
option schaeffer,0,0,1,0,0,0,0,1
ora rose,0,0,0,1,0,0,0,1
oral arguments,0,0,0,0,0,1,0,1
oral rehydration,1,0,0,0,0,0,0,1
orange puffy,0,0,0,0,1,0,0,1
orange tanker,0,0,0,0,1,0,0,1
orangutan conservation,0,0,1,0,0,0,0,1
orangutan plays,0,0,1,0,0,0,0,1
orbit nasa,1,0,0,0,0,0,0,1
orderly transition,0,1,0,0,0,0,0,1
ordinance urban,0,0,0,0,1,0,0,1
ordinances ralston's,0,0,0,0,1,0,0,1
ordinary human,0,0,0,0,0,0,1,1
ordinary times,1,0,0,0,0,0,0,1
ordinary trust,0,0,0,0,0,1,0,1
ore feat,0,0,0,0,1,0,0,1
ore piedmont's,0,1,0,0,0,0,0,1
oregon based,0,0,1,0,0,0,0,1
oregon gather,0,0,0,0,0,1,0,1
oregon laura,1,0,0,0,0,0,0,1
oregon nike,1,0,0,0,0,0,0,1
oregon public,0,0,0,0,1,0,0,1
oregon researchers,0,0,1,0,0,0,0,1
oregon sanitation,1,0,0,0,0,0,0,1
oregon school,0,1,0,0,0,0,0,1
oregon vermont,0,0,1,0,0,0,0,1
oregon's extreme,0,0,1,0,0,0,0,1
oregon's progressive,1,0,0,0,0,0,0,1
oregon's richest,1,0,0,0,0,0,0,1
organ failure,0,0,0,0,0,1,0,1
organic fertilizer,0,1,0,0,0,0,0,1
organic food,0,1,0,0,0,0,0,1
organic molecules,0,0,0,0,0,1,0,1
organic vegetable,0,0,0,0,0,1,0,1
organization applied,0,0,0,0,1,0,0,1
organization based,0,0,0,0,1,0,0,1
organization blue,0,1,0,0,0,0,0,1
organization epidemic,0,0,0,0,0,1,0,1
organization hired,0,0,0,1,0,0,0,1
organization isla,0,0,0,0,0,1,0,1
organization protect,0,0,0,0,1,0,0,1
organization quickly,0,0,0,1,0,0,0,1
organization ralston's,0,0,0,0,1,0,0,1
organization sightsavers,0,0,0,0,1,0,0,1
organization siri,0,0,0,0,1,0,0,1
organization spent,0,0,0,1,0,0,0,1
organization surveyed,0,0,0,0,1,0,0,1
organization walaa,0,0,0,0,1,0,0,1
organization welcomes,1,0,0,0,0,0,0,1
organization wmo,0,1,0,0,0,0,0,1
organization's report,0,0,1,0,0,0,0,1
organization's sources,0,0,0,0,1,0,0,1
organizations based,0,0,0,0,1,0,0,1
organizations choosing,0,1,0,0,0,0,0,1
organizations deny,0,0,1,0,0,0,0,1
organize local,0,0,0,0,1,0,0,1
organized opposition,0,0,0,0,1,0,0,1
organizer marisela,0,0,0,0,1,0,0,1
organizers interrupted,0,1,0,0,0,0,0,1
organizers quietly,0,1,0,0,0,0,0,1
organizes annual,0,1,0,0,0,0,0,1
organizing recently,0,1,0,0,0,0,0,1
organs shutting,0,0,0,0,0,1,0,1
oriented approach,0,0,0,1,0,0,0,1
original analysis,0,0,1,0,0,0,0,1
original church,0,1,0,0,0,0,0,1
original conocophillips,0,0,0,0,0,1,0,1
original enthusiasts,0,0,0,0,1,0,0,1
original photograph,0,1,0,0,0,0,0,1
originally burned,1,0,0,0,0,0,0,1
originally coal,1,0,0,0,0,0,0,1
originally collected,1,0,0,0,0,0,0,1
originally invest,0,0,0,1,0,0,0,1
originate thousands,0,0,0,0,1,0,0,1
originating created,0,1,0,0,0,0,0,1
orlando hurricane,0,1,0,0,0,0,0,1
orlando international,0,1,0,0,0,0,0,1
orlando planned,0,1,0,0,0,0,0,1
orlando sentinal,0,1,0,0,0,0,0,1
orleans 17th,0,1,0,0,0,0,0,1
orleans growing,1,0,0,0,0,0,0,1
orleans learned,1,0,0,0,0,0,0,1
orleans levees,0,1,0,0,0,0,0,1
orleans lower,0,1,0,0,0,0,0,1
orleans public,1,0,0,0,0,0,0,1
orleans restaurant,1,0,0,0,0,0,0,1
orleans steven,1,0,0,0,0,0,0,1
oroville dam,0,0,0,1,0,0,0,1
orthopedic injuries,0,0,0,1,0,0,0,1
oscar winning,0,0,0,0,0,0,1,1
oscillation enhances,0,0,0,1,0,0,0,1
osmanabad districts,0,1,0,0,0,0,0,1
ostranger added,0,0,0,1,0,0,0,1
otherworldly experience,0,0,0,0,1,0,0,1
otherworldly landscape,0,1,0,0,0,0,0,1
otis speaking,0,1,0,0,0,0,0,1
ottawa city,0,0,0,0,1,0,0,1
ottawa winter,0,0,0,0,1,0,0,1
otters play,0,1,0,0,0,0,0,1
ouachita mountains,0,1,0,0,0,0,0,1
out.martí hayley,0,0,0,0,1,0,0,1
outages mud,0,0,0,0,1,0,0,1
outboard motor,1,0,0,0,0,0,0,1
outcomes inger,0,1,0,0,0,0,0,1
outcomes timmermans,0,1,0,0,0,0,0,1
outdated officials,0,1,0,0,0,0,0,1
outdated stormwater,0,0,0,0,1,0,0,1
outdated wastewater,0,0,0,1,0,0,0,1
outdoor community,1,0,0,0,0,0,0,1
outdoor food,0,1,0,0,0,0,0,1
outdoor lab,0,0,0,1,0,0,0,1
outer continental,0,0,0,0,0,1,0,1
outgoing ceo,0,1,0,0,0,0,0,1
outgoing gov,1,0,0,0,0,0,0,1
outlet prager,0,0,0,0,0,1,0,1
outlets collectively,0,0,1,0,0,0,0,1
outpace sea,1,0,0,0,0,0,0,1
outpaced people's,1,0,0,0,0,0,0,1
outperform traditional,0,0,1,0,0,0,0,1
outrage viral,0,0,0,1,0,0,0,1
outreach workers,0,0,0,1,0,0,0,1
outright ban,0,0,0,0,1,0,0,1
outstanding natural,0,1,0,0,0,0,0,1
outward beginning,1,0,0,0,0,0,0,1
oven burners,0,0,0,0,1,0,0,1
overarching question,1,0,0,0,0,0,0,1
overarching weather,0,0,0,0,0,0,1,1
overcome analysts,0,0,1,0,0,0,0,1
overdue move,0,0,0,1,0,0,0,1
overdue previous,0,0,1,0,0,0,0,1
overfishing sala,0,1,0,0,0,0,0,1
overgrown brush,0,0,1,0,0,0,0,1
overgrown town,0,1,0,0,0,0,0,1
overhand east,0,1,0,0,0,0,0,1
overhaul institutions,0,1,0,0,0,0,0,1
overhaul meat,0,1,0,0,0,0,0,1
overlook local,0,0,0,0,1,0,0,1
overlooked tragedies,0,1,0,0,0,0,0,1
overnight thursday,1,0,0,0,0,0,0,1
overseeing clean,0,0,0,1,0,0,0,1
overseeing growth,1,0,0,0,0,0,0,1
overshadowing indonesia's,0,0,0,0,1,0,0,1
oversight accountability,0,0,0,0,1,0,0,1
oversight funding,0,0,0,0,0,0,1,1
oversight goals,0,0,0,0,0,0,1,1
oversight investigations,0,0,0,1,0,0,0,1
oversight panel,0,0,0,1,0,0,0,1
overtake china,0,1,0,0,0,0,0,1
overtaking sales,0,0,0,0,0,0,1,1
overtook sales,0,0,0,0,0,1,0,1
overtopped banks,0,0,0,1,0,0,0,1
overwhelm coastal,0,1,0,0,0,0,0,1
overwhelm natural,1,0,0,0,0,0,0,1
overwhelming multiple,0,0,0,1,0,0,0,1
overwhelmingly prices,1,0,0,0,0,0,0,1
owned coal,0,0,0,0,1,0,0,1
owned commodity,0,0,0,0,0,1,0,1
owned enterprises,0,0,0,0,1,0,0,1
owned historically,1,0,0,0,0,0,0,1
owned philadelphia,1,0,0,0,0,0,0,1
owner allison,0,0,1,0,0,0,0,1
owner james,0,0,0,0,0,1,0,1
owner moses,0,1,0,0,0,0,0,1
owner zeng,0,1,0,0,0,0,0,1
owners workers,0,0,0,0,0,1,0,1
owns river's,0,0,0,0,1,0,0,1
owns wolf,0,0,0,0,1,0,0,1
oxford modeled,0,1,0,0,0,0,0,1
oxide pollution,0,0,0,0,0,1,0,1
oxide remains,1,0,0,0,0,0,0,1
oxnard thousand,0,0,0,1,0,0,0,1
oyster beds,0,1,0,0,0,0,0,1
oyster farm,0,0,0,0,0,0,1,1
oyster industry,0,0,0,0,0,0,1,1
oyster reef,1,0,0,0,0,0,0,1
oyster season,0,0,0,0,0,0,1,1
oyster shells,1,0,0,0,0,0,0,1
oysters growing,1,0,0,0,0,0,0,1
ozug miguel,0,1,0,0,0,0,0,1
p.m local,0,0,0,0,0,1,0,1
p.m tuesday,0,1,0,0,0,0,0,1
paccar opposed,0,0,1,0,0,0,0,1
pace countries,0,0,1,0,0,0,0,1
pacific coast,0,0,0,1,0,0,0,1
pacific freight,0,0,0,1,0,0,0,1
pacific island,0,0,0,1,0,0,0,1
pacific julia,1,0,0,0,0,0,0,1
pacific maue,0,0,0,1,0,0,0,1
pacific pavilion,0,1,0,0,0,0,0,1
pacific research,0,0,0,0,0,1,0,1
pacific ring,1,0,0,0,0,0,0,1
packaged foods,0,0,0,0,0,0,1,1
packaging certification,0,1,0,0,0,0,0,1
packed concert,0,0,0,0,0,0,1,1
packed maximum,0,1,0,0,0,0,0,1
packs left,0,0,0,0,0,1,0,1
paddling pirogues,0,1,0,0,0,0,0,1
paddy's run,0,0,0,1,0,0,0,1
page county's,0,0,0,0,1,0,0,1
page paper,0,0,1,0,0,0,0,1
page rowan,0,0,0,0,1,0,0,1
page ruling,0,0,0,1,0,0,0,1
page utility,0,1,0,0,0,0,0,1
page's water,0,1,0,0,0,0,0,1
pageant holders,0,1,0,0,0,0,0,1
pageant obligations,0,1,0,0,0,0,0,1
pages dedicated,0,0,0,0,1,0,0,1
paid attention,0,0,1,0,0,0,0,1
paid news,0,0,1,0,0,0,0,1
paid peter,0,0,1,0,0,0,0,1
paid roughly,0,0,1,0,0,0,0,1
painful process,0,0,1,0,0,0,0,1
painful question,1,0,0,0,0,0,0,1
painting buildings,0,1,0,0,0,0,0,1
painting sala,0,1,0,0,0,0,0,1
paired phrase,0,0,0,0,0,1,0,1
pajaro levee,0,0,0,0,0,0,1,1
pak luhut,0,0,0,0,1,0,0,1
pakistan diaa,1,0,0,0,0,0,0,1
pakistan hussain,1,0,0,0,0,0,0,1
pakistan led,0,1,0,0,0,0,0,1
pakistan listens,0,1,0,0,0,0,0,1
pakistan's devastating,1,0,0,0,0,0,0,1
pakistani citizen,0,0,0,0,1,0,0,1
pakistani village,1,0,0,0,0,0,0,1
palacios marine,0,0,0,0,0,0,1,1
paleontologist adam,0,0,0,0,0,1,0,1
palestine train,0,0,0,0,0,0,1,1
palisades tahoe,0,0,0,0,1,0,0,1
pallet inside.there,0,1,0,0,0,0,0,1
palm shaped,0,0,0,1,0,0,0,1
palmeri retired,0,0,0,0,1,0,0,1
pan fried,0,1,0,0,0,0,0,1
panama honduras,1,0,0,0,0,0,0,1
pancreas severe,0,0,0,0,0,1,0,1
pandemic created,0,0,0,0,0,1,0,1
pandemic hit,0,0,0,0,0,0,1,1
pandemic warned,0,1,0,0,0,0,0,1
pandemics fran,0,0,0,0,0,1,0,1
pandjaitan coordinating,0,0,0,0,1,0,0,1
pandjaitan indonesia's,0,0,0,0,1,0,0,1
pandjaitan's office,0,0,0,0,1,0,0,1
panel james,0,0,0,1,0,0,0,1
paneled shed,0,1,0,0,0,0,0,1
panels continue,0,0,0,0,0,0,1,1
panels gov,0,0,1,0,0,0,0,1
panels keith,0,0,0,0,1,0,0,1
pants completely,0,1,0,0,0,0,0,1
paper flooding,0,0,0,1,0,0,0,1
paper found,0,0,0,0,1,0,0,1
paper industry,1,0,0,0,0,0,0,1
paper mills,1,0,0,0,0,0,0,1
paper towels,1,0,0,0,0,0,0,1
parachute gently,0,0,0,0,1,0,0,1
paradigm change,0,1,0,0,0,0,0,1
paradise frank,0,0,0,0,1,0,0,1
paradoxically california,0,0,0,1,0,0,0,1
parallel rivers,0,1,0,0,0,0,0,1
paralyzed floating,0,0,0,0,0,1,0,1
parched american,0,0,0,0,0,1,0,1
parched california,0,0,0,1,0,0,0,1
parched cities,0,0,0,1,0,0,0,1
parent southern,0,0,1,0,0,0,0,1
parents explains,0,0,0,0,1,0,0,1
parents house,1,0,0,0,0,0,0,1
paris correspondent,0,0,0,1,0,0,0,1
paris goal,0,0,0,1,0,0,0,1
paris hey,0,1,0,0,0,0,0,1
paris pact,1,0,0,0,0,0,0,1
paris thinking,0,0,0,0,1,0,0,1
park changed,1,0,0,0,0,0,0,1
park damaged,0,1,0,0,0,0,0,1
park erika,0,1,0,0,0,0,0,1
park neighborhood,0,0,0,0,1,0,0,1
park operated,1,0,0,0,0,0,0,1
park peru's,0,1,0,0,0,0,0,1
park service's,0,0,1,0,0,0,0,1
park short,1,0,0,0,0,0,0,1
park's broken,0,1,0,0,0,0,0,1
parked cars,0,1,0,0,0,0,0,1
parker reports,1,0,0,0,0,0,0,1
parker wwno,1,0,0,0,0,0,0,1
parking garages,0,0,0,0,1,0,0,1
parking lot.here,0,1,0,0,0,0,0,1
parks lush,0,0,0,1,0,0,0,1
parks nearest,0,0,0,1,0,0,0,1
parliament named,0,0,0,0,0,1,0,1
parodi explains,0,1,0,0,0,0,0,1
parra ap,1,0,0,0,0,0,0,1
partho protim,0,0,0,0,0,1,0,1
partial plastics,0,0,0,1,0,0,0,1
partially collapsed,0,0,0,0,0,0,1,1
partially reversible,0,1,0,0,0,0,0,1
partially scrap,1,0,0,0,0,0,0,1
participants including,0,1,0,0,0,0,0,1
particles created,1,0,0,0,0,0,0,1
particles fan,1,0,0,0,0,0,0,1
particles floated,1,0,0,0,0,0,0,1
parties announced,0,0,1,0,0,0,0,1
parties germany,0,0,1,0,0,0,0,1
parties remain,0,1,0,0,0,0,0,1
partisan issue,0,1,0,0,0,0,0,1
partner organization,0,1,0,0,0,0,0,1
partner received,0,0,1,0,0,0,0,1
partners acquired,0,0,1,0,0,0,0,1
partners operators,0,1,0,0,0,0,0,1
partners perkins,0,0,1,0,0,0,0,1
partners wrap,0,0,0,0,1,0,0,1
partnership includes,0,1,0,0,0,0,0,1
partnership started,0,0,1,0,0,0,0,1
party claim,1,0,0,0,0,0,0,1
party coalition,0,0,0,1,0,0,0,1
party conservative,0,0,1,0,0,0,0,1
party control,1,0,0,0,0,0,0,1
party gain,0,1,0,0,0,0,0,1
party governed,0,1,0,0,0,0,0,1
party government,0,1,0,0,0,0,0,1
party insists,0,0,0,1,0,0,0,1
party law,0,0,0,0,0,1,0,1
party registration,1,0,0,0,0,0,0,1
party transport,0,0,1,0,0,0,0,1
party vox,0,1,0,0,0,0,0,1
pascal played,0,0,1,0,0,0,0,1
pasculli communications,0,0,0,0,0,1,0,1
pasic rebecca,0,0,1,0,0,0,0,1
paso angela,0,1,0,0,0,0,0,1
pass laws,0,0,0,1,0,0,0,1
pass progressive,1,0,0,0,0,0,0,1
pass restrictions,0,0,0,0,1,0,0,1
passed earlier,0,0,1,0,0,0,0,1
passed inflation,0,0,1,0,0,0,0,1
passed legislation,0,0,0,0,0,0,1,1
passed messages,0,0,0,0,1,0,0,1
passed plans,0,1,0,0,0,0,0,1
passed praying,0,0,0,0,0,0,1,1
passed rosen,0,1,0,0,0,0,0,1
passenger pick,0,0,0,0,0,1,0,1
passengers affected,0,0,1,0,0,0,0,1
passengers floodwaters,1,0,0,0,0,0,0,1
passing ambitious,0,0,0,1,0,0,0,1
passing clouds,0,1,0,0,0,0,0,1
passing judgment,0,0,0,1,0,0,0,1
passing overhead,0,0,1,0,0,0,0,1
passive income,0,0,0,0,1,0,0,1
passport required,0,1,0,0,0,0,0,1
past annual,0,1,0,0,0,0,0,1
past biodiversity,0,0,1,0,0,0,0,1
past causing,0,0,0,1,0,0,0,1
past diffenbaugh,0,0,0,1,0,0,0,1
past efforts,0,1,0,0,0,0,0,1
past experience,0,0,0,1,0,0,0,1
past greenhouse,0,1,0,0,0,0,0,1
past heat,0,0,0,0,0,1,0,1
past international,0,1,0,0,0,0,0,1
past mine,1,0,0,0,0,0,0,1
past month,0,1,0,0,0,0,0,1
past negotiations,0,1,0,0,0,0,0,1
past observations,0,0,0,1,0,0,0,1
past plankton,0,0,0,0,0,1,0,1
past projects,0,1,0,0,0,0,0,1
past research,0,0,0,0,0,1,0,1
past roughly,0,1,0,0,0,0,0,1
past san,1,0,0,0,0,0,0,1
past saving,0,0,0,0,0,1,0,1
past seals,0,1,0,0,0,0,0,1
past shiny,0,1,0,0,0,0,0,1
past similarly,0,1,0,0,0,0,0,1
past speeches,0,0,0,1,0,0,0,1
past studies,0,0,0,0,0,1,0,1
past submerged,1,0,0,0,0,0,0,1
past summer,1,0,0,0,0,0,0,1
past sunday,1,0,0,0,0,0,0,1
past sunset,0,1,0,0,0,0,0,1
past temperature,0,1,0,0,0,0,0,1
past week's,0,1,0,0,0,0,0,1
pastel pink,0,0,0,1,0,0,0,1
pastels oranges,0,1,0,0,0,0,0,1
pastor don,0,1,0,0,0,0,0,1
pat guinan,1,0,0,0,0,0,0,1
pat robertson,0,0,0,0,0,1,0,1
path forward.rebecca,0,0,0,0,0,1,0,1
path remains,0,1,0,0,0,0,0,1
path width,0,0,0,0,0,1,0,1
pathogens bacteria,0,0,0,1,0,0,0,1
patient bleeding,1,0,0,0,0,0,0,1
patients mankani,1,0,0,0,0,0,0,1
patil shares,0,1,0,0,0,0,0,1
patricio portillo,0,0,1,0,0,0,0,1
patrick de,1,0,0,0,0,0,0,1
patrick lantrip,0,0,0,0,0,0,1,1
patrick mcelroy,0,0,0,1,0,0,0,1
patrick sheehan,0,0,0,0,0,0,1,1
patrol agents,0,1,0,0,0,0,0,1
patrols raise,0,0,0,1,0,0,0,1
pattern analyzing,0,0,1,0,0,0,0,1
pattern including,0,0,0,0,0,1,0,1
pattern intensified,0,1,0,0,0,0,0,1
pattern yeah,0,0,0,1,0,0,0,1
patterns connor,0,0,0,0,0,1,0,1
patterns heard,0,0,0,1,0,0,0,1
patterns lhakpa,0,1,0,0,0,0,0,1
pattie lives,1,0,0,0,0,0,0,1
pattie's hair,1,0,0,0,0,0,0,1
paul cort,0,0,0,0,0,1,0,1
paul cutler,0,0,0,0,1,0,0,1
paul kelleher,0,0,0,0,1,0,0,1
paul markowski,0,0,0,0,0,1,0,1
paul marshall,0,0,0,0,0,1,0,1
paul singer,0,0,0,0,1,0,0,1
paulo brazil,1,0,0,0,0,0,0,1
paved play,0,0,0,1,0,0,0,1
pay customers,1,0,0,0,0,0,0,1
pay economist,0,0,0,0,0,1,0,1
pay farmers,0,0,0,0,1,0,0,1
pay france,0,1,0,0,0,0,0,1
pay reparations,0,1,0,0,0,0,0,1
payback time,0,0,0,0,0,1,0,1
paying attention,0,0,0,0,1,0,0,1
paying viewers,0,1,0,0,0,0,0,1
payments contribute,0,0,1,0,0,0,0,1
payments flowed,0,0,1,0,0,0,0,1
pays climate,0,1,0,0,0,0,0,1
pea sized,0,0,0,1,0,0,0,1
peabody energy,0,0,0,0,1,0,0,1
peace knowing,1,0,0,0,0,0,0,1
peace negotiations,0,0,0,1,0,0,0,1
peace pact,1,0,0,0,0,0,0,1
peace park,0,1,0,0,0,0,0,1
peace steven's,0,1,0,0,0,0,0,1
peace talks,0,0,0,1,0,0,0,1
peaceful civil,0,1,0,0,0,0,0,1
peaceful days,0,0,0,0,1,0,0,1
peak hours,0,0,0,1,0,0,0,1
peak severe,0,1,0,0,0,0,0,1
peaker plants,0,1,0,0,0,0,0,1
peanut farms,1,0,0,0,0,0,0,1
peanuts corn,0,1,0,0,0,0,0,1
peard bay,0,0,0,0,0,1,0,1
pearl's team,0,0,0,0,1,0,0,1
peatland forests,0,0,0,0,0,0,1,1
peatlands store,0,0,1,0,0,0,0,1
peddled real,1,0,0,0,0,0,0,1
pedestrian died,0,0,0,0,1,0,0,1
pediatric infectious,0,0,0,0,1,0,0,1
peer review,1,0,0,0,0,0,0,1
peikes contributed,0,0,0,1,0,0,0,1
pelfini la,0,1,0,0,0,0,0,1
penetrate foliage,0,0,0,1,0,0,0,1
penguin colonies,1,0,0,0,0,0,0,1
penguin colony,0,1,0,0,0,0,0,1
penguin population,1,0,0,0,0,0,0,1
penguin serves,1,0,0,0,0,0,0,1
penguin tucked,0,1,0,0,0,0,0,1
penguins food,0,1,0,0,0,0,0,1
penguins lose,1,0,0,0,0,0,0,1
penguins walk,0,1,0,0,0,0,0,1
peninsula's marguerite,0,1,0,0,0,0,0,1
pennsylvania hurricane,0,1,0,0,0,0,0,1
pennsylvania's michael,0,0,0,1,0,0,0,1
pension fund,0,0,1,0,0,0,0,1
pensions electricity,0,0,0,0,1,0,0,1
pentagon asserts,0,0,0,0,1,0,0,1
pentagon official,0,1,0,0,0,0,0,1
people angry,0,0,0,0,1,0,0,1
people attempting,0,0,0,0,1,0,0,1
people balancing,0,0,0,0,1,0,0,1
people believed,0,1,0,0,0,0,0,1
people biedul,0,0,0,0,1,0,0,1
people call,0,0,0,0,1,0,0,1
people captured,1,0,0,0,0,0,0,1
people caused,0,0,0,1,0,0,0,1
people chamberlain,0,0,0,0,1,0,0,1
people collect,0,0,0,0,0,1,0,1
people commuting,0,0,1,0,0,0,0,1
people connected,1,0,0,0,0,0,0,1
people continue,0,0,0,0,1,0,0,1
people coping,0,0,0,1,0,0,0,1
people counting,0,1,0,0,0,0,0,1
people crammed,1,0,0,0,0,0,0,1
people cross,0,1,0,0,0,0,0,1
people crowded,1,0,0,0,0,0,0,1
people deal,1,0,0,0,0,0,0,1
people dealing,0,0,0,0,0,0,1,1
people decide,1,0,0,0,0,0,0,1
people demanding,0,0,0,0,1,0,0,1
people depend,0,0,0,0,0,1,0,1
people die,0,0,0,0,1,0,0,1
people dig,0,1,0,0,0,0,0,1
people displaced,0,0,0,0,0,1,0,1
people divert,0,0,0,1,0,0,0,1
people downstream,0,0,0,0,0,1,0,1
people dropped,0,0,0,0,1,0,0,1
people escaped,0,0,1,0,0,0,0,1
people evacuate,0,1,0,0,0,0,0,1
people experts,0,1,0,0,0,0,0,1
people facing,0,0,0,0,0,1,0,1
people farther,0,0,0,0,1,0,0,1
people floodlight,0,0,1,0,0,0,0,1
people forget,0,0,0,0,0,0,1,1
people fuel,0,0,0,0,1,0,0,1
people gathering,0,1,0,0,0,0,0,1
people grosso,1,0,0,0,0,0,0,1
people hear,0,0,0,0,0,1,0,1
people heard,1,0,0,0,0,0,0,1
people helped,0,1,0,0,0,0,0,1
people hey,0,0,0,1,0,0,0,1
people humans,0,1,0,0,0,0,0,1
people identified,0,1,0,0,0,0,0,1
people imagine,0,0,0,0,1,0,0,1
people indigenous,0,0,0,0,0,1,0,1
people information,0,1,0,0,0,0,0,1
people injured,0,0,0,0,0,0,1,1
people injuring,0,1,0,0,0,0,0,1
people inside,0,0,0,0,1,0,0,1
people invest,0,0,0,0,1,0,0,1
people isolated,1,0,0,0,0,0,0,1
people knowing,0,0,0,0,0,1,0,1
people latit,0,0,0,0,0,1,0,1
people listening,0,0,0,1,0,0,0,1
people marched,0,0,0,0,0,1,0,1
people money,0,0,0,0,1,0,0,1
people moss,0,1,0,0,0,0,0,1
people move,0,1,0,0,0,0,0,1
people moved,0,0,0,0,1,0,0,1
people nasuri,0,0,1,0,0,0,0,1
people owned,0,0,0,1,0,0,0,1
people packed,0,1,0,0,0,0,0,1
people pick,0,0,0,0,0,0,1,1
people play,0,0,0,0,1,0,0,1
people polluting,0,1,0,0,0,0,0,1
people posting,0,0,0,0,1,0,0,1
people poverty,0,0,0,0,0,1,0,1
people prepare,0,0,0,0,1,0,0,1
people pröller,0,0,1,0,0,0,0,1
people protested,0,0,0,0,0,1,0,1
people questioned,0,0,0,0,0,1,0,1
people realize,0,1,0,0,0,0,0,1
people relating,0,0,0,1,0,0,0,1
people rely,0,0,0,1,0,0,0,1
people running,0,0,0,0,0,1,0,1
people smoking,1,0,0,0,0,0,0,1
people solve,1,0,0,0,0,0,0,1
people sort,0,0,0,0,0,1,0,1
people sowed,0,1,0,0,0,0,0,1
people spend,0,0,0,0,0,1,0,1
people spoke,0,0,0,1,0,0,0,1
people spraying,0,0,0,1,0,0,0,1
people start,0,0,0,0,1,0,0,1
people started,0,0,0,0,0,1,0,1
people stephanie,0,1,0,0,0,0,0,1
people struggle,1,0,0,0,0,0,0,1
people stuck,0,0,0,0,1,0,0,1
people sucked,0,0,0,0,0,1,0,1
people talking,0,1,0,0,0,0,0,1
people tend,0,0,0,0,1,0,0,1
people texting,0,0,0,0,0,1,0,1
people uprooting,1,0,0,0,0,0,0,1
people visit,0,0,0,0,1,0,0,1
people walk,0,0,0,0,1,0,0,1
people walking,0,0,0,1,0,0,0,1
people wound,0,0,0,0,1,0,0,1
people's ability,1,0,0,0,0,0,0,1
people's collective,0,0,0,0,0,1,0,1
people's health,0,0,0,0,0,1,0,1
people's human,1,0,0,0,0,0,0,1
people's lands,1,0,0,0,0,0,0,1
people's mental,0,0,0,0,0,1,0,1
people's minds,0,1,0,0,0,0,0,1
people's pipes,0,0,0,1,0,0,0,1
people's plates,0,1,0,0,0,0,0,1
people's pocketbook,0,0,0,0,1,0,0,1
people's properties,0,0,0,1,0,0,0,1
people's understanding,0,0,0,0,0,1,0,1
peoples attitudes,0,1,0,0,0,0,0,1
peoples interact,0,0,1,0,0,0,0,1
peoria's water,0,0,0,0,1,0,0,1
pepper spokesperson,0,0,0,1,0,0,0,1
pepsico inched,0,1,0,0,0,0,0,1
pepsico's chief,0,1,0,0,0,0,0,1
percent clean,0,0,0,1,0,0,0,1
percent recycling,1,0,0,0,0,0,0,1
perennial grain,0,0,1,0,0,0,0,1
perfect climate,0,0,0,1,0,0,0,1
perfect storm,0,0,0,1,0,0,0,1
performance buildings,0,0,0,0,0,0,1,1
performance standards,0,0,0,1,0,0,0,1
performance venues,0,1,0,0,0,0,0,1
performed outrage,0,0,0,1,0,0,0,1
performed worse,0,0,1,0,0,0,0,1
peril caleb,0,1,0,0,0,0,0,1
perilous journey,0,0,0,0,1,0,0,1
period closed,0,0,0,1,0,0,0,1
period guinan,1,0,0,0,0,0,0,1
periodic rain,0,0,0,1,0,0,0,1
periodic science,0,0,0,1,0,0,0,1
perkins promised,0,0,1,0,0,0,0,1
perkins sued,0,0,1,0,0,0,0,1
perkins unethical,0,0,1,0,0,0,0,1
perks develop,0,0,0,1,0,0,0,1
permafrost carbon,0,1,0,0,0,0,0,1
permafrost expert,0,1,0,0,0,0,0,1
permanent cutbacks,0,0,0,1,0,0,0,1
permanent home,0,0,0,0,0,1,0,1
permanent homelands,0,0,0,0,0,1,0,1
permanent housing,0,0,0,0,1,0,0,1
permanent jobs,0,0,0,0,0,1,0,1
permanent solutions,1,0,0,0,0,0,0,1
permits alpha,1,0,0,0,0,0,0,1
permits lexington,1,0,0,0,0,0,0,1
permits worth,0,0,0,0,1,0,0,1
permitted oyster,0,0,0,0,0,0,1,1
permitted renewable,0,0,0,0,1,0,0,1
permitting process,0,1,0,0,0,0,0,1
perpetuating cycle,0,0,0,1,0,0,0,1
perrilloux told,0,0,0,0,0,1,0,1
perry environmental,0,0,0,0,1,0,0,1
persaud special,0,1,0,0,0,0,0,1
persisted derek,0,0,0,0,1,0,0,1
persistent air,0,1,0,0,0,0,0,1
persistent drought,0,0,1,0,0,0,0,1
persistent environmental,0,1,0,0,0,0,0,1
person dies,0,0,0,0,1,0,0,1
person living,0,1,0,0,0,0,0,1
person sounding,0,0,0,0,1,0,0,1
person's body,0,0,0,0,0,1,0,1
person's death,0,0,0,0,1,0,0,1
person's roadway.they,0,0,0,0,0,1,0,1
personal experiences,0,1,0,0,0,0,0,1
personal guilt,1,0,0,0,0,0,0,1
personal health,0,0,0,0,1,0,0,1
personal opinion,0,0,0,0,1,0,0,1
personal responsibility,1,0,0,0,0,0,0,1
personally combat,0,0,1,0,0,0,0,1
personnel vehicles,0,0,0,1,0,0,0,1
perspective california,0,0,0,1,0,0,0,1
persuade people,0,0,1,0,0,0,0,1
peru's huascarán,0,1,0,0,0,0,0,1
pessimism surrounding,0,1,0,0,0,0,0,1
pete marovich,0,0,0,0,0,1,0,1
pete souza,0,1,0,0,0,0,0,1
pete vujnovich,0,1,0,0,0,0,0,1
peter candelaria,0,0,0,0,1,0,0,1
peter carving,0,1,0,0,0,0,0,1
peter czerpak,0,1,0,0,0,0,0,1
peter davis,0,0,0,0,1,0,0,1
peter granitz,0,0,0,1,0,0,0,1
peter's square,0,1,0,0,0,0,0,1
petition calling,0,0,0,0,0,1,0,1
petrol pumps,0,1,0,0,0,0,0,1
petrol stations,0,1,0,0,0,0,0,1
petroleum association,0,0,0,0,1,0,0,1
petroleum gas,0,1,0,0,0,0,0,1
petroleum institute,0,1,0,0,0,0,0,1
petroleum natural,0,0,0,1,0,0,0,1
pets inside,0,0,0,0,1,0,0,1
pettus bridge,0,0,0,1,0,0,0,1
pew charitable,1,0,0,0,0,0,0,1
pew research,0,0,0,0,1,0,0,1
pew's lightbody,1,0,0,0,0,0,0,1
ph robinson,1,0,0,0,0,0,0,1
ph.d researcher,0,0,0,0,0,0,1,1
phelan added,0,0,1,0,0,0,0,1
phenomena francis,0,0,0,0,1,0,0,1
phil knight,1,0,0,0,0,0,0,1
phil magakoe,0,1,0,0,0,0,0,1
phil murphy,0,0,0,0,1,0,0,1
philadelphia declined,0,0,0,1,0,0,0,1
philadelphia gas,1,0,0,0,0,0,0,1
philadelphia includes,1,0,0,0,0,0,0,1
philanthropic funding,0,1,0,0,0,0,0,1
philippine archipelago,1,0,0,0,0,0,0,1
philippine history,1,0,0,0,0,0,0,1
phillip ap,0,0,0,0,1,0,0,1
phillip bitzer,0,0,1,0,0,0,0,1
phillip vanderweit,0,1,0,0,0,0,0,1
phillips walks,0,1,0,0,0,0,0,1
phoenix buckeye,0,0,0,0,1,0,0,1
phoenix hey,0,0,0,0,1,0,0,1
phoenix kirk,0,0,0,0,1,0,0,1
phoenix residents,0,0,0,1,0,0,0,1
phoenix salt,0,0,0,1,0,0,0,1
phoenix sprawl,0,0,0,0,1,0,0,1
phoenix suburb,0,0,0,0,1,0,0,1
phoenix's west,0,0,0,0,1,0,0,1
phone call,0,0,1,0,0,0,0,1
phone calls,0,1,0,0,0,0,0,1
phone camera,0,0,0,1,0,0,0,1
phone close,0,0,0,1,0,0,0,1
phone nazma,0,0,0,0,0,1,0,1
phone operators,0,0,0,0,0,1,0,1
phone screaming,0,0,0,0,0,0,1,1
phosphate dap,1,0,0,0,0,0,0,1
phosphorus fertilizer,1,0,0,0,0,0,0,1
phot getty,0,1,0,0,0,0,0,1
photo edited,0,1,0,0,0,0,0,1
photo reaches,0,1,0,0,0,0,0,1
photographer fatima,0,0,0,0,0,1,0,1
photographer steve,0,0,1,0,0,0,0,1
photographic expert,0,1,0,0,0,0,0,1
photographs soaked,0,1,0,0,0,0,0,1
photography hide,0,0,1,0,0,0,0,1
photos documents,0,1,0,0,0,0,0,1
photosynthesize eventually,1,0,0,0,0,0,0,1
phrase alabama,0,0,1,0,0,0,0,1
phrase people,0,0,0,1,0,0,0,1
phrase spread,0,0,0,0,0,1,0,1
phrase struck,1,0,0,0,0,0,0,1
phrase surfaced,0,0,0,0,0,1,0,1
physical health,0,0,0,0,0,1,0,1
physical objects,0,1,0,0,0,0,0,1
physical pieces,0,1,0,0,0,0,0,1
physical planning,1,0,0,0,0,0,0,1
physically attacked,0,0,0,0,1,0,0,1
physicists phillip,0,0,1,0,0,0,0,1
piano people,0,0,0,0,1,0,0,1
pick sultan,0,0,0,1,0,0,0,1
pick ups,0,0,0,0,0,1,0,1
pickup designed,0,0,0,0,1,0,0,1
pickup truck,0,0,1,0,0,0,0,1
pickup trucks,0,0,0,0,1,0,0,1
picture local,0,1,0,0,0,0,0,1
piece titled,0,0,0,0,0,1,0,1
piedmont leads,0,1,0,0,0,0,0,1
piedmont's north,0,1,0,0,0,0,0,1
pier disappear,1,0,0,0,0,0,0,1
pierre confirmed,0,0,0,0,0,1,0,1
pierre du,0,0,1,0,0,0,0,1
pierre roques,0,1,0,0,0,0,0,1
pierre told,0,1,0,0,0,0,0,1
piers washed,0,1,0,0,0,0,0,1
pigs hide,0,1,0,0,0,0,0,1
pigs matches,0,1,0,0,0,0,0,1
pigs mission,0,1,0,0,0,0,0,1
pile packed,1,0,0,0,0,0,0,1
pile seawater,0,1,0,0,0,0,0,1
pillars kelna,0,0,0,0,0,1,0,1
pills mankani,1,0,0,0,0,0,0,1
pilot plant,0,1,0,0,0,0,0,1
pilot program,0,0,0,0,1,0,0,1
pilot walks,0,1,0,0,0,0,0,1
pilot whales,0,0,0,0,0,1,0,1
pilots paramedics,1,0,0,0,0,0,0,1
pinal county,1,0,0,0,0,0,0,1
pine beetles,0,0,0,0,0,1,0,1
pine check,0,0,0,0,0,1,0,1
pine program,0,0,0,0,0,1,0,1
pineapple express,0,0,0,0,0,1,0,1
pineapple farm,0,0,0,1,0,0,0,1
pingree sits,0,0,0,1,0,0,0,1
pink sweats,0,0,0,1,0,0,0,1
pipe dream,0,1,0,0,0,0,0,1
pipe water,0,0,0,0,1,0,0,1
pipelines compressor,0,0,0,1,0,0,0,1
pipelines conocophillips,0,0,0,0,0,1,0,1
pipelines pumps,0,0,0,0,0,1,0,1
pipes absolutely,0,0,0,1,0,0,0,1
pipes beneath,1,0,0,0,0,0,0,1
pipes electric,1,0,0,0,0,0,0,1
pipes holding,0,1,0,0,0,0,0,1
pipes inside,0,1,0,0,0,0,0,1
pipes simply,0,0,0,1,0,0,0,1
pipes sounds,1,0,0,0,0,0,0,1
pipes susan,1,0,0,0,0,0,0,1
pipes yeah,1,0,0,0,0,0,0,1
pirani oversees,0,1,0,0,0,0,0,1
pit lithium,0,1,0,0,0,0,0,1
pit mine,0,1,0,0,0,0,0,1
pit mines,0,1,0,0,0,0,0,1
pit relative,0,1,0,0,0,0,0,1
pitch donald,1,0,0,0,0,0,0,1
pitiless backlash,0,1,0,0,0,0,0,1
pits carved,0,0,0,1,0,0,0,1
pitts alleged,0,0,1,0,0,0,0,1
pitts benefited,0,0,1,0,0,0,0,1
pitts left,0,0,1,0,0,0,0,1
pitts romantic,0,0,1,0,0,0,0,1
pivoted masdar,0,0,0,1,0,0,0,1
pizza cheese,0,0,0,0,0,1,0,1
placid postponed,0,0,0,0,1,0,0,1
plaguing california,0,0,0,0,0,1,0,1
plaguing puerto,0,1,0,0,0,0,0,1
plain promises,0,1,0,0,0,0,0,1
plaines ill,0,0,0,0,1,0,0,1
plains sea,0,0,0,0,1,0,0,1
plan act,0,0,0,1,0,0,0,1
plan ahead,1,0,0,0,0,0,0,1
plan aimed,0,1,0,0,0,0,0,1
plan announced,0,0,0,0,0,1,0,1
plan citing,0,0,0,0,0,1,0,1
plan delivers,0,1,0,0,0,0,0,1
plan earlier,0,1,0,0,0,0,0,1
plan established,0,0,0,1,0,0,0,1
plan greenlight,0,0,0,0,0,1,0,1
plan halt,0,0,0,0,0,1,0,1
plan hogan,1,0,0,0,0,0,0,1
plan investments,1,0,0,0,0,0,0,1
plan monday,0,1,0,0,0,0,0,1
plan proposing,0,0,0,0,0,1,0,1
plan pushed,0,0,0,0,0,1,0,1
plan relies,0,0,0,0,1,0,0,1
plan susan,0,0,0,0,1,0,0,1
plane nsf's,0,0,0,0,1,0,0,1
plane operation,0,0,1,0,0,0,0,1
plane thawing,0,0,1,0,0,0,0,1
planet acharya,0,1,0,0,0,0,0,1
planet advocates,0,1,0,0,0,0,0,1
planet cleetus,0,1,0,0,0,0,0,1
planet dangi,0,1,0,0,0,0,0,1
planet developed,0,1,0,0,0,0,0,1
planet earth,0,0,1,0,0,0,0,1
planet francis,0,0,0,1,0,0,0,1
planet habitable,0,0,1,0,0,0,0,1
planet heats,0,1,0,0,0,0,0,1
planet lauren,0,0,0,0,0,1,0,1
planet money's,0,0,0,1,0,0,0,1
planet passed,0,1,0,0,0,0,0,1
planet polar,0,0,0,1,0,0,0,1
planet schaeffer,0,0,1,0,0,0,0,1
planet supporters,1,0,0,0,0,0,0,1
planet warms,0,0,0,0,1,0,0,1
planet washington,0,0,0,0,1,0,0,1
planet's carbon,0,0,1,0,0,0,0,1
planet's glaciers,1,0,0,0,0,0,0,1
planet's oceans,0,0,0,0,1,0,0,1
planet's remaining,0,0,0,0,0,0,1,1
planet's surface,0,0,0,0,1,0,0,1
planet's warming,0,1,0,0,0,0,0,1
planetary health,0,0,0,0,0,1,0,1
planetary health.martí,0,0,0,0,1,0,0,1
plankton fossils,0,0,0,0,0,1,0,1
plankton living,0,0,0,0,0,1,0,1
plankton migrate,0,0,0,0,0,1,0,1
plankton shift,0,0,0,0,0,1,0,1
planktonic creatures.lauren,0,0,0,0,0,1,0,1
planned activities,0,0,0,0,1,0,0,1
planned burn,1,0,0,0,0,0,0,1
planned communities,0,0,0,0,1,0,0,1
planned conventions,0,0,1,0,0,0,0,1
planned east,0,1,0,0,0,0,0,1
planned south,0,1,0,0,0,0,0,1
planned visit,1,0,0,0,0,0,0,1
planners pushed,1,0,0,0,0,0,0,1
planning accounting,0,0,0,1,0,0,0,1
planning experts,1,0,0,0,0,0,0,1
planning model,0,0,0,0,1,0,0,1
plans announced,0,0,0,0,0,1,0,1
plans call,0,1,0,0,0,0,0,1
plans evidence,0,0,0,0,0,1,0,1
plans matrix,0,0,1,0,0,0,0,1
plans received,0,0,0,0,1,0,0,1
plant approvals,0,0,0,0,0,1,0,1
plant building,0,1,0,0,0,0,0,1
plant built,1,0,0,0,0,0,0,1
plant cereals,1,0,0,0,0,0,0,1
plant closures,0,0,0,0,0,1,0,1
plant diablo,0,0,0,1,0,0,0,1
plant kimberly,1,0,0,0,0,0,0,1
plant knowledge,0,1,0,0,0,0,0,1
plant lettuce,0,0,0,0,0,1,0,1
plant life,0,0,0,1,0,0,0,1
plant native,0,1,0,0,0,0,0,1
plant pathology,0,0,0,1,0,0,0,1
plant ryan,0,0,0,0,1,0,0,1
plantations illegal,0,0,0,0,0,0,1,1
planting cereals,1,0,0,0,0,0,0,1
planting millions,0,0,0,0,1,0,0,1
planting seeds,0,1,0,0,0,0,0,1
planting trees,0,1,0,0,0,0,0,1
planting vegetables,1,0,0,0,0,0,0,1
plants aditya,0,0,0,0,1,0,0,1
plants andy,0,0,1,0,0,0,0,1
plants captures,0,0,0,0,1,0,0,1
plants china,0,0,0,0,0,1,0,1
plants closed,0,0,0,0,0,1,0,1
plants cover,0,1,0,0,0,0,0,1
plants experts,0,0,0,0,1,0,0,1
plants grow,0,0,0,1,0,0,0,1
plants including,0,0,0,0,1,0,0,1
plants john,0,0,0,0,1,0,0,1
plants linked,0,0,0,0,1,0,0,1
plants makes,0,0,1,0,0,0,0,1
plants quadruple,0,1,0,0,0,0,0,1
plants regina,0,1,0,0,0,0,0,1
plants remains,0,1,0,0,0,0,0,1
plants responsible,0,0,0,1,0,0,0,1
plants stefania,0,1,0,0,0,0,0,1
plants takes,0,0,0,1,0,0,0,1
plants trees,0,0,0,1,0,0,0,1
plaque hanging,0,0,1,0,0,0,0,1
plastic bag,1,0,0,0,0,0,0,1
plastic bans,0,0,0,1,0,0,0,1
plastic campaigner,1,0,0,0,0,0,0,1
plastic capsules,0,0,0,1,0,0,0,1
plastic cutlery,0,0,0,1,0,0,0,1
plastic economy,1,0,0,0,0,0,0,1
plastic fork,0,0,0,1,0,0,0,1
plastic industry,0,0,1,0,0,0,0,1
plastic items,0,0,0,1,0,0,0,1
plastic reduction,0,0,0,1,0,0,0,1
plastic restrictions,0,0,0,1,0,0,0,1
plastic sheet,1,0,0,0,0,0,0,1
plastic stemmed,0,0,0,1,0,0,0,1
plastic straws,0,0,0,1,0,0,0,1
plastic tap,1,0,0,0,0,0,0,1
plastic tent,1,0,0,0,0,0,0,1
plastic tide,0,0,0,1,0,0,0,1
plastic transformed,0,0,1,0,0,0,0,1
plastic waste,0,0,0,1,0,0,0,1
plate honeycombed,0,0,0,0,1,0,0,1
plates trays,0,0,0,1,0,0,0,1
plath frederick,0,1,0,0,0,0,0,1
platt getty,0,0,0,0,1,0,0,1
platte river,0,0,1,0,0,0,0,1
plausible worst,0,0,0,0,0,0,1,1
play amid,0,0,0,1,0,0,0,1
play music,0,1,0,0,0,0,0,1
play sports,0,1,0,0,0,0,0,1
play volleyball,0,1,0,0,0,0,0,1
play win,0,0,0,0,1,0,0,1
playbook featuring,0,0,0,0,1,0,0,1
player alabama,0,0,1,0,0,0,0,1
player guitarist,0,1,0,0,0,0,0,1
playground asphalt,0,0,0,1,0,0,0,1
playground dominated,0,0,0,1,0,0,0,1
playground students,0,0,0,1,0,0,0,1
playground surfaces,0,0,0,1,0,0,0,1
playground's perimeter,0,0,0,1,0,0,0,1
playing fiddle,0,1,0,0,0,0,0,1
plays intimate,0,0,0,1,0,0,0,1
pleaded guilty,0,0,0,0,1,0,0,1
pleads guilty,0,0,0,0,1,0,0,1
pledged collectively,0,1,0,0,0,0,0,1
pledged money,0,1,0,0,0,0,0,1
plibersek told,0,1,0,0,0,0,0,1
plot kaplan,0,0,0,0,0,0,1,1
plots students,0,0,0,1,0,0,0,1
plough fields,0,0,1,0,0,0,0,1
plow accident,0,0,0,1,0,0,0,1
plow truck,0,0,0,1,0,0,0,1
plowed ahead,0,0,1,0,0,0,0,1
plowed hundreds,0,0,0,0,0,1,0,1
plowing snow,0,0,0,1,0,0,0,1
plows left,0,0,0,0,0,1,0,1
plumbing system,1,0,0,0,0,0,0,1
plummer explains,0,1,0,0,0,0,0,1
plummer spoke,0,1,0,0,0,0,0,1
plummet climate,0,0,0,0,0,1,0,1
plus.npr.org planetmoney,0,0,1,0,0,0,0,1
poaching pollution,0,0,1,0,0,0,0,1
poaching species,0,0,1,0,0,0,0,1
pod carbon,0,0,0,1,0,0,0,1
pod recycling,0,0,0,1,0,0,0,1
pod traveled,0,0,0,0,0,1,0,1
podcast cautionary,0,0,0,0,0,1,0,1
podcast listen,0,0,0,0,0,1,0,1
podcasts heavy,0,0,0,1,0,0,0,1
podcasts kwasi,0,0,1,0,0,0,0,1
podcasts npr,0,0,1,0,0,0,0,1
podcasts reach,0,0,0,0,0,1,0,1
podcasts today's,0,0,0,1,0,0,0,1
pods account,0,0,0,1,0,0,0,1
pods capsules,0,0,0,1,0,0,0,1
pods consumers,0,0,0,1,0,0,0,1
pods packaging,0,0,0,1,0,0,0,1
pods primarily,0,0,0,1,0,0,0,1
pointy ears,0,0,1,0,0,0,0,1
poison freshwater,0,0,0,0,0,1,0,1
poland hungary,0,1,0,0,0,0,0,1
poland opposed,0,0,0,0,0,1,0,1
poland's ruling,0,0,0,0,0,1,0,1
polar air,0,0,0,0,1,0,0,1
polar ice,1,0,0,0,0,0,0,1
polar regions,0,1,0,0,0,0,0,1
polar scientist,0,0,0,0,1,0,0,1
polarization holt,0,0,0,1,0,0,0,1
polarized politics,0,0,0,0,1,0,0,1
pole eric,0,0,0,1,0,0,0,1
poles plankton,0,0,0,0,0,1,0,1
police catch,0,1,0,0,0,0,0,1
police dragging,0,1,0,0,0,0,0,1
police fired,0,1,0,0,0,0,0,1
police reported,0,0,0,0,0,0,1,1
police roads,1,0,0,0,0,0,0,1
police struggle,0,0,0,1,0,0,0,1
police surveillance,0,1,0,0,0,0,0,1
policies companies,0,0,0,0,0,0,1,1
policies grew,0,0,0,1,0,0,0,1
policies protesters,0,0,0,0,0,1,0,1
policies strategies,0,0,0,0,0,1,0,1
policy adopting,0,1,0,0,0,0,0,1
policy afp,0,0,0,0,0,1,0,1
policy based,0,1,0,0,0,0,0,1
policy center,0,0,0,0,0,1,0,1
policy choices,0,1,0,0,0,0,0,1
policy circles,0,1,0,0,0,0,0,1
policy climate,0,0,1,0,0,0,0,1
policy coordinator,0,0,0,0,0,0,1,1
policy corpus,0,1,0,0,0,0,0,1
policy debate,0,0,0,0,0,1,0,1
policy debates,0,0,0,1,0,0,0,1
policy describes,0,1,0,0,0,0,0,1
policy institutions,0,0,1,0,0,0,0,1
policy manager,0,0,0,1,0,0,0,1
policy options,0,0,0,0,0,1,0,1
policy president,0,1,0,0,0,0,0,1
policy proposals,0,0,0,0,0,1,0,1
policy requires,0,0,1,0,0,0,0,1
policy spending,0,0,0,0,0,0,1,1
policy statements,0,0,1,0,0,0,0,1
policy tool,0,0,0,0,1,0,0,1
policymakers imagine,0,0,0,1,0,0,0,1
policymakers reliable,0,0,0,0,0,1,0,1
political activists,0,0,0,0,1,0,0,1
political branding,0,0,0,0,0,1,0,1
political campaigner,0,0,0,1,0,0,0,1
political commitments,0,1,0,0,0,0,0,1
political committees,0,0,0,0,1,0,0,1
political conflicts,0,0,0,0,1,0,0,1
political decisions,0,1,0,0,0,0,0,1
political determination,0,0,1,0,0,0,0,1
political environment,0,1,0,0,0,0,0,1
political establishment,0,0,0,0,1,0,0,1
political figures,0,0,0,0,0,1,0,1
political fundraising,0,0,0,1,0,0,0,1
political grid,0,0,0,0,0,1,0,1
political implications,0,0,0,1,0,0,0,1
political lines,0,0,0,0,0,0,1,1
political nature,0,0,0,0,1,0,0,1
political operative,0,0,0,0,1,0,0,1
political opposition,0,1,0,0,0,0,0,1
political organization,0,0,0,1,0,0,0,1
political polarization,0,0,0,1,0,0,0,1
political position,0,0,0,0,0,1,0,1
political pressure,0,0,1,0,0,0,0,1
political professionals,0,0,1,0,0,0,0,1
political realities,0,0,0,0,1,0,0,1
political realm,0,0,0,1,0,0,0,1
political spectrum,0,0,0,0,1,0,0,1
political strategy,0,0,0,1,0,0,0,1
political system,1,0,0,0,0,0,0,1
political target,0,0,1,0,0,0,0,1
political tides,0,1,0,0,0,0,0,1
political world,0,0,0,0,1,0,0,1
politically inclined,0,0,0,1,0,0,0,1
politically provocative,0,1,0,0,0,0,0,1
politically sensitive,0,0,0,1,0,0,0,1
politicians compare,0,1,0,0,0,0,0,1
politicians gain,0,1,0,0,0,0,0,1
politicians lobbing,0,0,0,0,0,1,0,1
politics ailsa,0,0,0,0,1,0,0,1
politics coverage,0,0,1,0,0,0,0,1
politics hobbs,0,0,0,0,1,0,0,1
politics ralston,0,0,0,0,1,0,0,1
politics reporter,0,0,1,0,0,0,0,1
pollard's farm,0,0,0,1,0,0,0,1
pollinator friendly,0,1,0,0,0,0,0,1
pollutant nitrogen,0,0,0,1,0,0,0,1
pollutants helping,0,0,0,0,0,1,0,1
pollutants inside,0,0,0,1,0,0,0,1
polluted airports,0,0,1,0,0,0,0,1
polluted lake,0,1,0,0,0,0,0,1
polluted local,1,0,0,0,0,0,0,1
polluted neighborhood,0,0,1,0,0,0,0,1
polluted red,1,0,0,0,0,0,0,1
polluted waterways,1,0,0,0,0,0,0,1
polluters maansi,0,1,0,0,0,0,0,1
polluters worldwide,0,1,0,0,0,0,0,1
polluting businesses,0,0,0,0,1,0,0,1
polluting designs,0,0,0,1,0,0,0,1
polluting vehicles,0,0,0,0,0,1,0,1
pollution anjali,0,0,0,0,1,0,0,1
pollution bob,0,0,1,0,0,0,0,1
pollution cleanup,0,0,0,0,0,0,1,1
pollution climate,0,0,0,0,1,0,0,1
pollution coal,0,0,0,0,1,0,0,1
pollution connor,0,0,0,0,0,1,0,1
pollution cuts,0,0,0,1,0,0,0,1
pollution driving,0,1,0,0,0,0,0,1
pollution fanning,0,0,1,0,0,0,0,1
pollution farming,0,0,1,0,0,0,0,1
pollution free,0,0,0,0,1,0,0,1
pollution heating,0,1,0,0,0,0,0,1
pollution issue,0,0,0,1,0,0,0,1
pollution levels,0,0,0,0,0,1,0,1
pollution reductions,0,0,0,0,1,0,0,1
pollution salt,0,0,0,0,1,0,0,1
pollution standards,0,0,0,0,0,1,0,1
pollution.for npr,0,1,0,0,0,0,0,1
pollution.martí yeah,0,0,0,0,1,0,0,1
polystyrene cups,0,0,0,1,0,0,0,1
ponce earlier,1,0,0,0,0,0,0,1
pond sand,0,0,0,0,0,1,0,1
ponderosa pine,0,0,0,0,0,1,0,1
poor country,0,0,0,0,0,1,0,1
poor cousin,0,0,1,0,0,0,0,1
poor governance,0,0,1,0,0,0,0,1
poor rainfall,1,0,0,0,0,0,0,1
poor residents,0,0,0,0,1,0,0,1
poor woman,1,0,0,0,0,0,0,1
poorer communities,0,0,0,0,0,0,1,1
poorest municipalities,0,1,0,0,0,0,0,1
poorest nations,0,1,0,0,0,0,0,1
poorest people,0,0,1,0,0,0,0,1
poorly planned,0,0,0,0,1,0,0,1
pop quiz,0,0,0,0,0,1,0,1
pope andrew,1,0,0,0,0,0,0,1
pope francis,0,1,0,0,0,0,0,1
popping colors,0,0,0,1,0,0,0,1
popping noise,1,0,0,0,0,0,0,1
popular bee,0,0,0,0,0,1,0,1
popular climate,0,1,0,0,0,0,0,1
popular forms,0,0,1,0,0,0,0,1
popular gun,0,0,0,1,0,0,0,1
popular hawaiian,0,0,0,0,1,0,0,1
popular maverick,0,0,0,0,1,0,0,1
popular tiktok,0,0,0,1,0,0,0,1
population ages,0,1,0,0,0,0,0,1
population boom,0,0,0,0,1,0,0,1
population coming,0,0,0,0,0,1,0,1
population declines,1,0,0,0,0,0,0,1
population depend,0,0,1,0,0,0,0,1
population flourished,0,0,0,0,0,1,0,1
population health,0,0,0,0,0,1,0,1
population lack,0,0,0,0,0,1,0,1
population live,0,0,0,0,0,1,0,1
population policies,0,0,0,0,1,0,0,1
population understand,0,0,0,0,0,0,1,1
population's set,0,0,0,1,0,0,0,1
populations boomed,0,0,0,0,1,0,0,1
populations grow,0,1,0,0,0,0,0,1
populations including,0,0,0,0,0,1,0,1
populations move,0,0,0,0,1,0,0,1
populations people,0,0,0,1,0,0,0,1
populist hero,0,0,1,0,0,0,0,1
populous city,0,0,0,0,0,1,0,1
populous southern,0,0,0,0,0,1,0,1
porch plucking,0,1,0,0,0,0,0,1
port saint,0,1,0,0,0,0,0,1
port sanibel,1,0,0,0,0,0,0,1
port town,0,1,0,0,0,0,0,1
portable bathrooms,0,1,0,0,0,0,0,1
porter ali,1,0,0,0,0,0,0,1
porter director,0,0,0,0,1,0,0,1
portfolios outperform,0,0,1,0,0,0,0,1
portillo believes,0,0,1,0,0,0,0,1
portion appropriated,0,1,0,0,0,0,0,1
portland coupled,0,0,0,0,1,0,0,1
portland oregon,0,0,0,0,1,0,0,1
portland pearl's,0,0,0,0,1,0,0,1
portland's grant,0,1,0,0,0,0,0,1
portland's streets,0,0,0,0,1,0,0,1
poses challenges,0,0,1,0,0,0,0,1
poses climate,0,0,0,1,0,0,0,1
poses daunting,0,0,0,0,1,0,0,1
position essentially,0,0,0,0,1,0,0,1
positions laughs,0,1,0,0,0,0,0,1
positions recently,0,1,0,0,0,0,0,1
positive associations,0,0,0,1,0,0,0,1
positive change,1,0,0,0,0,0,0,1
positive feedback,0,0,0,0,1,0,0,1
positive impact,0,0,0,0,0,1,0,1
positive news,0,0,1,0,0,0,0,1
positive step,0,1,0,0,0,0,0,1
positive vision,0,0,0,1,0,0,0,1
positively affect,0,0,1,0,0,0,0,1
possibly fail,0,0,0,1,0,0,0,1
possibly serve,0,0,1,0,0,0,0,1
possibly turtles,1,0,0,0,0,0,0,1
post disaster,0,0,0,0,1,0,0,1
post dispatch,1,0,0,0,0,0,0,1
post doc,0,0,0,0,0,1,0,1
post explains,0,0,0,0,0,1,0,1
post fossil,0,0,0,0,1,0,0,1
post getty,0,1,0,0,0,0,0,1
post john,0,1,0,0,0,0,0,1
post secondary,0,0,0,0,1,0,0,1
post suspended,0,0,0,1,0,0,0,1
posting environmental,0,0,0,0,0,1,0,1
posts material,0,0,0,0,1,0,0,1
posts tagged,0,0,0,0,0,1,0,1
potable water,0,0,0,0,0,1,0,1
potato sack,1,0,0,0,0,0,0,1
potent planet,0,0,0,0,0,0,1,1
potential action,0,0,0,0,1,0,0,1
potential advantage,0,1,0,0,0,0,0,1
potential arctic,0,0,0,0,0,1,0,1
potential bans,0,0,0,1,0,0,0,1
potential benefits,0,1,0,0,0,0,0,1
potential climate,0,1,0,0,0,0,0,1
potential dangers,1,0,0,0,0,0,0,1
potential environmental,1,0,0,0,0,0,0,1
potential fatality,0,0,0,0,0,1,0,1
potential grid,0,0,0,0,1,0,0,1
potential implications,0,1,0,0,0,0,0,1
potential loss,0,0,0,0,1,0,0,1
potential negotiation,0,1,0,0,0,0,0,1
potential path,0,0,0,0,0,1,0,1
potential plastic,0,0,0,1,0,0,0,1
potential power,0,0,0,0,1,0,0,1
potential promise,0,1,0,0,0,0,0,1
potential reforms,1,0,0,0,0,0,0,1
potential replacements,0,0,0,1,0,0,0,1
potential risks,0,1,0,0,0,0,0,1
potential runoff,0,0,0,0,0,1,0,1
potential site,0,0,0,0,0,1,0,1
potential solar,0,1,0,0,0,0,0,1
potential solution,1,0,0,0,0,0,0,1
potential strain,0,0,0,1,0,0,0,1
potential surveillance,0,0,0,0,1,0,0,1
potential unknowns,0,1,0,0,0,0,0,1
potential win,1,0,0,0,0,0,0,1
potentially accelerates,0,0,0,0,1,0,0,1
potentially catastrophic,0,1,0,0,0,0,0,1
potentially friendlier,0,0,0,1,0,0,0,1
potentially harm,0,0,0,0,1,0,0,1
potentially healthier,0,1,0,0,0,0,0,1
potentially trillions,0,1,0,0,0,0,0,1
potentially vulnerable,0,1,0,0,0,0,0,1
potentially weakening,0,0,1,0,0,0,0,1
potsdam institute,0,0,0,1,0,0,0,1
poultry company,0,0,0,0,1,0,0,1
poultry operations,0,1,0,0,0,0,0,1
pound sack,1,0,0,0,0,0,0,1
pound sacks,1,0,0,0,0,0,0,1
pour water,0,0,0,0,1,0,0,1
poured billions,0,1,0,0,0,0,0,1
poured money,1,0,0,0,0,0,0,1
pouring golden,0,0,0,0,0,1,0,1
pouring rain,0,1,0,0,0,0,0,1
pours based,1,0,0,0,0,0,0,1
poverty abounds,0,0,0,0,1,0,0,1
poverty development,0,1,0,0,0,0,0,1
poverty poor,0,0,1,0,0,0,0,1
powdered food,1,0,0,0,0,0,0,1
powell america's,0,1,0,0,0,0,0,1
powell insists,0,0,0,0,0,1,0,1
powell told,0,0,0,0,0,1,0,1
power accountable,0,1,0,0,0,0,0,1
power authority,0,0,0,1,0,0,0,1
power bills,0,0,1,0,0,0,0,1
power capacity,0,0,0,1,0,0,0,1
power ceo,0,0,1,0,0,0,0,1
power coming,0,0,0,0,1,0,0,1
power companies,0,0,1,0,0,0,0,1
power contractor,0,0,1,0,0,0,0,1
power days,1,0,0,0,0,0,0,1
power declined,0,0,1,0,0,0,0,1
power demand,0,0,0,0,1,0,0,1
power directed,0,0,1,0,0,0,0,1
power eric,0,0,1,0,0,0,0,1
power executives,0,0,1,0,0,0,0,1
power failures,1,0,0,0,0,0,0,1
power family,0,0,0,0,1,0,0,1
power generated,0,0,0,0,1,0,0,1
power grids,0,0,0,0,1,0,0,1
power heavy,0,0,0,1,0,0,0,1
power lies,0,0,0,0,0,1,0,1
power light's,0,0,1,0,0,0,0,1
power linked,0,0,1,0,0,0,0,1
power lower,0,0,0,0,1,0,0,1
power market,0,0,1,0,0,0,0,1
power owner,0,0,0,0,1,0,0,1
power past,0,1,0,0,0,0,0,1
power rates,0,0,0,1,0,0,0,1
power received,0,0,1,0,0,0,0,1
power remained,1,0,0,0,0,0,0,1
power remains,0,0,1,0,0,0,0,1
power runs,0,0,1,0,0,0,0,1
power sam,0,0,0,0,1,0,0,1
power sector,0,0,1,0,0,0,0,1
power service,0,0,0,0,0,1,0,1
power thirteen,0,1,0,0,0,0,0,1
power yellowhammer,0,0,1,0,0,0,0,1
powerco announced,0,0,0,0,0,1,0,1
powered chain,0,0,0,0,0,1,0,1
powered evs,0,0,0,0,0,1,0,1
powered fan,1,0,0,0,0,0,0,1
powered infrared,0,0,0,0,1,0,0,1
powered sensors,0,0,0,0,0,1,0,1
powerful climate,0,0,0,0,1,0,0,1
powerful earthquake,1,0,0,0,0,0,0,1
powerful guns,0,0,0,1,0,0,0,1
powerful incentive,0,1,0,0,0,0,0,1
powerful motivators,1,0,0,0,0,0,0,1
powerful nations,0,1,0,0,0,0,0,1
powerful offensive,0,0,0,1,0,0,0,1
powerful people,0,0,0,0,1,0,0,1
powerful statement,0,1,0,0,0,0,0,1
powerful surge,1,0,0,0,0,0,0,1
powerful tool,0,0,0,1,0,0,0,1
powerful updraft,0,0,0,0,0,1,0,1
powerful waves,0,0,0,0,1,0,0,1
powerful win,0,0,1,0,0,0,0,1
powering frigid,0,0,0,0,1,0,0,1
powering stations,0,0,0,0,0,1,0,1
poweroutage.us president,0,0,0,1,0,0,0,1
powerpoint presentation,0,0,0,0,0,0,1,1
powers authority,0,0,0,0,1,0,0,1
powers supporting,0,0,0,1,0,0,0,1
ppb jeff,0,0,0,0,1,0,0,1
pr firms,0,0,0,1,0,0,0,1
pr100 researchers,0,0,0,1,0,0,0,1
practical consensus,0,1,0,0,0,0,0,1
practical farmers,0,1,0,0,0,0,0,1
practical implications,0,0,0,0,1,0,0,1
practical options,0,0,0,0,0,1,0,1
practical reasons,0,1,0,0,0,0,0,1
practical steps,0,1,0,0,0,0,0,1
practical terms,0,0,1,0,0,0,0,1
practice impossible,0,1,0,0,0,0,0,1
practice oil,1,0,0,0,0,0,0,1
practiced law,0,0,1,0,0,0,0,1
practices candelaria,0,0,0,0,1,0,0,1
practices combination,0,0,1,0,0,0,0,1
practices companies,0,0,0,0,1,0,0,1
practices impossible,0,1,0,0,0,0,0,1
practices including,0,0,1,0,0,0,0,1
practices infestation,0,0,0,0,0,1,0,1
practices regenerative,0,1,0,0,0,0,0,1
practicing rituals,0,0,0,1,0,0,0,1
prager university,0,0,0,0,0,1,0,1
pragmatic approach,0,0,0,0,1,0,0,1
pragmatic realistic,0,0,0,1,0,0,0,1
pragmatism beats,0,0,1,0,0,0,0,1
prairie city,0,1,0,0,0,0,0,1
prairie grass,1,0,0,0,0,0,0,1
praised australia,0,1,0,0,0,0,0,1
praising southern,0,0,1,0,0,0,0,1
pratt explains,0,0,1,0,0,0,0,1
prayer rings,0,1,0,0,0,0,0,1
prayer rugs,0,1,0,0,0,0,0,1
prayog director,0,1,0,0,0,0,0,1
prayog hide,0,1,0,0,0,0,0,1
prayog ssp,0,1,0,0,0,0,0,1
pre drought,0,0,0,0,0,1,0,1
preble street,0,0,0,0,1,0,0,1
precautions university,0,0,0,0,0,1,0,1
precedent risking,0,0,0,1,0,0,0,1
precious archives,0,1,0,0,0,0,0,1
precious taking,0,0,1,0,0,0,0,1
precipitation california,0,0,0,0,1,0,0,1
precipitation campbell,0,0,0,1,0,0,0,1
precipitation causing,0,0,0,1,0,0,0,1
precipitation due,0,0,0,0,0,0,1,1
precipitation including,0,0,0,0,1,0,0,1
precipitation reversing,0,0,0,0,0,0,1,1
precipitation totals,0,0,0,0,1,0,0,1
precipitation wind,0,1,0,0,0,0,0,1
precise threshold,0,0,0,1,0,0,0,1
predecessor doug,0,0,0,0,1,0,0,1
predecessor republican,0,0,0,0,1,0,0,1
predecessor's pullout,0,1,0,0,0,0,0,1
predict low,0,1,0,0,0,0,0,1
predict trends,0,0,0,0,0,1,0,1
predict upcoming,0,0,0,0,1,0,0,1
predicting global,0,0,0,1,0,0,0,1
predicting sea,1,0,0,0,0,0,0,1
prediction appears,0,0,0,0,0,0,1,1
predictions based,0,0,0,0,0,0,1,1
predicts price,0,1,0,0,0,0,0,1
predominant ingredient,0,1,0,0,0,0,0,1
preety bhandari,0,1,0,0,0,0,0,1
prefect claudio,0,1,0,0,0,0,0,1
prefer climate,0,0,0,0,1,0,0,1
preindustrial times,0,0,0,1,0,0,0,1
preliminary figures,0,0,1,0,0,0,0,1
preliminary rating,0,0,0,0,0,1,0,1
prema gopalan,0,1,0,0,0,0,0,1
premier giorgia,0,1,0,0,0,0,0,1
premier hotel,0,1,0,0,0,0,0,1
premium prices,0,1,0,0,0,0,0,1
prepare countries,0,0,0,0,0,1,0,1
prepare initiative,0,1,0,0,0,0,0,1
prepare nathan,0,0,0,0,0,1,0,1
prepared communities,1,0,0,0,0,0,0,1
prepared residents,1,0,0,0,0,0,0,1
preparedness drills,1,0,0,0,0,0,0,1
preparing communities,0,0,0,1,0,0,0,1
preparing rain,0,0,0,1,0,0,0,1
presentation packed,0,0,0,0,0,0,1,1
preserve ecosystems,0,0,0,0,1,0,0,1
preserve forests,0,1,0,0,0,0,0,1
preserving coastal,0,0,1,0,0,0,0,1
president abdel,0,1,0,0,0,0,0,1
president abdul,0,1,0,0,0,0,0,1
president announced,1,0,0,0,0,0,0,1
president bolsonaro,0,1,0,0,0,0,0,1
president christopher,0,0,0,0,0,1,0,1
president david,1,0,0,0,0,0,0,1
president decided,1,0,0,0,0,0,0,1
president elect,0,1,0,0,0,0,0,1
president emomali,0,0,0,0,0,1,0,1
president ferdinand,1,0,0,0,0,0,0,1
president frans,0,0,0,0,0,1,0,1
president galvanize,0,1,0,0,0,0,0,1
president jed,0,0,1,0,0,0,0,1
president joko,0,0,0,0,1,0,0,1
president karen,0,0,0,0,1,0,0,1
president lula,0,0,0,0,1,0,0,1
president obama,0,0,0,0,0,1,0,1
president obama's,0,0,0,0,0,1,0,1
president pledged,1,0,0,0,0,0,0,1
president rosario,1,0,0,0,0,0,0,1
president signed,0,1,0,0,0,0,0,1
president sisi,0,1,0,0,0,0,0,1
president trump,0,0,0,0,0,1,0,1
president volodymyr,0,1,0,0,0,0,0,1
president xi,0,1,0,0,0,0,0,1
president's budget,0,0,0,0,0,0,1,1
president's response,0,1,0,0,0,0,0,1
president's speech,0,1,0,0,0,0,0,1
presidential election,0,1,0,0,0,0,0,1
press briefing,0,0,0,0,0,1,0,1
press coffee,0,0,0,1,0,0,0,1
press contributed,0,0,0,0,0,1,0,1
press corps,0,0,1,0,0,0,0,1
press covered,0,0,0,0,0,1,0,1
press event,0,1,0,0,0,0,0,1
press including,0,0,1,0,0,0,0,1
press interviews,0,1,0,0,0,0,0,1
press reported,0,0,0,1,0,0,0,1
pressing time,0,0,0,0,1,0,0,1
pressure builds,0,0,0,0,0,1,0,1
pressure campaign,0,0,1,0,0,0,0,1
pressure compton,0,0,0,0,0,1,0,1
pressure drops,0,0,0,1,0,0,0,1
pressure farmers,0,0,0,0,1,0,0,1
pressure investors,0,0,0,0,0,0,1,1
pressure rotating,0,0,0,0,1,0,0,1
pressure steam,1,0,0,0,0,0,0,1
pressured biden,0,0,0,0,0,1,0,1
prestigious law,0,0,0,0,1,0,0,1
pretty benign,0,0,0,0,1,0,0,1
pretty complex,0,0,0,1,0,0,0,1
pretty consistently,0,0,0,0,0,1,0,1
pretty familiar,0,0,0,1,0,0,0,1
pretty fantastic,0,0,0,0,0,1,0,1
pretty fast,0,0,0,1,0,0,0,1
pretty hopeful,0,0,1,0,0,0,0,1
pretty hot,1,0,0,0,0,0,0,1
pretty mild,0,0,0,0,0,1,0,1
pretty outrageous,0,0,1,0,0,0,0,1
pretty polarized,0,0,0,0,1,0,0,1
pretty progressive,0,0,0,0,1,0,0,1
pretty recently,0,0,0,0,1,0,0,1
pretty regularly,0,0,0,1,0,0,0,1
pretty severe,0,0,0,0,1,0,0,1
pretty shaken,0,0,0,1,0,0,0,1
pretty simple,1,0,0,0,0,0,0,1
pretty slowly,0,0,1,0,0,0,0,1
pretty spotless,0,0,0,1,0,0,0,1
pretty strong,0,0,0,1,0,0,0,1
pretty unexpected,1,0,0,0,0,0,0,1
prevailing science,1,0,0,0,0,0,0,1
prevent catastrophic,0,0,0,0,0,1,0,1
prevent climate,0,1,0,0,0,0,0,1
prevent damage,0,0,0,1,0,0,0,1
prevent dishonest,0,1,0,0,0,0,0,1
prevent double,0,1,0,0,0,0,0,1
prevent future,0,0,0,0,0,0,1,1
prevent hemorrhage,1,0,0,0,0,0,0,1
prevent irreversible,1,0,0,0,0,0,0,1
prevent methane,0,1,0,0,0,0,0,1
prevent wildfires,0,0,0,0,0,0,1,1
preventative stuff,0,0,1,0,0,0,0,1
prevented critical,0,0,0,1,0,0,0,1
preventing catastrophic,0,0,0,0,0,1,0,1
preventing deforestation,0,0,0,0,0,0,1,1
preventing heat,0,1,0,0,0,0,0,1
prevention medical,0,0,0,0,0,1,0,1
prevents governments,0,1,0,0,0,0,0,1
previous australian,0,1,0,0,0,0,0,1
previous community,0,1,0,0,0,0,0,1
previous conservative,0,1,0,0,0,0,0,1
previous droughts,0,0,0,0,0,1,0,1
previous government,0,1,0,0,0,0,0,1
previous hurricanes,1,0,0,0,0,0,0,1
previous incentive,0,0,0,0,0,0,1,1
previous jung,0,1,0,0,0,0,0,1
previous modeling,0,0,0,1,0,0,0,1
previous photo,0,1,0,0,0,0,0,1
previous planned,0,0,1,0,0,0,0,1
previous records,1,0,0,0,0,0,0,1
previous stint,0,1,0,0,0,0,0,1
previous ten,0,0,1,0,0,0,0,1
previous u.s,0,1,0,0,0,0,0,1
previously agreed,0,1,0,0,0,0,0,1
previously denied,0,0,0,0,1,0,0,1
previously served,0,0,1,0,0,0,0,1
previously unseen,0,0,1,0,0,0,0,1
prey read,0,0,0,0,0,1,0,1
prezioso afp,0,0,0,0,1,0,0,1
price cap,0,0,0,0,1,0,0,1
price caps,1,0,0,0,0,0,0,1
price competitive,0,1,0,0,0,0,0,1
price customers,0,0,0,0,1,0,0,1
price mwenja,1,0,0,0,0,0,0,1
price paid,0,0,0,0,1,0,0,1
price parity,0,1,0,0,0,0,0,1
price scientists,0,1,0,0,0,0,0,1
price tracking,1,0,0,0,0,0,0,1
prices alabama,0,0,1,0,0,0,0,1
prices amid,0,0,0,0,0,1,0,1
prices artificially,0,0,0,0,1,0,0,1
prices changing,0,0,1,0,0,0,0,1
prices consumers,1,0,0,0,0,0,0,1
prices dramatically,0,1,0,0,0,0,0,1
prices drop,0,0,0,0,0,1,0,1
prices dropping,1,0,0,0,0,0,0,1
prices eventually,0,0,0,0,0,1,0,1
prices fall,1,0,0,0,0,0,0,1
prices haywire,1,0,0,0,0,0,0,1
prices increase,1,0,0,0,0,0,0,1
prices michael,1,0,0,0,0,0,0,1
prices mwenja,1,0,0,0,0,0,0,1
prices president,1,0,0,0,0,0,0,1
prices republicans,0,1,0,0,0,0,0,1
priest father,0,0,1,0,0,0,0,1
primarily located,0,0,0,0,0,1,0,1
primary calving,0,0,0,0,0,1,0,1
primary defense,0,1,0,0,0,0,0,1
primary forms,0,0,0,1,0,0,0,1
primary refrigerants,0,0,0,0,0,0,1,1
primary source,1,0,0,0,0,0,0,1
primary supply,1,0,0,0,0,0,0,1
prime minister's,0,0,0,1,0,0,0,1
prime ministers,0,1,0,0,0,0,0,1
prior alert,0,1,0,0,0,0,0,1
prior notice,0,0,1,0,0,0,0,1
priorities carter,0,0,0,0,1,0,0,1
priorities heading,0,1,0,0,0,0,0,1
prioritize funding,0,0,0,1,0,0,0,1
prioritize investing,0,0,0,1,0,0,0,1
prioritize workplace,0,0,0,0,1,0,0,1
prioritized lowering,0,0,0,0,0,1,0,1
prioritizing climate,0,0,0,1,0,0,0,1
prioritizing deployment,0,0,0,1,0,0,0,1
priority appointing,0,0,1,0,0,0,0,1
priority rights,0,0,0,0,1,0,0,1
prisma bildagentur,0,0,1,0,0,0,0,1
prisoners alaa,0,1,0,0,0,0,0,1
prisoners human,0,1,0,0,0,0,0,1
prisoners meaning,0,0,0,0,1,0,0,1
prisoners npr's,0,0,0,0,1,0,0,1
prisons eating,0,0,0,0,0,1,0,1
prisons steven,0,1,0,0,0,0,0,1
pristine seas,0,1,0,0,0,0,0,1
pritzker traveled,0,0,0,0,0,0,1,1
prius dominated,0,0,0,0,1,0,0,1
prius review,0,0,0,0,1,0,0,1
private companies,0,0,1,0,0,0,0,1
private company,0,0,0,1,0,0,0,1
private dollars,0,1,0,0,0,0,0,1
private donations,0,0,0,0,1,0,0,1
private emails,0,0,1,0,0,0,0,1
private flight,0,0,1,0,0,0,0,1
private life,0,1,0,0,0,0,0,1
private lines,0,0,0,1,0,0,0,1
private markets,0,1,0,0,0,0,0,1
private meteorologist,0,0,0,1,0,0,0,1
private millers,1,0,0,0,0,0,0,1
private partnership,0,0,1,0,0,0,0,1
private research,0,0,1,0,0,0,0,1
private sector's,0,1,0,0,0,0,0,1
privately lobbied,0,0,1,0,0,0,0,1
privately oppose,0,0,1,0,0,0,0,1
prize winner,0,0,0,0,1,0,0,1
pro free,0,0,1,0,0,0,0,1
pro freedom,0,0,0,0,0,1,0,1
pro solar,0,0,1,0,0,0,0,1
pro stove,0,0,0,1,0,0,0,1
proactive buyouts,1,0,0,0,0,0,0,1
problem's urgency,0,0,0,0,0,0,1,1
problematic message,0,0,0,0,1,0,0,1
problematic rachel,0,1,0,0,0,0,0,1
probst ap,0,1,0,0,0,0,0,1
process based,0,1,0,0,0,0,0,1
process called,0,0,0,0,0,0,1,1
process commissioner,0,0,0,0,1,0,0,1
process emerged,0,0,0,0,1,0,0,1
process fema,0,1,0,0,0,0,0,1
process human,0,0,0,0,0,1,0,1
process starts,0,1,0,0,0,0,0,1
process takes,0,1,0,0,0,0,0,1
processes affecting,0,0,0,0,1,0,0,1
processes happen,1,0,0,0,0,0,0,1
processes leading,0,0,0,0,0,1,0,1
processing center,0,1,0,0,0,0,0,1
processing plant,0,1,0,0,0,0,0,1
proclaimed burger,0,1,0,0,0,0,0,1
procurement officer,0,1,0,0,0,0,0,1
procurement teams,0,1,0,0,0,0,0,1
produce fewer,0,1,0,0,0,0,0,1
produce lasting,0,0,0,0,0,1,0,1
produce material,0,0,1,0,0,0,0,1
produce organic,0,1,0,0,0,0,0,1
produce real,0,1,0,0,0,0,0,1
produce reliable,0,1,0,0,0,0,0,1
produce sound,0,0,0,0,0,1,0,1
produce weather,0,0,0,0,1,0,0,1
produced climate,0,0,0,1,0,0,0,1
produced flash,0,1,0,0,0,0,0,1
produced greenpeace,1,0,0,0,0,0,0,1
produced heavy,0,1,0,0,0,0,0,1
produced it’s,0,0,0,1,0,0,0,1
producer additional,0,0,1,0,0,0,0,1
producer berly,0,0,0,0,0,1,0,1
producer companies,0,1,0,0,0,0,0,1
producer dil,0,0,0,0,0,1,0,1
producer peabody,0,0,0,0,1,0,0,1
producer phelan,0,0,1,0,0,0,0,1
producer rebecca,0,0,0,0,0,1,0,1
producer responsibility,0,0,0,1,0,0,0,1
producer robert,0,1,0,0,0,0,0,1
producer tony,0,0,1,0,0,0,0,1
produces elements,0,0,0,1,0,0,0,1
produces food,1,0,0,0,0,0,0,1
produces lots,0,1,0,0,0,0,0,1
produces meat,0,1,0,0,0,0,0,1
producing countries,0,0,0,1,0,0,0,1
producing food,1,0,0,0,0,0,0,1
producing meltwater,0,0,0,1,0,0,0,1
producing nation,0,0,0,1,0,0,0,1
producing rainfall,0,0,0,0,0,0,1,1
product development,0,1,0,0,0,0,0,1
product footing,0,1,0,0,0,0,0,1
product gdp,0,0,0,0,0,1,0,1
product ready,0,1,0,0,0,0,0,1
production amounting,1,0,0,0,0,0,0,1
production company,0,1,0,0,0,0,0,1
production cut,1,0,0,0,0,0,0,1
production eugene,0,0,1,0,0,0,0,1
production including,0,1,0,0,0,0,0,1
production line,0,1,0,0,0,0,0,1
production lower,1,0,0,0,0,0,0,1
production plummer,0,1,0,0,0,0,0,1
production systems,0,0,1,0,0,0,0,1
productive sectors,0,0,1,0,0,0,0,1
products building,1,0,0,0,0,0,0,1
products cultivated,0,0,0,0,0,0,1,1
prof berhe,0,0,1,0,0,0,0,1
professional circles,0,0,1,0,0,0,0,1
professional homosexual,1,0,0,0,0,0,0,1
professionals business,0,0,1,0,0,0,0,1
professor agrees,0,0,0,0,1,0,0,1
professor andrew,0,0,0,1,0,0,0,1
professor fisher,0,0,0,1,0,0,0,1
professor josh,1,0,0,0,0,0,0,1
professor karen,0,0,1,0,0,0,0,1
professor max,0,0,0,0,0,0,1,1
professor paul,0,0,0,0,1,0,0,1
professor victor,0,0,0,1,0,0,0,1
profit margins,0,0,1,0,0,0,0,1
profit organization,0,0,0,0,1,0,0,1
profit research,0,0,0,1,0,0,0,1
profitable utility,0,0,1,0,0,0,0,1
profits ahmad,0,1,0,0,0,0,0,1
profits philip,0,1,0,0,0,0,0,1
profits sæthren,0,1,0,0,0,0,0,1
profound consequences,0,1,0,0,0,0,0,1
profound impacts,0,1,0,0,0,0,0,1
profound implications,0,1,0,0,0,0,0,1
profound instability,0,1,0,0,0,0,0,1
program climate,0,0,0,0,0,1,0,1
program coordinator,1,0,0,0,0,0,0,1
program focusing,0,1,0,0,0,0,0,1
program geared,1,0,0,0,0,0,0,1
program specialist,0,1,0,0,0,0,0,1
program started,1,0,0,0,0,0,0,1
program yagana,0,0,1,0,0,0,0,1
programme tells,0,0,0,0,0,1,0,1
programme wrote,0,1,0,0,0,0,0,1
programme's rehabilitation,0,0,1,0,0,0,0,1
programs including,0,0,0,0,0,0,1,1
programs proponents,0,0,0,0,0,0,1,1
programs real,0,1,0,0,0,0,0,1
progress npr's,0,0,0,0,1,0,0,1
progress raising,0,1,0,0,0,0,0,1
progress report,0,0,0,1,0,0,0,1
progress reports,0,1,0,0,0,0,0,1
progress yeah,0,0,0,1,0,0,0,1
progressive legislation,1,0,0,0,0,0,0,1
progressive trajectory,1,0,0,0,0,0,0,1
progressive watchdog,0,0,0,0,1,0,0,1
project activist,0,1,0,0,0,0,0,1
project altogether,0,0,0,0,0,1,0,1
project application,0,0,0,0,1,0,0,1
project approval,0,0,0,0,0,1,0,1
project called,0,0,0,0,1,0,0,1
project calling,0,0,0,0,0,1,0,1
project developer,0,1,0,0,0,0,0,1
project developers,0,1,0,0,0,0,0,1
project director,1,0,0,0,0,0,0,1
project east,0,0,0,0,1,0,0,1
project grew,0,0,0,1,0,0,0,1
project highlighted,0,1,0,0,0,0,0,1
project lent,0,0,0,0,0,1,0,1
project list,0,0,0,1,0,0,0,1
project psychologists,0,1,0,0,0,0,0,1
project republican,0,0,0,0,0,1,0,1
project research,1,0,0,0,0,0,0,1
project solar,0,0,0,0,1,0,0,1
project suggested,1,0,0,0,0,0,0,1
project sultan,0,0,0,1,0,0,0,1
project supported,0,0,1,0,0,0,0,1
project willow,0,0,0,0,0,1,0,1
project's impact,0,0,0,0,1,0,0,1
projected emissions,0,0,0,0,0,1,0,1
projected pattern,0,0,0,0,0,1,0,1
projections laughlin,0,0,0,1,0,0,0,1
projections lead,0,0,0,0,0,1,0,1
projects abroad,0,1,0,0,0,0,0,1
projects amtrak,1,0,0,0,0,0,0,1
projects christopher,0,0,0,0,0,1,0,1
projects department,0,0,0,0,1,0,0,1
projects exist,0,0,0,1,0,0,0,1
projects feature,0,0,0,0,1,0,0,1
projects global,0,0,0,1,0,0,0,1
projects include,0,0,0,1,0,0,0,1
projects paula,0,0,0,0,0,1,0,1
projects permitted,0,0,0,0,1,0,0,1
projects ruin,0,0,0,0,1,0,0,1
projects san,0,0,0,0,0,1,0,1
projects similar,0,0,0,0,0,1,0,1
projects supercell,0,0,0,0,0,1,0,1
projects tied,1,0,0,0,0,0,0,1
projects yeah,0,0,0,1,0,0,0,1
projects.but oil,0,0,0,1,0,0,0,1
proliferate including,0,1,0,0,0,0,0,1
prolific items,1,0,0,0,0,0,0,1
pröller shouts,0,0,1,0,0,0,0,1
prolonged period,0,0,0,0,1,0,0,1
prominent herald,0,0,1,0,0,0,0,1
prominent hyper,0,0,0,1,0,0,0,1
prominent political,0,0,0,0,0,1,0,1
promises german,0,0,1,0,0,0,0,1
promises global,0,0,0,0,0,1,0,1
promises representatives,0,1,0,0,0,0,0,1
promises tax,0,0,0,0,0,1,0,1
promising advance,0,0,0,0,0,1,0,1
promising climate,0,0,0,0,1,0,0,1
promising life,1,0,0,0,0,0,0,1
promising progress,1,0,0,0,0,0,0,1
promising start,0,0,0,1,0,0,0,1
promising yeah,0,0,0,0,1,0,0,1
promote buckeye,0,0,0,0,1,0,0,1
promote ecological,0,0,1,0,0,0,0,1
promote economic,0,1,0,0,0,0,0,1
promote environmental,0,1,0,0,0,0,0,1
promote renewables,0,0,0,0,1,0,0,1
promoter nic,0,0,0,0,0,1,0,1
promotes conservative,0,0,0,0,1,0,0,1
promotes economic,0,0,0,0,1,0,0,1
promotes energy,0,1,0,0,0,0,0,1
promotes environmentally,0,0,0,1,0,0,0,1
promotes innovation,0,1,0,0,0,0,0,1
promotes renewable,0,0,0,0,1,0,0,1
promoting commercial,0,1,0,0,0,0,0,1
promoting cooperation,0,0,0,0,0,1,0,1
promoting esg,0,0,1,0,0,0,0,1
prompt customer,0,0,1,0,0,0,0,1
prompted alarm,0,0,0,0,0,1,0,1
prompted assurances,0,0,0,0,0,1,0,1
prompting flood,0,0,0,1,0,0,0,1
promptly slid,0,1,0,0,0,0,0,1
prone russian,0,0,0,1,0,0,0,1
prone south,0,1,0,0,0,0,0,1
pronged approach,0,0,0,0,0,1,0,1
proof majority,0,1,0,0,0,0,0,1
properly address,0,0,0,0,0,1,0,1
property forcing,1,0,0,0,0,0,0,1
property owners,1,0,0,0,0,0,0,1
property resubmitted,0,0,0,0,1,0,0,1
property signs,0,0,0,0,1,0,0,1
prophecy mann,0,0,0,1,0,0,0,1
proposal inadequate,0,0,0,1,0,0,0,1
proposal stems,0,0,0,1,0,0,0,1
propose greenhouse,0,0,0,0,0,1,0,1
proposed building,0,0,0,0,1,0,0,1
proposed energy,0,1,0,0,0,0,0,1
proposed facility,0,0,0,1,0,0,0,1
proposed goals,0,0,1,0,0,0,0,1
proposed pausing,0,0,0,0,1,0,0,1
proposed regulating,0,0,0,1,0,0,0,1
proposed regulation,0,1,0,0,0,0,0,1
proposed regulations,0,0,0,0,1,0,0,1
proposed repealing,0,0,0,0,0,0,1,1
proposed rules,0,0,0,0,1,0,0,1
proposed solutions,0,0,0,0,1,0,0,1
proposed website,0,0,1,0,0,0,0,1
proposed willow,0,0,0,0,0,1,0,1
proposed wind,0,0,0,0,1,0,0,1
proprietary information,0,0,0,1,0,0,0,1
proprietor denies,0,0,1,0,0,0,0,1
prosecutor robert,0,0,0,1,0,0,0,1
protect biodiversity,1,0,0,0,0,0,0,1
protect local,0,1,0,0,0,0,0,1
protect polar,0,0,0,0,0,1,0,1
protect rainforests,0,0,0,0,0,0,1,1
protect today's,0,1,0,0,0,0,0,1
protect unesco's,0,1,0,0,0,0,0,1
protect wetlands,0,0,0,0,0,1,0,1
protected include,0,0,0,0,0,1,0,1
protected land,0,0,1,0,0,0,0,1
protected resources,0,0,0,0,1,0,0,1
protecting aquatic,0,0,0,0,0,1,0,1
protecting biodiversity,0,0,1,0,0,0,0,1
protecting future,0,0,0,1,0,0,0,1
protecting lives,0,1,0,0,0,0,0,1
protecting marine,0,0,0,0,1,0,0,1
protecting oceans,0,1,0,0,0,0,0,1
protection ministry,0,1,0,0,0,0,0,1
protection paradoxically,0,1,0,0,0,0,0,1
protection promises,0,0,1,0,0,0,0,1
protectionist act,0,0,0,0,0,1,0,1
protections lee,0,0,1,0,0,0,0,1
protections played,0,1,0,0,0,0,0,1
protections u.s,1,0,0,0,0,0,0,1
protective levels,0,0,0,1,0,0,0,1
protein fix,0,0,1,0,0,0,0,1
proteins carbohydrates,0,1,0,0,0,0,0,1
proteins climate,0,1,0,0,0,0,0,1
proteins fats,0,1,0,0,0,0,0,1
protest johnsen,0,0,1,0,0,0,0,1
protest mary,0,0,0,0,0,1,0,1
protest people,0,1,0,0,0,0,0,1
protest policy,0,0,0,0,0,1,0,1
protest.past global,0,1,0,0,0,0,0,1
protesters flocked,0,0,0,0,0,1,0,1
protesters killing,0,0,0,1,0,0,0,1
protesters sat,0,0,0,0,0,1,0,1
protests happened,0,0,0,0,0,1,0,1
protests similar,0,0,0,0,0,1,0,1
protim barua,0,0,0,0,0,1,0,1
prototypes obtained,0,0,1,0,0,0,0,1
proud nationalist,0,0,0,0,0,1,0,1
proudly promote,0,0,0,0,1,0,0,1
proven resilient,1,0,0,0,0,0,0,1
proverbial stopping,1,0,0,0,0,0,0,1
provide basic,0,0,0,1,0,0,0,1
provide checks,1,0,0,0,0,0,0,1
provide chilled,1,0,0,0,0,0,0,1
provide citizens,0,0,0,1,0,0,0,1
provide critical,0,0,1,0,0,0,0,1
provide crucial,0,0,0,0,0,1,0,1
provide culinary,0,1,0,0,0,0,0,1
provide developing,0,1,0,0,0,0,0,1
provide disaster,0,1,0,0,0,0,0,1
provide free,0,1,0,0,0,0,0,1
provide incentives,0,1,0,0,0,0,0,1
provide information,0,1,0,0,0,0,0,1
provide lifesaving,0,0,0,0,0,1,0,1
provide low,0,0,0,0,1,0,0,1
provide money,0,1,0,0,0,0,0,1
provide names,1,0,0,0,0,0,0,1
provide permanent,1,0,0,0,0,0,0,1
provide perspective,0,0,0,0,1,0,0,1
provide potable,0,0,0,0,0,1,0,1
provide pretty,0,0,0,1,0,0,0,1
provide public,0,0,0,0,1,0,0,1
provide redundancy,0,1,0,0,0,0,0,1
provide resilience,0,1,0,0,0,0,0,1
provide security,0,0,0,0,1,0,0,1
provide shelter,0,1,0,0,0,0,0,1
provide shuttle,0,0,0,0,0,1,0,1
provide subsidized,1,0,0,0,0,0,0,1
provide sustenance,0,0,0,0,0,1,0,1
provide temperatures,0,0,0,0,1,0,0,1
provide training,0,1,0,0,0,0,0,1
provide valuable,0,0,0,0,1,0,0,1
provide vast,0,1,0,0,0,0,0,1
provide vehicle,0,0,0,0,1,0,0,1
provided key,0,0,0,0,0,1,0,1
provided training,0,1,0,0,0,0,0,1
provider vicinity,1,0,0,0,0,0,0,1
providing benefits,0,0,0,0,0,1,0,1
providing communities,0,1,0,0,0,0,0,1
providing incentives,1,0,0,0,0,0,0,1
providing key,0,0,0,1,0,0,0,1
providing money,0,0,0,1,0,0,0,1
providing transportation,0,1,0,0,0,0,0,1
province glaciers,0,1,0,0,0,0,0,1
province monday,1,0,0,0,0,0,0,1
provinces officials,1,0,0,0,0,0,0,1
provinces saturday,1,0,0,0,0,0,0,1
provincial government,0,0,0,0,0,1,0,1
provincial governments,0,0,0,0,0,1,0,1
provincial governors,1,0,0,0,0,0,0,1
provincial health,1,0,0,0,0,0,0,1
proving complicated,0,1,0,0,0,0,0,1
provoke moscow,0,0,0,1,0,0,0,1
psychological consequences,1,0,0,0,0,0,0,1
psychology professor,0,0,0,1,0,0,0,1
psychotic episodes,0,0,0,0,1,0,0,1
pt people,0,0,0,0,1,0,0,1
public action,0,0,0,1,0,0,0,1
public actions,0,1,0,0,0,0,0,1
public acts,0,0,1,0,0,0,0,1
public agriculture,0,0,0,1,0,0,0,1
public appearances,1,0,0,0,0,0,0,1
public attention,0,0,0,0,0,0,1,1
public bears,0,0,1,0,0,0,0,1
public bidding,1,0,0,0,0,0,0,1
public broadcasting's,0,0,0,0,1,0,0,1
public charging,0,0,0,1,0,0,0,1
public comment,1,0,0,0,0,0,0,1
public confidence,0,0,0,1,0,0,0,1
public consciousness,0,0,0,0,0,1,0,1
public counsel,0,0,0,0,1,0,0,1
public discussion,0,0,0,1,0,0,0,1
public education,0,0,0,0,1,0,0,1
public environmental,0,0,1,0,0,0,0,1
public event,0,0,0,1,0,0,0,1
public eye,0,1,0,0,0,0,0,1
public finance,0,1,0,0,0,0,0,1
public fire,0,0,1,0,0,0,0,1
public funding,0,0,0,1,0,0,0,1
public funds,0,1,0,0,0,0,0,1
public governance,1,0,0,0,0,0,0,1
public hearing,0,0,0,0,1,0,0,1
public informed,0,0,0,0,1,0,0,1
public infrastructure,0,1,0,0,0,0,0,1
public land,0,0,0,0,0,1,0,1
public official,0,0,1,0,0,0,0,1
public outreach,0,0,0,0,1,0,0,1
public pension,0,0,1,0,0,0,0,1
public perception,0,0,1,0,0,0,0,1
public policy,0,0,0,0,0,1,0,1
public power,0,0,0,1,0,0,0,1
public pressure,0,0,0,0,1,0,0,1
public reports,0,0,0,1,0,0,0,1
public research,0,0,0,1,0,0,0,1
public sector,0,1,0,0,0,0,0,1
public sectors,0,0,0,0,0,1,0,1
public sentiment,0,0,1,0,0,0,0,1
public spaces,1,0,0,0,0,0,0,1
public stock,0,1,0,0,0,0,0,1
public utility,0,0,0,0,1,0,0,1
public water,0,1,0,0,0,0,0,1
public weather,0,1,0,0,0,0,0,1
public's activism,0,1,0,0,0,0,0,1
public's attention,0,1,0,0,0,0,0,1
public's calls,0,0,0,1,0,0,0,1
public's imagination,0,0,0,0,0,1,0,1
public's role,0,0,1,0,0,0,0,1
publication coincides,0,0,0,0,0,1,0,1
publication joshua,1,0,0,0,0,0,0,1
publicity stunt,0,0,1,0,0,0,0,1
publicly promote,0,0,1,0,0,0,0,1
publicly report,0,1,0,0,0,0,0,1
publicly stated,0,0,0,0,0,1,0,1
publicly traded,0,0,0,0,0,0,1,1
publish papers,0,0,0,0,0,1,0,1
publish progress,0,1,0,0,0,0,0,1
published earlier,0,0,0,1,0,0,0,1
publisher brian,0,0,1,0,0,0,0,1
puddle puddles,0,0,0,1,0,0,0,1
puddles lesley,0,0,0,1,0,0,0,1
puffy jacket,0,0,0,0,1,0,0,1
puffy lavender,0,0,0,1,0,0,0,1
pull black,0,0,0,0,0,1,0,1
pulley executive,0,0,0,0,1,0,0,1
pulmonary disease,0,0,0,1,0,0,0,1
pulsed light,0,0,0,1,0,0,0,1
pulses grains,0,1,0,0,0,0,0,1
pummeled california,0,0,0,1,0,0,0,1
pummeling california,0,0,0,0,0,1,0,1
pump installers,0,0,0,0,0,0,1,1
pump kircher,0,0,0,0,0,0,1,1
pump nutrients,0,1,0,0,0,0,0,1
pump owner,0,0,0,0,0,1,0,1
pump questions,0,0,0,0,0,0,1,1
pump removes,0,0,0,0,1,0,0,1
pump systems,0,0,0,0,0,0,1,1
pump water,0,1,0,0,0,0,0,1
pumped hydro,0,1,0,0,0,0,0,1
pumping money,1,0,0,0,0,0,0,1
pumping station,0,0,0,1,0,0,0,1
pumpkin eating,0,1,0,0,0,0,0,1
pumpkin puree,0,1,0,0,0,0,0,1
pumpkin soup,0,1,0,0,0,0,0,1
pumpkin spice,1,0,0,0,0,0,0,1
pumpkins gourds,0,1,0,0,0,0,0,1
pumpkins produce,0,1,0,0,0,0,0,1
pumps approximately,0,0,0,0,0,1,0,1
pumps bought,0,0,0,0,0,0,1,1
pumps heating,0,0,0,0,0,1,0,1
pumps kevin,0,0,0,0,0,1,0,1
pumps move,0,0,0,0,0,0,1,1
pumps nadel,0,0,0,0,0,0,1,1
pumps overtook,0,0,0,0,0,1,0,1
pumps shut,1,0,0,0,0,0,0,1
pumps sold,0,0,0,0,0,0,1,1
pumps virginia,1,0,0,0,0,0,0,1
punching bag,0,0,0,0,0,1,0,1
pundit noor,0,0,0,0,0,1,0,1
pungent odor,0,0,0,0,1,0,0,1
punished bp,0,0,0,0,1,0,0,1
punishing parade,0,0,0,1,0,0,0,1
punishing smog,0,1,0,0,0,0,0,1
punk metal,0,1,0,0,0,0,0,1
purchase generators,0,0,0,0,1,0,0,1
purchase price,1,0,0,0,0,0,0,1
pure electric,0,0,0,0,1,0,0,1
purify brackish,0,0,0,0,0,1,0,1
purple circle,0,0,0,1,0,0,0,1
purposes creating,0,1,0,0,0,0,0,1
pursuing deals,0,0,0,0,1,0,0,1
pursuits considers,0,1,0,0,0,0,0,1
push called,0,1,0,0,0,0,0,1
push citizens,0,0,0,0,0,1,0,1
push eastward,0,1,0,0,0,0,0,1
push leaves,1,0,0,0,0,0,0,1
push northwards,0,0,0,0,0,0,1,1
push notification,0,0,0,0,0,1,0,1
push ongoing,0,1,0,0,0,0,0,1
push politicians,0,0,0,1,0,0,0,1
push reforms,1,0,0,0,0,0,0,1
pushback frequently,0,0,0,0,1,0,0,1
pushed denver,0,1,0,0,0,0,0,1
pushed issues,0,0,0,0,1,0,0,1
pushed temperatures,0,0,0,0,1,0,0,1
pushes cool,0,0,1,0,0,0,0,1
pushing eventually,0,0,0,0,0,0,1,1
pushing hard,0,0,0,1,0,0,0,1
pushing past,0,0,0,1,0,0,0,1
pushing prices,1,0,0,0,0,0,0,1
puskar ap,0,0,0,1,0,0,0,1
puskar gene,0,0,0,1,0,0,0,1
putra adhiguna,0,0,0,0,1,0,0,1
puttered past,1,0,0,0,0,0,0,1
putting city,0,1,0,0,0,0,0,1
putting climate,0,0,0,0,0,0,1,1
putting decision,0,0,0,0,1,0,0,1
putting greenhouse,0,0,1,0,0,0,0,1
putting loss,0,1,0,0,0,0,0,1
putting money,0,0,1,0,0,0,0,1
putting people's,0,0,1,0,0,0,0,1
putting plastic,0,0,1,0,0,0,0,1
putting pressure,0,0,0,0,0,1,0,1
pyrenees argentina's,0,1,0,0,0,0,0,1
pyrra technologies,0,0,0,0,0,1,0,1
qadri ap,0,0,0,0,0,1,0,1
qaida courier,0,0,0,0,1,0,0,1
qaim charity,1,0,0,0,0,0,0,1
qataliña schaeffer,0,0,1,0,0,0,0,1
qatar note,0,0,0,1,0,0,0,1
qing wearing,0,0,0,1,0,0,0,1
quadruple wind,0,1,0,0,0,0,0,1
quality control,0,0,0,1,0,0,0,1
quality financing,1,0,0,0,0,0,0,1
quality globally,0,0,0,0,0,1,0,1
quality logs,1,0,0,0,0,0,0,1
quality material,1,0,0,0,0,0,0,1
quality medium,0,0,1,0,0,0,0,1
quality products,1,0,0,0,0,0,0,1
quality projects,0,1,0,0,0,0,0,1
quality thickness,0,0,1,0,0,0,0,1
quality underground,0,0,0,0,1,0,0,1
quality water,0,1,0,0,0,0,0,1
quantifiable verifiable,0,1,0,0,0,0,0,1
quantitative ecologist,0,0,1,0,0,0,0,1
quarter focus,0,0,0,0,0,0,1,1
quarter million,0,0,0,0,1,0,0,1
quarterly earnings,0,0,0,1,0,0,0,1
quarters makes,0,1,0,0,0,0,0,1
quasi extinct,1,0,0,0,0,0,0,1
quaternary science,1,0,0,0,0,0,0,1
quebec michael,0,1,0,0,0,0,0,1
queen bees,0,0,0,1,0,0,0,1
queen intersectional,1,0,0,0,0,0,0,1
queensland authorities,0,1,0,0,0,0,0,1
queer people,1,0,0,0,0,0,0,1
queer person,0,1,0,0,0,0,0,1
question email,0,0,0,1,0,0,0,1
question grass,0,0,0,1,0,0,0,1
question looms,0,1,0,0,0,0,0,1
question people,0,1,0,0,0,0,0,1
questionable carbon,0,1,0,0,0,0,0,1
questionable coverage,0,0,1,0,0,0,0,1
questions esg,0,0,1,0,0,0,0,1
questions including,0,0,0,0,1,0,0,1
questions johnson,0,0,0,0,1,0,0,1
questions people,0,1,0,0,0,0,0,1
quick emptying,0,0,0,1,0,0,0,1
quick hitting,0,0,0,0,1,0,0,1
quick payoff,0,0,0,1,0,0,0,1
quicker sultan,0,0,0,0,0,1,0,1
quickly adopting,0,0,0,0,0,1,0,1
quickly begin,0,0,0,1,0,0,0,1
quickly broke,0,0,0,0,0,1,0,1
quickly called,0,0,0,1,0,0,0,1
quickly climb,1,0,0,0,0,0,0,1
quickly dismantled,1,0,0,0,0,0,0,1
quickly established,1,0,0,0,0,0,0,1
quickly expel,0,1,0,0,0,0,0,1
quickly ice,0,1,0,0,0,0,0,1
quickly identify,0,1,0,0,0,0,0,1
quickly pivot,0,0,0,0,0,1,0,1
quickly provide,0,1,0,0,0,0,0,1
quickly realized,0,1,0,0,0,0,0,1
quickly replied,0,1,0,0,0,0,0,1
quickly rich,0,1,0,0,0,0,0,1
quickly thick,1,0,0,0,0,0,0,1
quickly timmermans,0,1,0,0,0,0,0,1
quiet beauty,0,0,0,1,0,0,0,1
quietly lightning,0,0,0,0,1,0,0,1
quietly sought,0,0,1,0,0,0,0,1
quietly warned,0,1,0,0,0,0,0,1
quit matrix,0,0,1,0,0,0,0,1
quote brutal,0,0,0,1,0,0,0,1
quote collective,0,1,0,0,0,0,0,1
quote global,0,1,0,0,0,0,0,1
quote natural,0,0,0,0,1,0,0,1
quote unquote,0,0,1,0,0,0,0,1
quote war,0,1,0,0,0,0,0,1
quoted al,0,0,0,1,0,0,0,1
qureshi afp,0,1,0,0,0,0,0,1
race ethnicity,0,0,0,0,1,0,0,1
raced sunday,0,0,0,0,0,0,1,1
rachel milam,0,0,0,0,0,0,1,1
rachel pearl,0,0,0,0,1,0,0,1
rachel treisman,0,1,0,0,0,0,0,1
rachmat kaimuddin,0,0,0,0,1,0,0,1
racial justice,0,0,0,0,1,0,0,1
racist claim,1,0,0,0,0,0,0,1
racketeering lawsuit,0,0,0,1,0,0,0,1
radar computers,0,1,0,0,0,0,0,1
radar foote's,0,0,0,0,0,1,0,1
radar upgrades,0,1,0,0,0,0,0,1
radhika fox,0,0,0,1,0,0,0,1
radiating outward,1,0,0,0,0,0,0,1
radiative forcing,1,0,0,0,0,0,0,1
radical environmentalist,0,0,1,0,0,0,0,1
radical expectations,0,1,0,0,0,0,0,1
radical position,0,0,0,0,1,0,0,1
radically reinvent,0,0,0,0,1,0,0,1
radio brian,0,0,0,1,0,0,0,1
radio hide,0,0,0,1,0,0,0,1
radio reporter,0,0,0,0,1,0,0,1
radio reports,1,0,0,0,0,0,0,1
radio version,0,1,0,0,0,0,0,1
radio's lucy,0,0,0,0,1,0,0,1
radio's mara,0,0,0,1,0,0,0,1
radio's rachel,0,0,0,0,1,0,0,1
radio's sam,0,1,0,0,0,0,0,1
raedle getty,0,0,0,0,0,1,0,1
rafts operated,0,1,0,0,0,0,0,1
raging pyrotechnics,0,0,1,0,0,0,0,1
raging waters,0,1,0,0,0,0,0,1
rai pope,0,1,0,0,0,0,0,1
railing children,1,0,0,0,0,0,0,1
railroad commission,0,0,0,0,1,0,0,1
rain causing,0,0,0,1,0,0,0,1
rain coming,0,0,0,0,0,1,0,1
rain dropped,0,0,0,0,1,0,0,1
rain drought,0,1,0,0,0,0,0,1
rain due,0,0,0,1,0,0,0,1
rain engorging,0,0,0,0,1,0,0,1
rain expected,0,0,0,0,0,1,0,1
rain fall,0,0,0,1,0,0,0,1
rain falling,0,1,0,0,0,0,0,1
rain fell,0,0,0,1,0,0,0,1
rain finally,0,0,0,0,0,1,0,1
rain flash,1,0,0,0,0,0,0,1
rain floodwaters,0,1,0,0,0,0,0,1
rain forecast,0,0,0,0,0,1,0,1
rain heads,0,0,0,1,0,0,0,1
rain melted,0,0,0,0,0,1,0,1
rain rates,0,0,0,0,1,0,0,1
rain sea,0,1,0,0,0,0,0,1
rain situation,0,0,0,0,0,1,0,1
rain started,0,0,0,0,0,0,1,1
rain taking,0,0,0,1,0,0,0,1
rain waters,0,0,0,1,0,0,0,1
rain wind,0,0,0,1,0,0,0,1
rain's coming,0,0,0,1,0,0,0,1
raindrops simply,1,0,0,0,0,0,0,1
rainfall california,0,0,0,1,0,0,0,1
rainfall countries,1,0,0,0,0,0,0,1
rainfall due,1,0,0,0,0,0,0,1
rainfall dumped,1,0,0,0,0,0,0,1
rainfall increased,1,0,0,0,0,0,0,1
rainfall info,0,0,0,1,0,0,0,1
rainfall intensity,1,0,0,0,0,0,0,1
rainfall kenneth,0,0,0,1,0,0,0,1
rainfall means,0,1,0,0,0,0,0,1
rainfall overwhelmed,1,0,0,0,0,0,0,1
rainfall patterns,1,0,0,0,0,0,0,1
rainfall record,1,0,0,0,0,0,0,1
rainforest action,0,0,0,0,0,0,1,1
rainforest spanning,0,0,0,0,0,0,1,1
rainforest trees,0,1,0,0,0,0,0,1
rains arrive,0,0,0,0,0,1,0,1
rains doshi,0,1,0,0,0,0,0,1
rains drowned,0,0,0,0,0,1,0,1
rains falter,1,0,0,0,0,0,0,1
rains hit,0,0,0,1,0,0,0,1
rains justin,0,0,0,1,0,0,0,1
rains moving,0,0,0,1,0,0,0,1
rains pummeled,0,0,0,1,0,0,0,1
rains set,1,0,0,0,0,0,0,1
rains subsided,1,0,0,0,0,0,0,1
rains trees,0,0,0,0,0,0,1,1
rainstorms pummeling,0,0,0,0,0,1,0,1
rainwater exceeded,0,0,0,1,0,0,0,1
rainwater harvesting,0,0,0,0,0,1,0,1
rainwater mabbutt's,0,1,0,0,0,0,0,1
raise alarm,0,0,0,0,1,0,0,1
raise animals,0,0,0,0,0,1,0,1
raise cattle,0,0,0,0,1,0,0,1
raise chickens,0,1,0,0,0,0,0,1
raise chicks,1,0,0,0,0,0,0,1
raise energy,0,1,0,0,0,0,0,1
raise livestock,0,1,0,0,0,0,0,1
raise rates,0,0,0,0,0,1,0,1
raised chris,0,1,0,0,0,0,0,1
raised energy,0,1,0,0,0,0,0,1
raised eyebrows,0,1,0,0,0,0,0,1
raised houses,0,0,0,0,0,1,0,1
raised millions,0,0,0,1,0,0,0,1
raised oysters,0,0,0,0,0,0,1,1
raised repeatedly,0,1,0,0,0,0,0,1
raised significantly,0,1,0,0,0,0,0,1
raises issues,0,0,1,0,0,0,0,1
raises questions,1,0,0,0,0,0,0,1
raises water,0,0,0,0,1,0,0,1
raising ambition,0,1,0,0,0,0,0,1
raising cattle,0,0,0,0,1,0,0,1
raising event,0,0,0,0,1,0,0,1
raising livestock,0,1,0,0,0,0,0,1
raising money,0,1,0,0,0,0,0,1
raising prices,0,0,0,0,0,1,0,1
raising public,0,0,0,0,0,0,1,1
raising questions,0,0,0,0,1,0,0,1
raising sea,0,1,0,0,0,0,0,1
raj panjabi,0,0,0,0,1,0,0,1
raking leaves,0,0,1,0,0,0,0,1
raleigh county,1,0,0,0,0,0,0,1
rally american,0,1,0,0,0,0,0,1
ralston declined,0,0,0,0,1,0,0,1
ralston founded,0,0,0,0,1,0,0,1
ralston launched,0,0,0,0,1,0,0,1
ralston reportedly,0,0,0,0,1,0,0,1
ralston served,0,0,0,0,1,0,0,1
ralston spoke,0,0,0,0,1,0,0,1
ralston started,0,0,0,0,1,0,0,1
ralston tapped,0,0,0,0,1,0,0,1
ralston's advice,0,0,0,0,1,0,0,1
ralston's consulting,0,0,0,0,1,0,0,1
ralston's firm,0,0,0,0,1,0,0,1
ralston's growing,0,0,0,0,1,0,0,1
ralston's message,0,0,0,0,1,0,0,1
ralston's website,0,0,0,0,1,0,0,1
ramos leads,0,0,0,0,1,0,0,1
rampant deforestation,0,1,0,0,0,0,0,1
ramsden senior,1,0,0,0,0,0,0,1
ran headlong,1,0,0,0,0,0,0,1
ran hundreds,0,0,0,0,0,1,0,1
ran segments,0,0,0,1,0,0,0,1
ranch house,0,0,0,0,1,0,0,1
rancher john,0,0,0,0,1,0,0,1
ranching business,0,0,0,0,1,0,0,1
ranching community,0,0,0,0,0,0,1,1
ranching methods,0,0,1,0,0,0,0,1
rancid smell,0,0,0,1,0,0,0,1
randall director,0,0,0,0,1,0,0,1
randy chamness,0,1,0,0,0,0,0,1
randy parkinson,1,0,0,0,0,0,0,1
randy sullivan,0,0,0,0,1,0,0,1
rane network,0,0,0,1,0,0,0,1
raney produced,0,1,0,0,0,0,0,1
range america,0,0,0,0,0,1,0,1
range anxiety,0,0,0,0,1,0,0,1
range hood,0,0,0,1,0,0,0,1
range influence,1,0,0,0,0,0,0,1
range makers,0,0,0,0,1,0,0,1
range simi,0,0,1,0,0,0,0,1
range victor,0,0,0,0,0,1,0,1
ranges aham,0,0,0,0,1,0,0,1
ranges snow,0,0,0,1,0,0,0,1
ranked tv,0,0,1,0,0,0,0,1
rapid change,0,0,0,0,1,0,0,1
rapid decarbonization,0,0,0,1,0,0,0,1
rapid increase,0,0,0,0,0,1,0,1
rapid migrations,0,1,0,0,0,0,0,1
rapid reduction,0,1,0,0,0,0,0,1
rapid rises,0,0,0,1,0,0,0,1
rapid transition,0,0,0,0,1,0,0,1
rapidly accelerating,0,0,0,1,0,0,0,1
rapidly beneath,1,0,0,0,0,0,0,1
rapidly closing,0,0,0,0,0,1,0,1
rapidly destabilize,0,1,0,0,0,0,0,1
rapidly developing,0,1,0,0,0,0,0,1
rapidly drying,0,1,0,0,0,0,0,1
rapidly expanding,0,0,0,0,0,1,0,1
rapidly intensify,0,1,0,0,0,0,0,1
rapidly millions,0,1,0,0,0,0,0,1
rapidly phase,0,0,0,1,0,0,0,1
rapidly plan,0,0,1,0,0,0,0,1
rapidly result,0,1,0,0,0,0,0,1
rapidly shifting,0,1,0,0,0,0,0,1
rapidly swelled,1,0,0,0,0,0,0,1
rapids contributed,1,0,0,0,0,0,0,1
rapper named,0,1,0,0,0,0,0,1
rare blizzard,0,0,0,0,1,0,0,1
rare boat,0,1,0,0,0,0,0,1
rare documents,0,1,0,0,0,0,0,1
rare jon,0,1,0,0,0,0,0,1
rare languages,0,0,0,1,0,0,0,1
rare tornadoes,0,0,0,0,0,1,0,1
rare yeah,0,0,0,1,0,0,0,1
rarely abandon,1,0,0,0,0,0,0,1
rarely discussed,0,0,0,0,1,0,0,1
rat poison,0,0,1,0,0,0,0,1
rate fell,0,0,0,0,0,1,0,1
rate hike.martí,0,0,0,0,0,1,0,1
rate setting,0,0,0,0,0,1,0,1
rate varies,0,0,0,0,0,1,0,1
rated highly,0,1,0,0,0,0,0,1
rates due,0,1,0,0,0,0,0,1
rates jumped,0,0,0,0,0,1,0,1
rates mortgage,0,0,0,0,0,1,0,1
rates sorensen,0,1,0,0,0,0,0,1
ravaged wildlife,0,1,0,0,0,0,0,1
ravenna koenig,0,0,0,0,0,0,1,1
raw meat,0,1,0,0,0,0,0,1
ray ap,1,0,0,0,0,0,0,1
ray gaesser,0,0,0,0,1,0,0,1
ray tells,0,0,1,0,0,0,0,1
razed streets,0,0,0,0,1,0,0,1
reach california,0,0,0,1,0,0,0,1
reach consensus,0,1,0,0,0,0,0,1
reach cooking,0,0,0,0,1,0,0,1
reach countries,0,1,0,0,0,0,0,1
reach nearby,1,0,0,0,0,0,0,1
reach record,0,1,0,0,0,0,0,1
reached rolling,0,0,0,0,0,1,0,1
reaches developing,0,0,0,0,0,1,0,1
reaching climate,0,0,0,0,0,1,0,1
reaching consumers,0,0,0,0,1,0,0,1
reaching effects,1,0,0,0,0,0,0,1
reaching net,0,1,0,0,0,0,0,1
reaching storm,0,1,0,0,0,0,0,1
reaching tipping,0,0,1,0,0,0,0,1
react quickly,0,1,0,0,0,0,0,1
read democrats,0,0,1,0,0,0,0,1
read peer,0,0,0,0,0,0,1,1
reader donations,0,0,1,0,0,0,0,1
reading policy,0,0,1,0,0,0,0,1
ready a.martí,0,0,0,0,0,1,0,1
ready hagekhalil,0,0,0,1,0,0,0,1
ready hanak,0,0,0,0,0,1,0,1
ready homeland,0,1,0,0,0,0,0,1
ready set,1,0,0,0,0,0,0,1
real challenges,0,0,0,1,0,0,0,1
real change,0,1,0,0,0,0,0,1
real concern,0,0,0,0,0,0,1,1
real costs,0,0,0,0,0,1,0,1
real honesty,0,0,0,0,1,0,0,1
real investment,0,1,0,0,0,0,0,1
real issue,0,1,0,0,0,0,0,1
real meat,0,1,0,0,0,0,0,1
real moral,0,0,0,0,0,0,1,1
real parallels,0,1,0,0,0,0,0,1
real possibility,0,0,0,1,0,0,0,1
real promises,0,1,0,0,0,0,0,1
real results,0,0,0,0,1,0,0,1
real sense,0,0,1,0,0,0,0,1
real shift,0,0,0,1,0,0,0,1
real solution,1,0,0,0,0,0,0,1
real story,0,0,1,0,0,0,0,1
real valeti,0,1,0,0,0,0,0,1
real word,0,1,0,0,0,0,0,1
realistic emissions,0,0,0,1,0,0,0,1
reality affecting,0,1,0,0,0,0,0,1
reality check,0,0,0,0,1,0,0,1
reality citizens,0,0,0,0,1,0,0,1
reality setting,0,0,0,1,0,0,0,1
realized california's,0,1,0,0,0,0,0,1
realized scientists,0,1,0,0,0,0,0,1
realm.martí karnauskas,0,0,1,0,0,0,0,1
rearing offspring,0,0,1,0,0,0,0,1
rearview mirror,0,0,0,0,1,0,0,1
reason averbeck,0,0,0,0,0,0,1,1
reason scientists,0,0,0,1,0,0,0,1
reason survival,0,0,0,0,1,0,0,1
reasonable expenses,0,0,1,0,0,0,0,1
reasonable rates,0,1,0,0,0,0,0,1
reasons bases,0,1,0,0,0,0,0,1
reasons communities,0,0,0,0,1,0,0,1
reasons nicole,0,1,0,0,0,0,0,1
reasons school,0,0,0,0,1,0,0,1
rebecca shaw,0,0,1,0,0,0,0,1
rebecca's yeah,1,0,0,0,0,0,0,1
rebuild communities,1,0,0,0,0,0,0,1
rebuild stronger,1,0,0,0,0,0,0,1
rebuilding coastal,0,0,0,0,1,0,0,1
rebuilding federal,0,0,0,0,1,0,0,1
rebuilding key,0,1,0,0,0,0,0,1
rebuilding raised,0,0,0,0,0,1,0,1
rebuilt scott,1,0,0,0,0,0,0,1
recalled neighbors,0,1,0,0,0,0,0,1
recalls roy,0,0,0,0,1,0,0,1
recalls upside,0,1,0,0,0,0,0,1
receding lake,0,0,0,0,1,0,0,1
receding shore,0,0,0,0,1,0,0,1
receive water,0,0,0,1,0,0,0,1
received akter's,0,0,0,0,0,1,0,1
received biographical,0,1,0,0,0,0,0,1
received electric,0,0,0,0,1,0,0,1
received intense,0,0,1,0,0,0,0,1
received major,0,1,0,0,0,0,0,1
received rainfall,0,0,0,1,0,0,0,1
received redesign,0,0,0,0,1,0,0,1
received ryan,0,0,0,0,1,0,0,1
recent afternoon,0,0,0,0,1,0,0,1
recent arrivals,0,1,0,0,0,0,0,1
recent bipartisan,0,0,0,1,0,0,0,1
recent climate,0,0,1,0,0,0,0,1
recent cloudy,0,0,0,0,1,0,0,1
recent dead,0,0,0,0,0,1,0,1
recent droughts,0,0,1,0,0,0,0,1
recent dry,0,0,0,0,0,1,0,1
recent efforts,0,1,0,0,0,0,0,1
recent events,0,0,0,1,0,0,0,1
recent executive,0,1,0,0,0,0,0,1
recent federal,0,0,1,0,0,0,0,1
recent floods,1,0,0,0,0,0,0,1
recent forecasts,0,1,0,0,0,0,0,1
recent greenpeace,0,0,1,0,0,0,0,1
recent investment,0,0,0,0,0,1,0,1
recent marches,0,0,0,0,0,1,0,1
recent morning,1,0,0,0,0,0,0,1
recent news,0,0,0,0,1,0,0,1
recent outbreak,0,0,0,0,1,0,0,1
recent peer,0,0,0,0,1,0,0,1
recent pledge,0,0,0,0,1,0,0,1
recent public,0,0,0,1,0,0,0,1
recent rainfall,0,0,0,1,0,0,0,1
recent report,1,0,0,0,0,0,0,1
recent scandals,0,0,1,0,0,0,0,1
recent scientific,0,0,0,0,1,0,0,1
recent snow,0,0,0,0,1,0,0,1
recent stop,1,0,0,0,0,0,0,1
recent surge,0,0,0,0,0,0,1,1
recent tally,0,0,0,0,0,0,1,1
recent tornadoes,0,0,0,0,0,0,1,1
recent u.n,0,1,0,0,0,0,0,1
recent united,0,0,1,0,0,0,0,1
recent uptick,0,0,0,1,0,0,0,1
recent wildfires,0,0,0,1,0,0,0,1
recently announced,0,0,0,0,1,0,0,1
recently awarded,1,0,0,0,0,0,0,1
recently burned,0,0,0,1,0,0,0,1
recently called,0,1,0,0,0,0,0,1
recently crandall,0,1,0,0,0,0,0,1
recently criticized,1,0,0,0,0,0,0,1
recently declared,0,0,0,0,0,1,0,1
recently dipped,0,1,0,0,0,0,0,1
recently due,0,1,0,0,0,0,0,1
recently implemented,0,0,0,0,1,0,0,1
recently including,0,1,0,0,0,0,0,1
recently joined,0,0,1,0,0,0,0,1
recently lifted,0,0,0,0,0,1,0,1
recently maine's,1,0,0,0,0,0,0,1
recently moved,0,0,0,1,0,0,0,1
recently passed,0,0,1,0,0,0,0,1
recently reaffirmed,0,0,0,0,1,0,0,1
recently recorded,0,0,0,1,0,0,0,1
recently reduced,0,0,1,0,0,0,0,1
recently refused,0,1,0,0,0,0,0,1
recently reported,0,0,0,0,0,1,0,1
recently returned,0,1,0,0,0,0,0,1
recently scrapped,0,1,0,0,0,0,0,1
recently shot,1,0,0,0,0,0,0,1
recently sign,0,1,0,0,0,0,0,1
recently signed,0,0,0,0,0,1,0,1
recently swept,0,0,0,1,0,0,0,1
recently touched,0,0,0,0,0,1,0,1
recently ukraine's,0,0,0,1,0,0,0,1
recently volunteers,1,0,0,0,0,0,0,1
recently warned,0,0,1,0,0,0,0,1
recess canceled,0,1,0,0,0,0,0,1
recess slack,0,0,0,1,0,0,0,1
recession capital,1,0,0,0,0,0,0,1
recession scott's,1,0,0,0,0,0,0,1
recharge water,1,0,0,0,0,0,0,1
recipe development,0,1,0,0,0,0,0,1
recipients equals,0,0,0,0,0,0,1,1
reclamation act,1,0,0,0,0,0,0,1
recognize community,0,1,0,0,0,0,0,1
recognize eventually,0,0,0,0,1,0,0,1
recommendation lawmakers,0,0,0,0,1,0,0,1
recommended daily,0,1,0,0,0,0,0,1
recommended shifting,0,1,0,0,0,0,0,1
recommended vitamin,0,1,0,0,0,0,0,1
recommends reducing,0,0,0,0,1,0,0,1
recommends urgent,0,0,1,0,0,0,0,1
reconstruction funding,0,1,0,0,0,0,0,1
reconstruction funds,0,1,0,0,0,0,0,1
record acceleration,1,0,0,0,0,0,0,1
record keeping,0,1,0,0,0,0,0,1
record lowest,0,0,0,0,1,0,0,1
record overwhelming,0,0,0,1,0,0,0,1
record rainfall,0,0,0,0,0,1,0,1
record set,0,1,0,0,0,0,0,1
record setting,0,0,0,0,1,0,0,1
record snowpack,0,0,0,0,1,0,0,1
recorded mississippi,0,0,0,0,0,1,0,1
recorded music,0,1,0,0,0,0,0,1
recorded npr's,0,0,0,1,0,0,0,1
recorded temperatures,0,0,0,1,0,0,0,1
recorded tornadoes,0,0,0,0,0,1,0,1
recording accessible,0,0,0,0,0,1,0,1
records curated,0,1,0,0,0,0,0,1
records found,0,0,0,1,0,0,0,1
records matrix,0,0,1,0,0,0,0,1
records requests,0,0,1,0,0,0,0,1
records water,0,0,0,0,0,1,0,1
recounted episodes,0,0,1,0,0,0,0,1
recover abbott,0,1,0,0,0,0,0,1
recovered instruments,0,1,0,0,0,0,0,1
recovering renner,0,0,0,1,0,0,0,1
recovery gov,0,0,0,0,0,0,1,1
recovery plan,1,0,0,0,0,0,0,1
recovery related,0,1,0,0,0,0,0,1
recovery team,0,0,0,1,0,0,0,1
recovery tennessee,0,0,0,0,0,0,1,1
recreation ecotourism,1,0,0,0,0,0,0,1
recruit fresh,0,0,1,0,0,0,0,1
recurrent droughts,1,0,0,0,0,0,0,1
recycle plastic,0,0,0,1,0,0,0,1
recycle pumpkins,0,1,0,0,0,0,0,1
recycled oyster,1,0,0,0,0,0,0,1
recycling accounts,0,0,0,0,0,0,1,1
recycling bin,1,0,0,0,0,0,0,1
recycling center,0,0,0,0,1,0,0,1
recycling containers,1,0,0,0,0,0,0,1
recycling due,0,0,0,0,0,0,1,1
recycling facilities,1,0,0,0,0,0,0,1
recycling feels,0,0,1,0,0,0,0,1
recycling infrastructure,0,0,0,1,0,0,0,1
recycling plastic,1,0,0,0,0,0,0,1
recycling rates,1,0,0,0,0,0,0,1
recycling water,0,0,0,0,0,1,0,1
red break,0,0,0,0,1,0,0,1
red dirt,0,1,0,0,0,0,0,1
red flags,0,0,0,0,1,0,0,1
red lines,0,1,0,0,0,0,0,1
red list,1,0,0,0,0,0,0,1
red mine,1,0,0,0,0,0,0,1
red string,0,0,0,1,0,0,0,1
red tape,0,0,0,0,0,1,0,1
red tide,0,0,0,1,0,0,0,1
redesign sample,0,0,0,0,1,0,0,1
redlined neighborhoods,0,0,0,1,0,0,0,1
reduce air,0,0,0,0,0,1,0,1
reduce carbon,0,0,0,1,0,0,0,1
reduce climate,0,0,0,0,0,0,1,1
reduce costs,1,0,0,0,0,0,0,1
reduce demand,0,0,0,1,0,0,0,1
reduce food,0,1,0,0,0,0,0,1
reduce local,0,0,0,0,0,0,1,1
reduce pollution,0,0,0,0,1,0,0,1
reduce risk,0,1,0,0,0,0,0,1
reduce single,0,0,0,1,0,0,0,1
reduce traffic,0,0,0,0,0,1,0,1
reduce warming,1,0,0,0,0,0,0,1
reduced capacity,0,1,0,0,0,0,0,1
reduced computing,0,0,0,0,0,1,0,1
reduced critical,0,1,0,0,0,0,0,1
reduced due,0,0,1,0,0,0,0,1
reduced flood,1,0,0,0,0,0,0,1
reduced precipitation,0,0,0,0,0,0,1,1
reduced tillage,0,1,0,0,0,0,0,1
reduces leaks,0,0,0,0,0,0,1,1
reduces rainfall,0,0,0,0,0,0,1,1
reduces wildlife,0,0,1,0,0,0,0,1
reducing climate,0,0,0,0,1,0,0,1
reducing coffee,0,0,0,1,0,0,0,1
reducing deforestation,1,0,0,0,0,0,0,1
reducing exposure,0,0,0,0,1,0,0,1
reducing financial,0,1,0,0,0,0,0,1
reducing gas,0,0,0,0,0,0,1,1
reducing global,0,0,0,0,0,1,0,1
reducing greenhouse,0,0,0,0,0,1,0,1
reducing meat,0,0,0,0,0,1,0,1
reducing methane,0,0,0,1,0,0,0,1
reducing oil,0,0,0,0,1,0,0,1
reducing reliance,0,0,0,0,0,1,0,1
reduction programs,0,0,0,0,1,0,0,1
reduction scenario,0,0,0,1,0,0,0,1
reduction targets,0,1,0,0,0,0,0,1
reductions required,1,0,0,0,0,0,0,1
reductions scientists,1,0,0,0,0,0,0,1
reef accounts,0,1,0,0,0,0,0,1
reef coral,0,1,0,0,0,0,0,1
reef corals,0,1,0,0,0,0,0,1
reef ecosystems,0,1,0,0,0,0,0,1
reef enric,0,1,0,0,0,0,0,1
reef habitat,1,0,0,0,0,0,0,1
reef leading,0,1,0,0,0,0,0,1
reef marine,0,1,0,0,0,0,0,1
reef system,0,1,0,0,0,0,0,1
reef's status,0,1,0,0,0,0,0,1
reef's water,0,1,0,0,0,0,0,1
reefs birds,0,0,1,0,0,0,0,1
reefs coastal,0,0,0,0,0,0,1,1
reefs covers,0,1,0,0,0,0,0,1
reefs short,0,1,0,0,0,0,0,1
reefs thinking,0,1,0,0,0,0,0,1
reefs worldwide,0,1,0,0,0,0,0,1
reefs wwno's,1,0,0,0,0,0,0,1
refill barrels,0,0,0,0,0,1,0,1
refill ramsden,1,0,0,0,0,0,0,1
refill targets,0,0,0,1,0,0,0,1
refinery manager,0,0,0,0,1,0,0,1
refinery north,0,0,0,0,1,0,0,1
refinery situation,1,0,0,0,0,0,0,1
reflect lin's,0,1,0,0,0,0,0,1
reflection data,1,0,0,0,0,0,0,1
reforestation forester,0,0,0,0,0,1,0,1
reforestation green,0,1,0,0,0,0,0,1
reform subsidies,0,0,1,0,0,0,0,1
reforms yellen,1,0,0,0,0,0,0,1
refrigerant inside,0,0,0,0,0,0,1,1
refrigerant substitutes,0,0,0,0,0,0,1,1
refrigerants commonly,0,0,0,0,0,0,1,1
refrigerate medicines,0,0,0,1,0,0,0,1
refugee crises,0,1,0,0,0,0,0,1
refugees international,1,0,0,0,0,0,0,1
refuges pockets,0,1,0,0,0,0,0,1
refusal makes,0,0,0,0,1,0,0,1
refusing water,0,1,0,0,0,0,0,1
regan low,0,0,0,1,0,0,0,1
regenerative farm,0,1,0,0,0,0,0,1
regenerative farmland,0,1,0,0,0,0,0,1
regenerative land,0,0,0,0,1,0,0,1
regenerative practice,0,1,0,0,0,0,0,1
regime campaigners,0,1,0,0,0,0,0,1
region chad's,0,0,1,0,0,0,0,1
region crop,0,1,0,0,0,0,0,1
region forecasters,0,0,0,0,1,0,0,1
region joanne,0,0,0,1,0,0,0,1
region operated,0,0,0,0,1,0,0,1
region people,1,0,0,0,0,0,0,1
region repairing,0,1,0,0,0,0,0,1
region residents,0,0,0,0,0,1,0,1
region run,1,0,0,0,0,0,0,1
region walaa,0,0,0,0,1,0,0,1
region warming,0,0,0,1,0,0,0,1
region's agricultural,0,0,0,0,0,1,0,1
region's creeks,0,1,0,0,0,0,0,1
region's driest,0,0,0,1,0,0,0,1
region's fertile,0,0,0,0,0,1,0,1
region's fragility,1,0,0,0,0,0,0,1
region's history,0,1,0,0,0,0,0,1
region's parched,0,0,0,1,0,0,0,1
region's snow,0,0,0,0,1,0,0,1
region's storied,0,1,0,0,0,0,0,1
region's water,0,0,0,0,0,1,0,1
regional computer,0,0,0,0,0,1,0,1
regional conflicts,1,0,0,0,0,0,0,1
regional content,0,0,0,0,0,1,0,1
regional executive,0,0,1,0,0,0,0,1
regional fema,0,0,0,0,0,1,0,1
regional governments,0,1,0,0,0,0,0,1
regional leaders,0,0,0,0,1,0,0,1
regional migration,0,1,0,0,0,0,0,1
regional town,1,0,0,0,0,0,0,1
regions compared,0,0,0,0,0,1,0,1
regions franklin,0,1,0,0,0,0,0,1
regions reducing,0,0,0,0,0,1,0,1
regions skyrocketing,1,0,0,0,0,0,0,1
registered dietitian,0,1,0,0,0,0,0,1
regular air,0,0,0,0,0,1,0,1
regular contributor,0,0,0,0,0,1,0,1
regular folks,0,0,0,0,0,1,0,1
regular legislative,0,0,0,0,1,0,0,1
regular magnets,0,0,0,1,0,0,0,1
regular measurements,1,0,0,0,0,0,0,1
regular newsy,0,0,0,0,0,1,0,1
regular storms,0,0,0,0,0,1,0,1
regular weather,0,0,0,0,1,0,0,1
regularly attending,0,0,0,0,1,0,0,1
regulate airplane,0,0,1,0,0,0,0,1
regulate gas,0,0,0,0,1,0,0,1
regulate migration,0,1,0,0,0,0,0,1
regulate uncontrolled,0,0,0,0,1,0,0,1
regulating emissions,0,0,0,0,1,0,0,1
regulating global,0,0,0,0,0,0,1,1
regulation includes,0,0,0,0,1,0,0,1
regulation issues,0,0,0,1,0,0,0,1
regulations add,0,0,1,0,0,0,0,1
regulations dave,1,0,0,0,0,0,0,1
regulations failed,1,0,0,0,0,0,0,1
regulator documents,1,0,0,0,0,0,0,1
regulators collaborating,0,0,0,0,0,1,0,1
regulators grew,0,0,0,0,1,0,0,1
regulators lexington,1,0,0,0,0,0,0,1
regulators prepare,0,0,0,0,0,1,0,1
regulators signed,0,0,1,0,0,0,0,1
regulators views,0,0,0,0,1,0,0,1
regulatory actions,0,0,0,0,0,1,0,1
regulatory agency,0,0,0,0,1,0,0,1
regulatory certainty,0,1,0,0,0,0,0,1
regulatory demands,0,0,1,0,0,0,0,1
regulatory framework,0,1,0,0,0,0,0,1
rehabilitate ecosystems,0,0,0,0,0,1,0,1
rehabilitation center,0,0,1,0,0,0,0,1
rehman spoke,0,1,0,0,0,0,0,1
rehydration salts,1,0,0,0,0,0,0,1
reid acknowledges,0,1,0,0,0,0,0,1
reid outgoing,0,1,0,0,0,0,0,1
reimburse reasonable,0,0,1,0,0,0,0,1
reimburse residents,0,0,0,0,1,0,0,1
reinforced pillars,0,0,0,0,0,1,0,1
reinforcements including,1,0,0,0,0,0,0,1
rejected calls,0,1,0,0,0,0,0,1
rejected shareholder,0,0,0,0,0,1,0,1
rejected winterization,0,0,0,0,1,0,0,1
related content,0,0,1,0,0,0,0,1
related death,0,0,0,0,1,0,0,1
related incidents,0,0,0,1,0,0,0,1
related losses,0,1,0,0,0,0,0,1
related purchases,0,1,0,0,0,0,0,1
related targets,0,0,1,0,0,0,0,1
related topics,0,1,0,0,0,0,0,1
related vehicle,1,0,0,0,0,0,0,1
relations campaign,0,0,0,0,1,0,0,1
relations company,0,0,1,0,0,0,0,1
relations coordinator,0,1,0,0,0,0,0,1
relationship diplomatically,0,0,0,0,1,0,0,1
relationship financial,0,0,1,0,0,0,0,1
relative amount,0,0,0,1,0,0,0,1
relative humidity,0,0,0,0,1,0,0,1
relative's home,0,0,0,0,1,0,0,1
relatives processing,0,0,0,1,0,0,0,1
relatives tombs,1,0,0,0,0,0,0,1
release announced,1,0,0,0,0,0,0,1
release federal,0,0,0,0,0,1,0,1
release nathan,0,1,0,0,0,0,0,1
release production,0,0,0,0,0,1,0,1
release recent,0,1,0,0,0,0,0,1
release sacha,0,0,0,0,1,0,0,1
release verbatim,0,0,1,0,0,0,0,1
released ahead,0,1,0,0,0,0,0,1
released map,0,0,0,1,0,0,0,1
released monday,0,0,0,1,0,0,0,1
released rules,0,0,0,0,0,1,0,1
releases ammonia,0,0,0,0,0,1,0,1
releases carbon,0,0,0,0,0,0,1,1
releases enormous,0,0,0,0,0,1,0,1
releases huge,0,0,1,0,0,0,0,1
releasing planet,0,1,0,0,0,0,0,1
releasing recent,0,1,0,0,0,0,0,1
releasing water,0,0,0,0,0,1,0,1
relentless flooding,0,0,0,0,0,1,0,1
relentless news,0,0,0,0,0,1,0,1
relevant anymore,0,0,0,0,1,0,0,1
relevant situation,0,0,0,0,1,0,0,1
reliable broad,0,0,0,0,0,1,0,1
reliable corn,0,0,1,0,0,0,0,1
reliable deliveries,0,1,0,0,0,0,0,1
reliable drinking,0,0,0,0,0,1,0,1
reliable heating,1,0,0,0,0,0,0,1
reliable irrigation,1,0,0,0,0,0,0,1
reliable profits,0,1,0,0,0,0,0,1
reliable schedule,0,1,0,0,0,0,0,1
reliably avoid,0,0,0,0,1,0,0,1
relics knowing,0,1,0,0,0,0,0,1
relief programs,0,0,0,0,0,0,1,1
relies heavily,0,1,0,0,0,0,0,1
relieve feelings,1,0,0,0,0,0,0,1
relieve pressure,0,0,0,0,1,0,0,1
religious authorities,0,1,0,0,0,0,0,1
religious education,0,1,0,0,0,0,0,1
religious roles,0,1,0,0,0,0,0,1
relocated tribes,0,0,0,0,0,1,0,1
rely heavily,0,0,1,0,0,0,0,1
relying solely,0,0,0,0,1,0,0,1
remain buried,0,0,1,0,0,0,0,1
remain divided,0,1,0,0,0,0,0,1
remain focused,0,0,0,1,0,0,0,1
remain greenland,1,0,0,0,0,0,0,1
remain healthy,0,0,1,0,0,0,0,1
remain home,0,0,0,0,0,0,1,1
remain inconclusive,0,0,0,0,0,1,0,1
remain livable,0,1,0,0,0,0,0,1
remain missing,1,0,0,0,0,0,0,1
remain profitable,0,0,1,0,0,0,0,1
remain till,0,1,0,0,0,0,0,1
remain twenty,0,0,0,0,1,0,0,1
remain vigilant,1,0,0,0,0,0,0,1
remain vulnerable,0,0,0,0,1,0,0,1
remained closed,0,0,0,0,1,0,0,1
remained knocked,1,0,0,0,0,0,0,1
remained low,0,1,0,0,0,0,0,1
remained online,1,0,0,0,0,0,0,1
remained online.for,1,0,0,0,0,0,0,1
remained standing,0,1,0,0,0,0,0,1
remained stubbornly,0,1,0,0,0,0,0,1
remaining biodiversity,0,0,0,0,0,0,1,1
remaining children,0,0,1,0,0,0,0,1
remaining industrial,1,0,0,0,0,0,0,1
remaining oil,0,0,1,0,0,0,0,1
remaining rainforest,0,0,0,1,0,0,0,1
remaining saltwater,0,0,0,0,1,0,0,1
remaining tropical,0,0,0,0,0,0,1,1
remaining unidentified,0,0,0,0,1,0,0,1
remains difficult,0,0,0,1,0,0,0,1
remains hopeful,0,0,0,0,0,1,0,1
remains missing,0,0,0,1,0,0,0,1
remains pretty,0,0,0,1,0,0,0,1
remains steadfast,0,0,0,0,0,1,0,1
remains super,0,0,0,0,0,1,0,1
remains uncertain,0,1,0,0,0,0,0,1
remarkable storm,0,0,0,0,1,0,0,1
remarkable story,0,0,1,0,0,0,0,1
remember ailsa,0,0,0,0,1,0,0,1
remember flying,0,1,0,0,0,0,0,1
remember mary,0,0,1,0,0,0,0,1
remember owens,0,0,0,0,1,0,0,1
remember people,0,0,0,0,0,1,0,1
remember telling,0,1,0,0,0,0,0,1
remember walking,0,1,0,0,0,0,0,1
remembered anlleyn,1,0,0,0,0,0,0,1
remembers shrimping,1,0,0,0,0,0,0,1
remind people,0,0,0,1,0,0,0,1
reminding people,0,1,0,0,0,0,0,1
remiorz ap,0,0,1,0,0,0,0,1
remixed field,0,0,0,1,0,0,0,1
remote alaskan,0,0,0,1,0,0,0,1
remote highway,0,0,0,0,0,1,0,1
remote mountains,1,0,0,0,0,0,0,1
removal businesses,0,0,0,1,0,0,0,1
removal companies,0,0,0,1,0,0,0,1
removal detention,0,1,0,0,0,0,0,1
removal equipment,0,0,0,1,0,0,0,1
removal mining,0,1,0,0,0,0,0,1
removal program,0,0,0,0,1,0,0,1
remove homes,1,0,0,0,0,0,0,1
removes water,0,0,0,0,1,0,0,1
removing damaged,0,1,0,0,0,0,0,1
removing trees,0,0,0,0,0,0,1,1
rene mendez,0,0,0,1,0,0,0,1
renewable aspirations,0,0,0,0,1,0,0,1
renewable goal,0,0,0,1,0,0,0,1
renewable projects,0,0,0,0,1,0,0,1
renewable sector,0,0,0,0,1,0,0,1
renewables ching,0,0,0,0,1,0,0,1
renewables monschauer,0,0,0,0,0,0,1,1
renewables world,0,0,0,0,1,0,0,1
renewables yannick,0,0,0,0,0,1,0,1
renewables yeah,0,0,0,0,1,0,0,1
renewed attention,0,0,0,1,0,0,0,1
renewed efforts,0,0,0,0,0,0,1,1
renewed gurrola,0,0,0,1,0,0,0,1
renewed hope,0,0,0,1,0,0,0,1
renews questions,1,0,0,0,0,0,0,1
renner suffered,0,0,0,1,0,0,0,1
reno nevada,0,0,0,1,0,0,0,1
renovation benson,0,1,0,0,0,0,0,1
renowned oceanographer,1,0,0,0,0,0,0,1
rental car,0,0,0,0,1,0,0,1
rental cars,0,0,1,0,0,0,0,1
rented air,0,0,0,1,0,0,0,1
rented home's,0,1,0,0,0,0,0,1
rented sewing,0,0,1,0,0,0,0,1
renter's insurance,0,1,0,0,0,0,0,1
renters compared,0,0,0,1,0,0,0,1
renters majority,0,0,1,0,0,0,0,1
rep chris,0,0,0,0,1,0,0,1
rep donna,0,0,0,0,1,0,0,1
rep jim,0,0,0,1,0,0,0,1
rep jon,0,0,0,0,1,0,0,1
repair bridges,1,0,0,0,0,0,0,1
repair private,0,0,0,1,0,0,0,1
repaired light,0,1,0,0,0,0,0,1
repairing facilities,0,1,0,0,0,0,0,1
repairs finished,0,1,0,0,0,0,0,1
repeated cops,0,0,0,0,0,1,0,1
repeated flooding,0,0,0,0,1,0,0,1
repeated heat,0,1,0,0,0,0,0,1
repeated messages,0,0,0,0,1,0,0,1
repeatedly longtime,0,0,0,0,1,0,0,1
repeatedly practicing,0,0,0,1,0,0,0,1
repeating warnings,1,0,0,0,0,0,0,1
replace guest,1,0,0,0,0,0,0,1
replace natural,0,0,1,0,0,0,0,1
replace pipes,0,0,0,1,0,0,0,1
replace spoiled,0,0,0,0,1,0,0,1
replace wild,0,0,0,0,0,0,1,1
replaced nafta,0,0,0,0,0,1,0,1
replacing pipes,0,0,0,1,0,0,0,1
replacing water,0,0,0,0,0,1,0,1
replenish surrounding,0,1,0,0,0,0,0,1
replicating tornado,0,0,0,0,0,1,0,1
report antonio,0,0,0,0,0,0,1,1
report authors,0,0,0,0,0,1,0,1
report based,0,0,1,0,0,0,0,1
report bleaching,0,1,0,0,0,0,0,1
report cites,1,0,0,0,0,0,0,1
report climate,0,0,0,0,0,1,0,1
report damage,0,1,0,0,0,0,0,1
report days,0,1,0,0,0,0,0,1
report droughts,0,0,0,0,0,1,0,1
report earlier,0,0,0,0,0,1,0,1
report focuses,0,0,0,0,0,1,0,1
report harvest,0,0,0,1,0,0,0,1
report hope,0,0,0,0,0,1,0,1
report identified,0,0,1,0,0,0,0,1
report information,0,0,0,0,0,1,0,1
report issued,0,0,0,0,0,1,0,1
report jodie,0,1,0,0,0,0,0,1
report laid,0,1,0,0,0,0,0,1
report launched,0,0,0,0,0,1,0,1
report lays,0,0,0,0,0,1,0,1
report makes,0,0,0,0,0,1,0,1
report risi,0,0,0,0,0,1,0,1
report stated,0,0,0,1,0,0,0,1
report stopped,0,0,0,0,1,0,0,1
report submitted,0,1,0,0,0,0,0,1
report told,0,0,0,0,0,1,0,1
report water,0,0,0,0,0,1,0,1
report's concerns,0,1,0,0,0,0,0,1
reported citing,0,0,0,1,0,0,0,1
reported conditions,0,1,0,0,0,0,0,1
reported data,0,1,0,0,0,0,0,1
reported dead,1,0,0,0,0,0,0,1
reported npr's,0,0,0,0,0,1,0,1
reported people,0,0,0,0,1,0,0,1
reported recently,0,0,0,1,0,0,0,1
reported sunday,1,0,0,0,0,0,0,1
reported wastewater,0,0,0,1,0,0,0,1
reporter amy,0,0,0,0,0,1,0,1
reporter based,0,0,0,0,0,1,0,1
reporter ezra,0,0,0,0,1,0,0,1
reporter geoffrey,0,0,0,0,1,0,0,1
reporter mark,0,0,0,0,1,0,0,1
reporter mary,0,0,1,0,0,0,0,1
reporter matrix,0,0,1,0,0,0,0,1
reporter matt,0,0,0,0,0,1,0,1
reporter nadia,0,0,0,1,0,0,0,1
reporter offer,0,0,1,0,0,0,0,1
reporter posted,0,0,1,0,0,0,0,1
reporter recounted,0,0,1,0,0,0,0,1
reporter schorsch,0,0,1,0,0,0,0,1
reporters haaland,0,0,0,0,0,1,0,1
reporting continues,0,1,0,0,0,0,0,1
reporting trips,1,0,0,0,0,0,0,1
reports released,1,0,0,0,0,0,0,1
reports slashing,0,0,0,1,0,0,0,1
reports spanning,1,0,0,0,0,0,0,1
reports tracked,0,0,0,1,0,0,0,1
reports volunteers,0,0,0,0,0,1,0,1
repowereu heat,0,0,0,0,0,0,1,1
represent rural,0,0,0,0,0,0,1,1
represents communities,0,1,0,0,0,0,0,1
represents oil,0,0,0,0,1,0,0,1
represents renewable,0,0,0,0,1,0,0,1
represents tribal,0,0,0,0,0,1,0,1
reprocess cups,1,0,0,0,0,0,0,1
reprocessing rates,1,0,0,0,0,0,0,1
reproduce advocates,0,0,1,0,0,0,0,1
reproduce polar,0,0,1,0,0,0,0,1
reproductive engine,0,0,1,0,0,0,0,1
reproductive health,0,1,0,0,0,0,0,1
republican chair,0,0,0,0,1,0,0,1
republican christine,1,0,0,0,0,0,0,1
republican congressmen,0,0,0,0,1,0,0,1
republican controlled,1,0,0,0,0,0,0,1
republican gov,1,0,0,0,0,0,0,1
republican governor,0,0,0,0,1,0,0,1
republican governors,1,0,0,0,0,0,0,1
republican house,0,0,0,0,1,0,0,1
republican james,0,1,0,0,0,0,0,1
republican lawmakers,0,1,0,0,0,0,0,1
republican majority,0,0,1,0,0,0,0,1
republican party,0,0,0,0,0,0,1,1
republican predecessor,0,0,0,0,1,0,0,1
republican public,0,0,1,0,0,0,0,1
republican senator,0,0,0,0,1,0,0,1
republican senators,0,0,0,0,0,1,0,1
reputational benefits,0,0,1,0,0,0,0,1
requested interviews,1,0,0,0,0,0,0,1
requesting charity,0,0,1,0,0,0,0,1
require clients,0,0,0,0,0,0,1,1
require developers,0,1,0,0,0,0,0,1
require electrifying,0,0,0,0,1,0,0,1
require emissions,0,1,0,0,0,0,0,1
require gasoline,0,0,0,0,1,0,0,1
require manufacturers,0,0,1,0,0,0,0,1
require noaa,0,0,0,1,0,0,0,1
require packaging,0,1,0,0,0,0,0,1
require quality,1,0,0,0,0,0,0,1
require truck,0,0,0,0,0,1,0,1
required emissions,0,0,0,0,1,0,0,1
required time,0,0,0,1,0,0,0,1
required.for npr,0,1,0,0,0,0,0,1
requirements texas,0,1,0,0,0,0,0,1
requires cooperation,0,1,0,0,0,0,0,1
requires countries,0,0,0,0,0,1,0,1
requires cutting,0,0,0,0,1,0,0,1
requires mining,1,0,0,0,0,0,0,1
requires multiple,0,0,0,1,0,0,0,1
requires noaa,0,0,0,1,0,0,0,1
requires subsidies,0,0,0,0,1,0,0,1
requires vast,0,0,0,1,0,0,0,1
requiring search,0,1,0,0,0,0,0,1
rerouting water,0,1,0,0,0,0,0,1
rescue comb,1,0,0,0,0,0,0,1
rescue efforts,1,0,0,0,0,0,0,1
rescue personnel,1,0,0,0,0,0,0,1
rescue teams,0,0,0,1,0,0,0,1
rescue vehicles,0,1,0,0,0,0,0,1
rescue workers,0,1,0,0,0,0,0,1
rescued migrants,0,1,0,0,0,0,0,1
rescued overnight,0,0,0,0,0,0,1,1
rescuers dug,0,1,0,0,0,0,0,1
rescuers evacuated,1,0,0,0,0,0,0,1
reseal driveways,0,0,0,1,0,0,0,1
research additionally,0,0,0,1,0,0,0,1
research agenda,0,0,0,1,0,0,0,1
research analyst,0,0,0,0,1,0,0,1
research analyzed,0,0,0,1,0,0,0,1
research board,0,0,0,0,0,1,0,1
research dollars,0,0,0,1,0,0,0,1
research effort,0,0,0,0,1,0,0,1
research foundation,0,0,0,0,0,1,0,1
research funding,0,0,0,1,0,0,0,1
research gti,0,0,0,0,1,0,0,1
research located,0,0,0,0,0,0,1,1
research manager,0,0,0,1,0,0,0,1
research published,0,0,0,0,0,1,0,1
research scientist,0,1,0,0,0,0,0,1
research strengthen,0,1,0,0,0,0,0,1
research study,0,0,1,0,0,0,0,1
research suggesting,0,0,0,1,0,0,0,1
research support,0,0,0,0,1,0,0,1
research underscore,0,0,1,0,0,0,0,1
researcher erin,0,0,0,0,1,0,0,1
researcher yael,0,1,0,0,0,0,0,1
researchers conclude,0,1,0,0,0,0,0,1
researchers concluded,0,0,0,1,0,0,0,1
researchers confirmed,0,0,0,1,0,0,0,1
researchers identified,0,0,1,0,0,0,0,1
researchers measures,0,0,0,0,1,0,0,1
researchers revealed,0,0,0,1,0,0,0,1
researchers suggested,0,0,0,0,0,1,0,1
researchers surveyed,0,0,1,0,0,0,0,1
researchers yasuhiro,0,0,0,0,0,1,0,1
researches alternative,0,0,1,0,0,0,0,1
researches water,0,1,0,0,0,0,0,1
resentment alabamians,0,0,1,0,0,0,0,1
resentment cynicism,0,0,0,1,0,0,0,1
reservation pretty,0,0,0,0,0,1,0,1
reservation stretches,0,0,0,0,0,1,0,1
reservation's northwestern,0,0,0,0,0,1,0,1
reserve alaska,0,0,0,0,0,1,0,1
reserve bank,0,0,0,0,1,0,0,1
reserve chairman,0,0,0,0,0,1,0,1
reserve climate,0,0,0,0,0,1,0,1
reserve earlier,1,0,0,0,0,0,0,1
reserve environmental,0,0,0,0,0,1,0,1
reserve located,0,0,0,0,0,1,0,1
reserve officials,0,0,0,0,0,1,0,1
reserve supplies,1,0,0,0,0,0,0,1
reserves indonesian,0,0,0,0,1,0,0,1
reserves shrinking,0,0,0,1,0,0,0,1
reservoir levels,1,0,0,0,0,0,0,1
reservoirs arizona,0,0,0,0,1,0,0,1
reservoirs declined,0,0,0,0,0,1,0,1
reservoirs filling,0,0,0,0,0,1,0,1
reservoirs fuller,0,0,0,0,0,1,0,1
reservoirs started,0,0,0,1,0,0,0,1
reservoirs tend,0,0,0,1,0,0,0,1
reset entered,0,0,0,0,0,1,0,1
reset participants,0,0,0,0,0,1,0,1
reset urged,0,0,0,0,0,1,0,1
reshape oregon's,0,0,1,0,0,0,0,1
reshaping life,0,1,0,0,0,0,0,1
residence regina,0,0,0,0,0,1,0,1
resident erika,0,0,0,1,0,0,0,1
resident kristen,0,0,0,1,0,0,0,1
resident susanne,0,0,1,0,0,0,0,1
residents adapt,0,0,0,0,0,1,0,1
residents believed,0,0,0,0,1,0,0,1
residents continues,0,0,1,0,0,0,0,1
residents electricity,0,0,1,0,0,0,0,1
residents explains,0,0,0,1,0,0,0,1
residents information,0,0,0,0,1,0,0,1
residents living,0,0,1,0,0,0,0,1
residents months,0,0,0,1,0,0,0,1
residents participate,0,0,0,0,1,0,0,1
residents primary,0,0,0,0,1,0,0,1
residents reported,0,0,0,1,0,0,0,1
residents safe,1,0,0,0,0,0,0,1
residents talking,0,0,0,1,0,0,0,1
residue filled,0,0,0,1,0,0,0,1
resign florida,0,0,1,0,0,0,0,1
resilience creating,0,0,0,0,0,1,0,1
resilience efforts,0,1,0,0,0,0,0,1
resilience portal,0,1,0,0,0,0,0,1
resilience projects,0,1,0,0,0,0,0,1
resilience strategies,0,0,0,0,1,0,0,1
resilience water,0,0,0,1,0,0,0,1
resilient agriculture,0,1,0,0,0,0,0,1
resilient charlene,0,1,0,0,0,0,0,1
resilient infrastructure,1,0,0,0,0,0,0,1
resist development,0,0,0,0,0,0,1,1
resistant depinte,0,0,1,0,0,0,0,1
resistant varieties,0,0,0,0,0,1,0,1
resisted addressing,0,1,0,0,0,0,0,1
resisted efforts,0,0,0,0,0,0,1,1
resisted sending,0,0,0,1,0,0,0,1
resolute carnivores,0,1,0,0,0,0,0,1
resort city,0,1,0,0,0,0,0,1
resort island,0,1,0,0,0,0,0,1
resort located,0,0,0,0,1,0,0,1
resource development,0,0,0,0,0,1,0,1
resource scarcity,0,0,0,1,0,0,0,1
resource wash,0,0,0,1,0,0,0,1
resources analysis,0,0,0,0,1,0,0,1
resources committee,0,1,0,0,0,0,0,1
resources increasing,0,0,0,0,0,1,0,1
resources institute's,0,1,0,0,0,0,0,1
resources launching,0,0,1,0,0,0,0,1
resources manager,0,0,0,0,1,0,0,1
resources npr's,1,0,0,0,0,0,0,1
resources officials,1,0,0,0,0,0,0,1
resources seymour,0,0,0,0,0,0,1,1
resources slower,0,1,0,0,0,0,0,1
resources told,0,0,0,0,1,0,0,1
respected italian,0,1,0,0,0,0,0,1
respectful care,1,0,0,0,0,0,0,1
respond rachel,0,0,0,0,0,0,1,1
responded times,0,1,0,0,0,0,0,1
respondents supported,0,0,0,1,0,0,0,1
responder zipping,0,1,0,0,0,0,0,1
responds robert,1,0,0,0,0,0,0,1
response agency,1,0,0,0,0,0,0,1
response bill,0,0,0,0,1,0,0,1
response dialed,0,0,0,0,0,0,1,1
response national,0,1,0,0,0,0,0,1
response team,0,0,0,0,0,1,0,1
response workers,1,0,0,0,0,0,0,1
responses ranging,0,0,0,0,0,1,0,1
responsibilities belong,0,0,0,0,0,1,0,1
responsibility inherent,0,1,0,0,0,0,0,1
responsibility pattie,1,0,0,0,0,0,0,1
responsibly dispose,0,1,0,0,0,0,0,1
responsibly reducing,0,0,0,0,1,0,0,1
restaurant atelier,0,1,0,0,0,0,0,1
restaurant kitchens,0,1,0,0,0,0,0,1
restaurant owners,0,0,0,1,0,0,0,1
restaurants apartments,0,1,0,0,0,0,0,1
restore biodiversity,0,0,1,0,0,0,0,1
restore coastal,1,0,0,0,0,0,0,1
restore electricity,0,0,0,1,0,0,0,1
restore generating,0,0,0,1,0,0,0,1
restore public,0,0,0,1,0,0,0,1
restored baseball,0,1,0,0,0,0,0,1
restored field,0,1,0,0,0,0,0,1
restored lights,0,1,0,0,0,0,0,1
restored power,0,0,0,0,0,0,1,1
restored vázquez,0,1,0,0,0,0,0,1
restoring instruments,0,1,0,0,0,0,0,1
restoring land,0,1,0,0,0,0,0,1
restoring natural,0,0,1,0,0,0,0,1
restrictions called,0,1,0,0,0,0,0,1
restrictions effectively,0,0,0,0,1,0,0,1
restrictive laws,1,0,0,0,0,0,0,1
restricts drilling,0,0,0,0,0,1,0,1
resubmitted plans,0,0,0,0,1,0,0,1
result climate,0,0,1,0,0,0,0,1
result egypt's,0,0,0,1,0,0,0,1
result hybrids,0,0,0,0,1,0,0,1
resulting floodplains,1,0,0,0,0,0,0,1
resulting rise,0,1,0,0,0,0,0,1
resulting water,1,0,0,0,0,0,0,1
results add,0,0,0,0,1,0,0,1
results fit,0,0,0,1,0,0,0,1
resume flights,0,1,0,0,0,0,0,1
resume negotiations,0,0,0,0,1,0,0,1
resumed retrieval,1,0,0,0,0,0,0,1
retail electric,0,0,0,0,1,0,0,1
retail stoves,0,0,0,0,1,0,0,1
retailer replacement,0,0,0,1,0,0,0,1
retainer letter,0,1,0,0,0,0,0,1
retired computer,0,0,0,0,1,0,0,1
retired director,0,0,0,0,1,0,0,1
retired environmental,0,1,0,0,0,0,0,1
retired market,0,0,0,0,1,0,0,1
retired pediatrician,0,0,0,0,1,0,0,1
retired santa,0,0,0,1,0,0,0,1
retirees organized,0,0,0,0,0,1,0,1
retirement funds,0,0,0,0,0,0,1,1
retreating coastline,1,0,0,0,0,0,0,1
retrieve data,1,0,0,0,0,0,0,1
retroactive report,0,1,0,0,0,0,0,1
return obama,1,0,0,0,0,0,0,1
return phone,0,1,0,0,0,0,0,1
returning home,1,0,0,0,0,0,0,1
reuben askew,1,0,0,0,0,0,0,1
reusable advocates,0,0,0,1,0,0,0,1
reusable capsules,0,0,0,1,0,0,0,1
reuse refill,0,0,0,1,0,0,0,1
reuse water,0,0,0,1,0,0,0,1
reused close,1,0,0,0,0,0,0,1
reuters reported,0,0,0,0,0,1,0,1
revealed deficiencies,0,0,0,1,0,0,0,1
revelation gas,0,0,0,1,0,0,0,1
revenues fuel,0,0,0,1,0,0,0,1
reverse basically,0,1,0,0,0,0,0,1
reverse deforestation,0,1,0,0,0,0,0,1
reverse nature's,0,0,1,0,0,0,0,1
reversed obama's,0,0,0,0,0,1,0,1
review looked,0,0,1,0,0,0,0,1
review period,0,0,0,0,0,1,0,1
review plane,0,0,1,0,0,0,0,1
review quote,0,0,0,0,1,0,0,1
review window,0,0,0,0,0,1,0,1
reviewed discussions,0,0,0,0,0,1,0,1
reviewed literature,0,0,0,0,0,0,1,1
reviewed study,0,0,0,1,0,0,0,1
reviews failed,0,0,0,0,0,1,0,1
reviews helped,1,0,0,0,0,0,0,1
revive coal,0,1,0,0,0,0,0,1
reviving polar,0,0,0,1,0,0,0,1
revolutionary vehicle,0,0,0,0,1,0,0,1
revolutionized hybrids,0,0,0,0,1,0,0,1
revolving fund,0,0,0,1,0,0,0,1
revulsion diego,0,0,0,0,0,1,0,1
revving snowmobiles,0,0,0,1,0,0,0,1
rhino shielding,0,1,0,0,0,0,0,1
rhome appeared,0,1,0,0,0,0,0,1
rhome responded,0,1,0,0,0,0,0,1
rhome's comments,0,1,0,0,0,0,0,1
rhythm emerges,1,0,0,0,0,0,0,1
rican artists,0,0,0,1,0,0,0,1
rican melodies,0,1,0,0,0,0,0,1
ricans guerrero,0,0,0,1,0,0,0,1
ricardo salvador,0,1,0,0,0,0,0,1
riccardo caniparoli,0,1,0,0,0,0,0,1
rice farmer,0,1,0,0,0,0,0,1
rice farming,1,0,0,0,0,0,0,1
rice potatoes,0,1,0,0,0,0,0,1
rice university,0,0,0,0,1,0,0,1
rich culture,0,1,0,0,0,0,0,1
rich family,0,0,1,0,0,0,0,1
rich minerals,0,1,0,0,0,0,0,1
rich soil,0,1,0,0,0,0,0,1
rich water,0,0,1,0,0,0,0,1
richard alley,0,0,0,0,1,0,0,1
richard grosso,1,0,0,0,0,0,0,1
richard nixon,1,0,0,0,0,0,0,1
richard vogel,0,0,0,0,1,0,0,1
richer developed,0,0,1,0,0,0,0,1
richer industrialized,0,0,0,0,0,1,0,1
richer people,0,0,0,0,1,0,0,1
richmond california,0,0,1,0,0,0,0,1
rick palmeri,0,0,0,0,1,0,0,1
rickety boats,0,1,0,0,0,0,0,1
rico carlos,0,0,0,1,0,0,0,1
rico destroying,0,1,0,0,0,0,0,1
rico electric,0,0,0,1,0,0,0,1
rico energy,0,0,0,1,0,0,0,1
rico erika,0,1,0,0,0,0,0,1
rico filed,0,0,0,1,0,0,0,1
rico florida,0,0,0,0,1,0,0,1
rico grid,0,0,0,1,0,0,0,1
rico including,1,0,0,0,0,0,0,1
rico investment,0,0,0,1,0,0,0,1
rico lajas,0,1,0,0,0,0,0,1
rico listing,1,0,0,0,0,0,0,1
rico monday,1,0,0,0,0,0,0,1
rico officials,0,1,0,0,0,0,0,1
rico post,0,0,0,1,0,0,0,1
rico's grid,0,0,0,1,0,0,0,1
rico's poorest,0,1,0,0,0,0,0,1
rico's targets,0,0,0,1,0,0,0,1
riddle climate,0,1,0,0,0,0,0,1
riddle npr,0,1,0,0,0,0,0,1
ride recently,0,0,0,1,0,0,0,1
rideau canal,0,0,0,0,1,0,0,1
ridge recently,0,0,0,0,1,0,0,1
ridiculous question,1,0,0,0,0,0,0,1
ridiculous sort,1,0,0,0,0,0,0,1
rig workers,0,1,0,0,0,0,0,1
rights abuses,0,0,0,0,0,0,1,1
rights advocates,1,0,0,0,0,0,0,1
rights called,0,0,0,1,0,0,0,1
rights combating,0,0,0,0,1,0,0,1
rights generation,0,0,0,1,0,0,0,1
rights o'donnell,0,0,0,0,0,0,1,1
rights protections,0,0,1,0,0,0,0,1
rights slogan,0,0,0,1,0,0,0,1
rights violations,0,1,0,0,0,0,0,1
rigorous guidelines,0,1,0,0,0,0,0,1
rigorously discharging,0,0,0,1,0,0,0,1
ring fenced,0,1,0,0,0,0,0,1
ring taking,1,0,0,0,0,0,0,1
ringo h.w,0,0,0,1,0,0,0,1
rio calif,0,0,0,1,0,0,0,1
rio grande,0,1,0,0,0,0,0,1
ripping homes,0,0,0,0,0,1,0,1
ripple effects,0,1,0,0,0,0,0,1
rise accurately,1,0,0,0,0,0,0,1
rise damages,1,0,0,0,0,0,0,1
rise deadly,0,1,0,0,0,0,0,1
rise flooding,0,1,0,0,0,0,0,1
rise globally,0,1,0,0,0,0,0,1
rise heavy,0,1,0,0,0,0,0,1
rise potential,0,0,0,0,1,0,0,1
rise research,0,1,0,0,0,0,0,1
rise ryan,0,1,0,0,0,0,0,1
rise scientists,0,1,0,0,0,0,0,1
rise slightly,0,1,0,0,0,0,0,1
rise stronger,0,1,0,0,0,0,0,1
rises suddenly,0,0,0,0,0,1,0,1
rishi sunak,0,1,0,0,0,0,0,1
risi program,0,0,0,0,0,1,0,1
risi stressed,0,0,0,0,0,1,0,1
rising climate,0,0,0,0,0,1,0,1
rising construction,0,0,0,0,1,0,0,1
rising costs,1,0,0,0,0,0,0,1
rising expenses,1,0,0,0,0,0,0,1
rising female,0,1,0,0,0,0,0,1
rising fossil,0,1,0,0,0,0,0,1
rising fuel,1,0,0,0,0,0,0,1
rising global,1,0,0,0,0,0,0,1
rising power,0,0,0,0,1,0,0,1
rising quickly,0,1,0,0,0,0,0,1
rising rivers,0,0,0,0,0,1,0,1
rising summer,0,1,0,0,0,0,0,1
rising waters,0,1,0,0,0,0,0,1
risk allowing,0,1,0,0,0,0,0,1
risk building,0,0,0,1,0,0,0,1
risk factor,0,1,0,0,0,0,0,1
risk intelligence,0,0,0,1,0,0,0,1
risk phelan,0,0,1,0,0,0,0,1
risk posed,0,0,0,0,1,0,0,1
risk prof,0,0,1,0,0,0,0,1
risk tyrone,0,1,0,0,0,0,0,1
risking extinction,0,1,0,0,0,0,0,1
risking future,0,0,1,0,0,0,0,1
risking public,0,0,1,0,0,0,0,1
risks alienating,0,0,0,0,0,1,0,1
risks commissioner,0,0,0,1,0,0,0,1
risks developed,1,0,0,0,0,0,0,1
risks involved,0,1,0,0,0,0,0,1
risks overshooting,0,1,0,0,0,0,0,1
risky development,1,0,0,0,0,0,0,1
rita hit,0,0,0,0,1,0,0,1
rita nelson,0,0,0,0,0,1,0,1
rival consulting,0,0,1,0,0,0,0,1
rival deal,0,0,0,0,0,1,0,1
rival politicians,1,0,0,0,0,0,0,1
river alex,0,0,0,1,0,0,0,1
river arcadia,1,0,0,0,0,0,0,1
river barges,1,0,0,0,0,0,0,1
river begins,0,0,0,1,0,0,0,1
river blues,0,1,0,0,0,0,0,1
river california,0,0,0,0,0,1,0,1
river carried,0,0,0,0,1,0,0,1
river clogged,0,0,0,0,0,1,0,1
river compact,0,0,0,1,0,0,0,1
river conditions,0,1,0,0,0,0,0,1
river county,0,1,0,0,0,0,0,1
river crisis,1,0,0,0,0,0,0,1
river cynthia,0,0,0,1,0,0,0,1
river deliveries,0,0,0,0,1,0,0,1
river deriso,1,0,0,0,0,0,0,1
river domestic,0,1,0,0,0,0,0,1
river dried,0,0,0,0,0,1,0,1
river dropped,0,1,0,0,0,0,0,1
river expire,0,0,0,1,0,0,0,1
river flowing,0,0,0,1,0,0,0,1
river front,0,0,0,1,0,0,0,1
river gradually,0,1,0,0,0,0,0,1
river hard,0,0,0,0,0,1,0,1
river hit,1,0,0,0,0,0,0,1
river including,0,0,0,0,0,1,0,1
river inventive,0,0,0,1,0,0,0,1
river jumped,1,0,0,0,0,0,0,1
river kasegaluk,0,0,0,0,0,1,0,1
river king,0,1,0,0,0,0,0,1
river law,1,0,0,0,0,0,0,1
river levee,0,0,0,0,0,0,1,1
river meaning,0,0,0,0,0,1,0,1
river monitors,0,0,0,1,0,0,0,1
river north,0,1,0,0,0,0,0,1
river overflowing,0,0,0,1,0,0,0,1
river peaks,0,0,0,1,0,0,0,1
river people,1,0,0,0,0,0,0,1
river produced,0,0,0,1,0,0,0,1
river pumps,1,0,0,0,0,0,0,1
river randy,0,1,0,0,0,0,0,1
river remain,0,1,0,0,0,0,0,1
river steam,1,0,0,0,0,0,0,1
river studies,1,0,0,0,0,0,0,1
river swept,0,1,0,0,0,0,0,1
river tens,0,0,0,1,0,0,0,1
river traffic,0,1,0,0,0,0,0,1
river underneath,1,0,0,0,0,0,0,1
river unlike,1,0,0,0,0,0,0,1
river washed,1,0,0,0,0,0,0,1
river winter,0,0,0,0,1,0,0,1
river's bend,0,0,0,0,1,0,0,1
river's drought,0,0,0,1,0,0,0,1
river's future,0,0,0,1,0,0,0,1
river's headwaters,0,0,0,0,1,0,0,1
river's major,0,0,0,0,1,0,0,1
river's overtopped,0,0,0,1,0,0,0,1
rivera's home,0,1,0,0,0,0,0,1
riverbank akter,0,0,0,0,0,1,0,1
riverbed exploring,0,1,0,0,0,0,0,1
riverbeds speaking,0,0,0,1,0,0,0,1
riverboat pilot,0,1,0,0,0,0,0,1
riverine flooding,1,0,0,0,0,0,0,1
rivers drive,0,0,1,0,0,0,0,1
rivers national,0,1,0,0,0,0,0,1
rivers pipelines,0,0,0,1,0,0,0,1
rivers pushed,1,0,0,0,0,0,0,1
rivers sounds,0,0,0,0,0,0,1,1
rivers streams,0,0,0,0,0,1,0,1
rivers upstream,0,0,0,0,1,0,0,1
riverside paths,0,1,0,0,0,0,0,1
road accidents,1,0,0,0,0,0,0,1
road alongside,0,1,0,0,0,0,0,1
road bangladesh,0,0,0,0,0,1,0,1
road capacity,1,0,0,0,0,0,0,1
road closures,0,0,0,0,0,1,0,1
road construction,0,0,0,0,0,0,1,1
road esme,0,0,0,1,0,0,0,1
road fatima,0,0,0,0,0,1,0,1
road initiative,0,1,0,0,0,0,0,1
road lots,0,0,0,0,1,0,0,1
road map,0,0,1,0,0,0,0,1
road military,0,1,0,0,0,0,0,1
road named,0,1,0,0,0,0,0,1
road reinforced,1,0,0,0,0,0,0,1
road started,1,0,0,0,0,0,0,1
road system,0,0,1,0,0,0,0,1
road traffic,0,0,0,0,0,1,0,1
road tree,1,0,0,0,0,0,0,1
road washouts,0,1,0,0,0,0,0,1
road west,1,0,0,0,0,0,0,1
roadblocks.for npr,0,0,0,0,1,0,0,1
roads connecting,0,1,0,0,0,0,0,1
roads lancaster,0,0,0,1,0,0,0,1
roads nadia,0,0,0,1,0,0,0,1
roads overnight,0,1,0,0,0,0,0,1
roads ryan,0,0,0,0,0,1,0,1
roads va,0,1,0,0,0,0,0,1
roadstar trucking,0,0,1,0,0,0,0,1
roadway vehicle,0,0,1,0,0,0,0,1
roadway.they live,0,0,0,0,0,1,0,1
roadways mudslides,0,0,0,0,0,1,0,1
roadways poured,0,0,0,1,0,0,0,1
roadways power's,0,0,0,1,0,0,0,1
roared ashore,1,0,0,0,0,0,0,1
roaring fork,0,0,0,1,0,0,0,1
roaring traffic,0,0,1,0,0,0,0,1
rob thornton,1,0,0,0,0,0,0,1
robert bresson,0,1,0,0,0,0,0,1
robert califf,0,1,0,0,0,0,0,1
robert darby,0,1,0,0,0,0,0,1
robert fenton,0,0,0,0,0,1,0,1
robert kenney,0,1,0,0,0,0,0,1
robert ray,1,0,0,0,0,0,0,1
roberto schmidt,0,1,0,0,0,0,0,1
robin averbeck,0,0,0,0,0,0,1,1
robin lubbock,0,0,0,0,0,1,0,1
robin rix,0,1,0,0,0,0,0,1
robinson michael,1,0,0,0,0,0,0,1
robot creator,0,0,0,0,1,0,0,1
robot named,0,0,0,0,1,0,0,1
robot wended,0,0,0,0,1,0,0,1
robust national,0,1,0,0,0,0,0,1
robust power,0,1,0,0,0,0,0,1
robust punk,0,1,0,0,0,0,0,1
rochester minnesota,0,0,0,0,1,0,0,1
rock ketki,0,0,1,0,0,0,0,1
rock listen,0,0,1,0,0,0,0,1
rock memphis,0,0,0,0,0,1,0,1
rock moonscape,1,0,0,0,0,0,0,1
rock star,0,1,0,0,0,0,0,1
rockies greg,0,0,0,0,1,0,0,1
rocking chairs,0,0,0,0,0,1,0,1
rocks warren,0,1,0,0,0,0,0,1
rockslides debris,0,0,0,0,1,0,0,1
rocky beach,0,0,1,0,0,0,0,1
rocky cliffs,0,1,0,0,0,0,0,1
rocky mountain,0,1,0,0,0,0,0,1
rocky relationship,0,0,0,0,1,0,0,1
rocky steps,1,0,0,0,0,0,0,1
rodger bosch,0,1,0,0,0,0,0,1
rodrigues viana,0,0,0,1,0,0,0,1
rodríguez frowned,0,1,0,0,0,0,0,1
rodríguez malavé,0,1,0,0,0,0,0,1
rodríguez malavé's,0,1,0,0,0,0,0,1
rodríguez realized,0,1,0,0,0,0,0,1
rodríguez recalled,0,1,0,0,0,0,0,1
rodriguez sierra,0,0,1,0,0,0,0,1
rodríguez walked,0,1,0,0,0,0,0,1
rodríguez's neighborhood,0,1,0,0,0,0,0,1
rods called,0,0,0,0,0,1,0,1
roesch mcnally,0,0,0,1,0,0,0,1
rogue employee,0,0,1,0,0,0,0,1
rohlman ap,0,0,0,0,0,0,1,1
roiling pacific,0,0,0,1,0,0,0,1
roiling santa,0,0,0,0,1,0,0,1
role government,0,1,0,0,0,0,0,1
role governments,0,1,0,0,0,0,0,1
role nature,1,0,0,0,0,0,0,1
role neighborhoods,0,0,0,1,0,0,0,1
role oil,0,0,0,0,1,0,0,1
role reversal,0,1,0,0,0,0,0,1
rolling blackouts,0,1,0,0,0,0,0,1
rolwaling river,0,1,0,0,0,0,0,1
rolwaling valley,0,1,0,0,0,0,0,1
roma involving,0,0,1,0,0,0,0,1
romaine leaf,0,0,0,0,0,1,0,1
roman catholic,1,0,0,0,0,0,0,1
roman empire,0,1,0,0,0,0,0,1
roman epicures,0,0,0,0,0,1,0,1
romania abstained,0,0,0,0,0,1,0,1
romans ate,0,0,0,0,0,1,0,1
romantic partner,0,0,1,0,0,0,0,1
romer kate,0,0,1,0,0,0,0,1
romero visits,0,0,0,0,1,0,0,1
romney's presidential,0,0,0,0,1,0,0,1
ron amstutz,0,0,0,1,0,0,0,1
ron bull,0,1,0,0,0,0,0,1
ron lovick,0,0,0,0,0,1,0,1
ron sachs,0,0,1,0,0,0,0,1
roof collapses,0,0,0,0,0,1,0,1
roof demands,0,1,0,0,0,0,0,1
roof panels,0,1,0,0,0,0,0,1
roof shredded,0,0,0,0,0,0,1,1
roofless sagging,0,1,0,0,0,0,0,1
roofs climate,0,1,0,0,0,0,0,1
roofs president,1,0,0,0,0,0,0,1
rooftops susan,0,0,0,0,1,0,0,1
roolvink deputy,0,0,0,0,1,0,0,1
root structures,0,1,0,0,0,0,0,1
roots hold,0,1,0,0,0,0,0,1
rope eventually,0,0,0,1,0,0,0,1
rope taught,0,1,0,0,0,0,0,1
rosalyn lapier,0,1,0,0,0,0,0,1
rosario murillo,1,0,0,0,0,0,0,1
rose reporting,0,1,0,0,0,0,0,1
rose toure,0,0,0,1,0,0,0,1
rosensweig's deep,0,1,0,0,0,0,0,1
rosman reports,0,0,0,0,1,0,0,1
rot explains,0,1,0,0,0,0,0,1
rotating columns,0,0,0,0,0,1,0,1
rotating powerful,0,0,0,0,0,1,0,1
rotating thunderstorm,0,0,0,0,0,1,0,1
rotating thunderstorms,0,0,0,0,0,0,1,1
rotating tube,0,0,0,0,0,0,1,1
rott hey,0,0,1,0,0,0,0,1
rott reporting,0,0,0,0,0,1,0,1
rott reports,0,0,0,0,0,1,0,1
rott's story,0,1,0,0,0,0,0,1
rotting eggs,0,0,0,0,0,1,0,1
rough times,0,1,0,0,0,0,0,1
roughly equivalent,0,1,0,0,0,0,0,1
roughly half,0,1,0,0,0,0,0,1
roughly triple,0,0,0,1,0,0,0,1
round jobs,0,0,0,1,0,0,0,1
round trip,0,0,1,0,0,0,0,1
rounding error,0,0,0,0,1,0,0,1
route davis,0,0,0,1,0,0,0,1
routine flaring,0,1,0,0,0,0,0,1
routine pattie,1,0,0,0,0,0,0,1
routinely monitor,0,0,0,0,0,1,0,1
roy citing,0,0,0,0,1,0,0,1
roy launched,0,0,0,0,1,0,0,1
roy started,0,0,0,0,1,0,0,1
roy's coalfield,0,0,0,0,1,0,0,1
roy's free,0,0,0,0,1,0,0,1
roybal mack,1,0,0,0,0,0,0,1
rubber boots,0,0,0,0,1,0,0,1
rubber bullets,0,1,0,0,0,0,0,1
rubber hits,0,0,0,0,0,1,0,1
rubber national,0,0,0,0,1,0,0,1
rubbery bounce,0,0,1,0,0,0,0,1
rubbing bony,0,0,0,0,0,1,0,1
rubio associate,0,0,0,1,0,0,0,1
ruby leung,0,0,0,0,1,0,0,1
ruin crops,1,0,0,0,0,0,0,1
ruins oklahoma,0,1,0,0,0,0,0,1
ruksana touches,1,0,0,0,0,0,0,1
rule act,0,0,1,0,0,0,0,1
rule applies,0,0,0,0,0,1,0,1
rule gradually,0,0,1,0,0,0,0,1
rule portillo,0,0,1,0,0,0,0,1
rule reinstated,0,0,0,0,0,1,0,1
rule require,0,0,1,0,0,0,0,1
rules enacted,1,0,0,0,0,0,0,1
rules governing,1,0,0,0,0,0,0,1
rules seek,0,0,0,0,1,0,0,1
ruling class,0,0,0,0,0,1,0,1
ruling nationalist,0,0,0,0,0,1,0,1
rumble kiwifarms,0,0,0,0,0,1,0,1
ruminates shinaasha,0,0,0,0,0,1,0,1
rummer told,0,1,0,0,0,0,0,1
run american,0,0,1,0,0,0,0,1
run citizens,0,0,0,0,1,0,0,1
run dependably,0,0,0,0,1,0,0,1
run dry,0,0,0,0,1,0,0,1
run midwife,1,0,0,0,0,0,0,1
run oil,0,0,0,1,0,0,0,1
run parallel,0,0,1,0,0,0,0,1
run report,0,0,0,0,0,1,0,1
run schools,0,0,0,0,1,0,0,1
run seminars,0,0,0,1,0,0,0,1
run similar,0,0,0,1,0,0,0,1
run wam,0,0,0,1,0,0,0,1
runaway impacts,0,0,1,0,0,0,0,1
runaway pacific,0,0,0,1,0,0,0,1
runaway sea,0,1,0,0,0,0,0,1
runaway warming,0,0,0,1,0,0,0,1
running amid,0,0,0,0,1,0,0,1
running complex,1,0,0,0,0,0,0,1
running drought,0,1,0,0,0,0,0,1
running eventually,0,0,0,1,0,0,0,1
running green,0,0,0,0,1,0,0,1
running hot,0,0,0,1,0,0,0,1
running neck,1,0,0,0,0,0,0,1
running pop,1,0,0,0,0,0,0,1
running shoes,0,1,0,0,0,0,0,1
running simulations,0,0,0,0,0,1,0,1
running start,0,0,1,0,0,0,0,1
runoff carved,0,1,0,0,0,0,0,1
runoff coming,0,0,0,0,0,1,0,1
runoff rain,0,0,0,0,0,1,0,1
runoff ruin,0,0,0,0,1,0,0,1
runoff saturday,0,0,0,0,1,0,0,1
runs journeys,0,0,0,1,0,0,0,1
runways bals,0,0,1,0,0,0,0,1
rupp arena,0,1,0,0,0,0,0,1
rural affairs,0,0,0,1,0,0,0,1
rural development,0,0,0,0,0,0,1,1
rural homes,0,1,0,0,0,0,0,1
rural households,0,1,0,0,0,0,0,1
rural landowners,0,0,0,0,1,0,0,1
rural markets,0,1,0,0,0,0,0,1
rural neighbors,0,0,0,1,0,0,0,1
rural page,0,0,0,0,1,0,0,1
rural solar,0,0,0,0,1,0,0,1
rural tool,0,0,0,0,0,1,0,1
rural village,0,0,0,0,1,0,0,1
rural women,0,1,0,0,0,0,0,1
rushing water,1,0,0,0,0,0,0,1
russell dickerson,0,0,0,0,1,0,0,1
russell emergency,0,1,0,0,0,0,0,1
russell waer,0,0,0,0,1,0,0,1
russia launched,0,0,1,0,0,0,0,1
russia ukrainian,0,0,0,0,1,0,0,1
russia's vladimir,0,1,0,0,0,0,0,1
russia's war,0,1,0,0,0,0,0,1
russian control,0,1,0,0,0,0,0,1
russian fortifications,0,0,0,1,0,0,0,1
russian republic,0,0,0,1,0,0,0,1
russian river.so,0,0,0,1,0,0,0,1
rust fungus,0,0,0,0,0,1,0,1
ruto acknowledged,1,0,0,0,0,0,0,1
ruto addresses,1,0,0,0,0,0,0,1
ruto kenya's,1,0,0,0,0,0,0,1
ruto raised,1,0,0,0,0,0,0,1
ruto's inauguration,1,0,0,0,0,0,0,1
rwanda farm,0,0,1,0,0,0,0,1
rwanda gisele,0,0,0,0,1,0,0,1
ryan bohl,0,0,0,1,0,0,0,1
ryan executive,0,0,0,0,0,1,0,1
ryan kane,1,0,0,0,0,0,0,1
ryan lance,0,0,0,0,0,1,0,1
ryan maue,0,0,0,1,0,0,0,1
ryan ray,0,0,1,0,0,0,0,1
ryan remiorz,0,0,1,0,0,0,0,1
ryan sweezey,0,0,1,0,0,0,0,1
ryugu researchers,0,0,0,0,0,1,0,1
s.g goodman,0,1,0,0,0,0,0,1
sabal dangi,0,1,0,0,0,0,0,1
sachs confirms,0,0,1,0,0,0,0,1
sachs media,0,0,1,0,0,0,0,1
sachs media's,0,0,1,0,0,0,0,1
sack size,1,0,0,0,0,0,0,1
sacramento calif,0,0,0,0,0,1,0,1
sacramento merced,0,0,0,1,0,0,0,1
sacred forest,0,0,0,1,0,0,0,1
sacred jordan,0,1,0,0,0,0,0,1
sacred ls,0,0,0,0,1,0,0,1
sacred space,0,0,0,1,0,0,0,1
sacrificing portions,0,0,0,1,0,0,0,1
sad climate,0,1,0,0,0,0,0,1
saddled er,0,0,0,0,0,1,0,1
sadio konte,0,1,0,0,0,0,0,1
sadly dozens,0,0,0,0,0,0,1,1
sadness stress,1,0,0,0,0,0,0,1
sæthren head,0,1,0,0,0,0,0,1
safe afraid,1,0,0,0,0,0,0,1
safe bet,0,0,0,0,0,1,0,1
safe country,0,1,0,0,0,0,0,1
safe hurricane,1,0,0,0,0,0,0,1
safe lanes,0,1,0,0,0,0,0,1
safe passage,0,0,1,0,0,0,0,1
safe reliable,0,1,0,0,0,0,0,1
safe space,0,0,0,0,0,0,1,1
safe supply,0,0,0,0,0,1,0,1
safe ty,0,0,0,1,0,0,0,1
safe version,0,0,0,1,0,0,0,1
safeguarding biodiversity,0,0,1,0,0,0,0,1
safeguarding land,0,0,1,0,0,0,0,1
safely cross,0,1,0,0,0,0,0,1
safely flown,0,0,0,1,0,0,0,1
safely land,0,0,0,0,1,0,0,1
safely transferred,0,0,0,0,1,0,0,1
safer alternative,0,0,0,0,1,0,0,1
safety food,0,0,1,0,0,0,0,1
safety nets,0,1,0,0,0,0,0,1
safety precautions,0,0,0,1,0,0,0,1
safety risks,0,0,0,1,0,0,0,1
safety standpoint,0,1,0,0,0,0,0,1
sagging heap,0,1,0,0,0,0,0,1
sahel region,1,0,0,0,0,0,0,1
sailed past,0,1,0,0,0,0,0,1
saint lucie,0,1,0,0,0,0,0,1
saints day,1,0,0,0,0,0,0,1
sainz ap,0,0,0,0,0,0,1,1
sala added,0,1,0,0,0,0,0,1
sala dreading,0,1,0,0,0,0,0,1
sala explained,0,1,0,0,0,0,0,1
sala led,0,1,0,0,0,0,0,1
sala national,0,1,0,0,0,0,0,1
salaam camp,0,0,1,0,0,0,0,1
salad bowl,0,0,0,0,0,1,0,1
salad english,0,1,0,0,0,0,0,1
salad salad,0,1,0,0,0,0,0,1
salad yeah,0,1,0,0,0,0,0,1
salads andrew,0,0,0,0,0,1,0,1
salam aleikum,0,0,0,0,0,1,0,1
salas director,0,0,0,1,0,0,0,1
sale appliance,0,0,0,0,1,0,0,1
saleemul huq,0,0,0,0,0,1,0,1
sales figures,0,0,0,0,1,0,0,1
sales staff,0,0,0,0,1,0,0,1
salinas river's,0,0,0,1,0,0,0,1
saline owens,0,0,0,0,1,0,0,1
saline resistant,0,0,0,0,0,1,0,1
salinity researchers,0,0,0,0,1,0,0,1
salmon river,1,0,0,0,0,0,0,1
salt pillars,0,1,0,0,0,0,0,1
salt snow,0,0,0,1,0,0,0,1
saltwater lake,0,0,0,0,1,0,0,1
saltwater pond,0,1,0,0,0,0,0,1
salty lake,1,0,0,0,0,0,0,1
salty sea,0,1,0,0,0,0,0,1
salty therapeutic,0,1,0,0,0,0,0,1
salty waters,0,1,0,0,0,0,0,1
salvador acknowledges,0,1,0,0,0,0,0,1
salvage operation,0,1,0,0,0,0,0,1
salzgitter germany,0,0,0,0,0,1,0,1
sam chamberlain,0,0,0,0,1,0,0,1
sam dean,0,0,0,0,1,0,0,1
sam yellowhorse,0,0,1,0,0,0,0,1
samantha bricker,0,0,1,0,0,0,0,1
samas 1st,0,0,0,0,1,0,0,1
sameh shoukry,0,0,0,1,0,0,0,1
samel hide,0,0,1,0,0,0,0,1
samir tounsi,0,0,0,0,0,0,1,1
samira wears,1,0,0,0,0,0,0,1
sample data,0,0,0,1,0,0,0,1
sample review,0,0,0,0,1,0,0,1
samuel alito,0,0,0,0,0,1,0,1
samuel clemens,0,1,0,0,0,0,0,1
san diego's,0,0,0,1,0,0,0,1
san félix,0,1,0,0,0,0,0,1
san francisco's,0,0,0,1,0,0,0,1
san joaquin,0,0,0,0,0,1,0,1
san jose,0,0,0,1,0,0,0,1
san lorenzo,0,0,0,1,0,0,0,1
sanaa seif,0,1,0,0,0,0,0,1
sand beaches,0,0,0,0,1,0,0,1
sand called,0,0,0,0,0,1,0,1
sand filtration,0,0,0,0,0,1,0,1
sandbags putting,0,0,0,1,0,0,0,1
sandbags swift,0,0,0,1,0,0,0,1
sandstone canyons,0,1,0,0,0,0,0,1
sanibel marina,1,0,0,0,0,0,0,1
sanitation services,0,0,0,0,0,1,0,1
santa catarina,0,0,0,0,0,0,1,1
santa clara,0,0,0,0,1,0,0,1
santa clarita,0,0,0,0,1,0,0,1
santa rosa,0,0,0,0,1,0,0,1
santa susana,0,0,1,0,0,0,0,1
santa ynez,0,0,0,1,0,0,0,1
santee river,0,1,0,0,0,0,0,1
santiago getty,0,0,0,0,0,0,1,1
sao paulo,1,0,0,0,0,0,0,1
sara aniano,0,0,0,0,0,1,0,1
sarah carlson,0,1,0,0,0,0,0,1
sarah huckabee,0,0,0,0,0,0,1,1
sarah kapnick,0,1,0,0,0,0,0,1
sarah porter,0,0,0,0,1,0,0,1
sarah wright,0,0,0,0,1,0,0,1
sargassum belt,0,0,0,0,0,1,0,1
satellite based,1,0,0,0,0,0,0,1
satellite beach,1,0,0,0,0,0,0,1
satellite image,0,0,0,0,0,1,0,1
satellite imagery,1,0,0,0,0,0,0,1
satellite measurements,0,0,0,1,0,0,0,1
satellite readings,0,0,0,1,0,0,0,1
satterwhite explained,0,0,0,1,0,0,0,1
saturated ground,0,0,0,1,0,0,0,1
saturated soils,0,0,0,1,0,0,0,1
saturday adrian,0,0,0,0,0,0,1,1
saturday chris,0,0,0,0,0,0,1,1
saturday citing,1,0,0,0,0,0,0,1
saturday eddie,1,0,0,0,0,0,0,1
saturday evening,0,0,0,1,0,0,0,1
saturday joined,0,0,0,1,0,0,0,1
saturday joseph,0,0,0,0,1,0,0,1
saturday milan,0,1,0,0,0,0,0,1
saturday patrick,0,0,0,0,0,0,1,1
saturday salvatore,0,1,0,0,0,0,0,1
saturday sean,0,0,0,1,0,0,0,1
saturday steve,1,0,0,0,0,0,0,1
saturday stuff,1,0,0,0,0,0,0,1
saturday swelling,0,0,0,0,1,0,0,1
saturday tobogganing,0,0,0,0,1,0,0,1
sauce insects,0,0,0,0,0,1,0,1
saul loeb,1,0,0,0,0,0,0,1
savage conservative,0,0,0,0,0,1,0,1
save biodiversity,0,0,1,0,0,0,0,1
save californians,0,1,0,0,0,0,0,1
save carbon,1,0,0,0,0,0,0,1
save countless,0,0,0,0,1,0,0,1
save glaciers,0,1,0,0,0,0,0,1
save human,0,0,0,0,1,0,0,1
save potentially,0,1,0,0,0,0,0,1
save project,0,0,0,0,0,1,0,1
save property,0,0,1,0,0,0,0,1
save ratepayers,0,1,0,0,0,0,0,1
save species,0,0,0,0,0,0,1,1
save thousands,0,0,0,1,0,0,0,1
saving climate,0,0,0,0,0,1,0,1
saving energy,0,0,0,0,0,0,1,1
saving package,1,0,0,0,0,0,0,1
saving water,0,0,0,0,0,1,0,1
scaffolding amidst,0,1,0,0,0,0,0,1
scaffolding circling,0,0,0,1,0,0,0,1
scale authorities,0,1,0,0,0,0,0,1
scale battery,0,0,0,0,0,1,0,1
scale brian,0,0,1,0,0,0,0,1
scale climate,0,0,0,0,1,0,0,1
scale corn,1,0,0,0,0,0,0,1
scale cross,1,0,0,0,0,0,0,1
scale disaster,0,0,0,1,0,0,0,1
scale electricity,0,0,0,1,0,0,0,1
scale events,0,0,0,0,0,1,0,1
scale internal,1,0,0,0,0,0,0,1
scale invasion,0,0,1,0,0,0,0,1
scale mining,0,0,0,0,1,0,0,1
scale schorsch,0,0,1,0,0,0,0,1
scale solar,0,0,0,1,0,0,0,1
scale synoptic,0,0,0,0,0,0,1,1
scale transformation,0,0,0,1,0,0,0,1
scale water,0,0,0,0,0,1,0,1
scan terrain,0,0,1,0,0,0,0,1
scandals matrix,0,0,1,0,0,0,0,1
scandinavian homes,0,0,0,0,0,0,1,1
scar regions,0,0,0,1,0,0,0,1
scarce presence,0,1,0,0,0,0,0,1
scarcity called,0,0,0,1,0,0,0,1
scarcity unprecedented,0,0,0,0,0,1,0,1
scared people,0,0,0,1,0,0,0,1
scares people,0,0,0,0,1,0,0,1
scary costume,1,0,0,0,0,0,0,1
scatec asa,0,1,0,0,0,0,0,1
scathing letter,0,0,0,0,0,1,0,1
scattered bursts,0,0,0,0,1,0,0,1
scavenge anjali,0,0,0,0,1,0,0,1
scavenge walaa,0,0,0,0,1,0,0,1
scenario avoiding,0,0,0,1,0,0,0,1
scenario forecasts,1,0,0,0,0,0,0,1
scenes featuring,0,0,1,0,0,0,0,1
scenes lobbying,0,0,0,0,0,0,1,1
scenes role,0,0,1,0,0,0,0,1
scenes updates,1,0,0,0,0,0,0,1
schedule boats,1,0,0,0,0,0,0,1
schleussner maintain,0,0,0,1,0,0,0,1
schmidt afp,0,1,0,0,0,0,0,1
schmidt lawrence,0,0,0,0,1,0,0,1
schmidt lead,0,0,0,0,1,0,0,1
schmitz joining,0,0,0,0,0,1,0,1
schmitz joins,0,0,0,0,0,1,0,1
scholars worry,0,0,0,1,0,0,0,1
scholz's governing,0,0,1,0,0,0,0,1
school asphalt,0,0,0,1,0,0,0,1
school bus,0,0,0,0,0,0,1,1
school crime,1,0,0,0,0,0,0,1
school dry,0,1,0,0,0,0,0,1
school fees,0,0,0,0,1,0,0,1
school j.h.s,0,0,0,1,0,0,0,1
school lessons,0,0,0,0,1,0,0,1
school library,0,1,0,0,0,0,0,1
school ordinarily,0,0,0,0,0,1,0,1
school parking,0,0,0,1,0,0,0,1
school policy,0,1,0,0,0,0,0,1
school ryan,0,1,0,0,0,0,0,1
school science,0,1,0,0,0,0,0,1
school shooting,0,0,0,0,0,0,1,1
school strike,0,0,0,0,1,0,0,1
school surrounded,0,1,0,0,0,0,0,1
school thunberg,0,0,0,0,1,0,0,1
school walaa,0,0,0,0,1,0,0,1
school walk,0,0,0,1,0,0,0,1
school's precious,0,1,0,0,0,0,0,1
school's roof,0,0,0,0,0,0,1,1
schools police,1,0,0,0,0,0,0,1
schorsch acknowledges,0,0,1,0,0,0,0,1
schorsch allison,0,0,1,0,0,0,0,1
schorsch calls,0,0,1,0,0,0,0,1
schorsch directed,0,0,1,0,0,0,0,1
schorsch rejects,0,0,1,0,0,0,0,1
schwab announced,0,0,0,0,0,1,0,1
schwing visited,0,0,1,0,0,0,0,1
science adviser,0,0,0,0,1,0,0,1
science based,0,1,0,0,0,0,0,1
science carlyn,0,0,0,0,0,1,0,1
science class,0,1,0,0,0,0,0,1
science correspondent,0,0,0,0,0,1,0,1
science department,0,0,0,0,1,0,0,1
science director,1,0,0,0,0,0,0,1
science foundation,0,0,0,0,1,0,0,1
science geekery,0,0,0,0,0,1,0,1
science inside,0,0,0,1,0,0,0,1
science linking,0,1,0,0,0,0,0,1
science mariotti,0,0,0,0,0,1,0,1
science marks,0,0,1,0,0,0,0,1
science naomi,0,0,0,0,1,0,0,1
science podcast,1,0,0,0,0,0,0,1
science question,0,0,0,1,0,0,0,1
science report,0,0,0,0,0,1,0,1
science reviews,1,0,0,0,0,0,0,1
science series,0,0,0,1,0,0,0,1
science stories,0,0,0,0,0,1,0,1
science supports,0,0,0,1,0,0,0,1
science underpinning,0,0,0,1,0,0,0,1
sciencelast week,0,0,0,0,0,1,0,1
sciences hide,1,0,0,0,0,0,0,1
sciences hopes,0,0,0,0,0,1,0,1
sciences reignites,0,0,0,1,0,0,0,1
scientific adviser,0,1,0,0,0,0,0,1
scientific affairs,0,0,0,0,1,0,0,1
scientific articles,0,0,0,0,0,0,1,1
scientific community,0,0,0,1,0,0,0,1
scientific foundation,0,0,0,0,0,1,0,1
scientific knowledge,0,0,1,0,0,0,0,1
scientific report,0,0,0,0,1,0,0,1
scientific research,0,1,0,0,0,0,0,1
scientific studies,0,0,0,1,0,0,0,1
scientist britney,0,0,0,0,1,0,0,1
scientist dana,0,1,0,0,0,0,0,1
scientist daniel,0,0,0,0,0,0,1,1
scientist enric,0,1,0,0,0,0,0,1
scientist focused,0,0,0,1,0,0,0,1
scientist jen,1,0,0,0,0,0,0,1
scientist jennifer,0,0,0,1,0,0,0,1
scientist keith,0,1,0,0,0,0,0,1
scientist natalie,0,0,0,1,0,0,0,1
scientist paul,0,0,0,0,0,1,0,1
scientist robert,1,0,0,0,0,0,0,1
scientist vitor,0,1,0,0,0,0,0,1
scientists call,0,0,0,0,0,1,0,1
scientists caution,0,0,0,1,0,0,0,1
scientists crowd,0,0,0,1,0,0,0,1
scientists descend,0,1,0,0,0,0,0,1
scientists estimate,0,1,0,0,0,0,0,1
scientists expected,0,1,0,0,0,0,0,1
scientists found,0,0,0,1,0,0,0,1
scientists historians,0,0,0,0,1,0,0,1
scientists reported,0,1,0,0,0,0,0,1
scientists scurried,0,0,0,0,0,1,0,1
scientists separately,0,1,0,0,0,0,0,1
scientists traditionally,1,0,0,0,0,0,0,1
scientists valeti,0,1,0,0,0,0,0,1
scientists weighed,0,1,0,0,0,0,0,1
scientists worry,0,1,0,0,0,0,0,1
scintillating screen,0,0,1,0,0,0,0,1
scoop birdseed,0,1,0,0,0,0,0,1
scored lower,0,0,0,0,1,0,0,1
scorpions gayle,1,0,0,0,0,0,0,1
scorpions scorpions,1,0,0,0,0,0,0,1
scott aide,0,0,1,0,0,0,0,1
scott called,1,0,0,0,0,0,0,1
scott cindy,0,0,0,1,0,0,0,1
scott dr,0,0,0,1,0,0,0,1
scott hikari's,0,0,0,1,0,0,0,1
scott musgrove,0,1,0,0,0,0,0,1
scott nathan,0,1,0,0,0,0,0,1
scott scientist,0,0,0,0,0,1,0,1
scott selma,0,0,0,1,0,0,0,1
scott's campaign,1,0,0,0,0,0,0,1
scottsdale cut,0,0,0,0,1,0,0,1
scottsdale john,0,0,0,0,1,0,0,1
scottsdale recently,0,0,0,0,1,0,0,1
screen time,0,0,1,0,0,0,0,1
screen window,1,0,0,0,0,0,0,1
scribbled sheets,0,0,0,1,0,0,0,1
scripted media,0,0,1,0,0,0,0,1
scripted television,0,0,0,0,0,0,1,1
scripts written,0,0,1,0,0,0,0,1
scrutinized vegetation,0,0,0,0,0,1,0,1
sculpt ice,0,1,0,0,0,0,0,1
sculptor timo,0,1,0,0,0,0,0,1
sculpture dorothy,0,1,0,0,0,0,0,1
sea anemones,0,0,0,0,1,0,0,1
sea blast,0,0,0,0,0,1,0,1
sea closing,0,0,0,0,0,1,0,1
sea communities,0,0,1,0,0,0,0,1
sea fishing,0,0,0,0,1,0,0,1
sea floor,0,0,0,0,0,0,1,1
sea hogan,1,0,0,0,0,0,0,1
sea issues,1,0,0,0,0,0,0,1
sea meet,0,0,0,0,1,0,0,1
sea melilla,0,1,0,0,0,0,0,1
sea mining,0,0,0,0,1,0,0,1
sea researcher,0,1,0,0,0,0,0,1
sea scientists,0,0,0,0,1,0,0,1
sea surface,0,0,0,0,0,1,0,1
sea wall,0,1,0,0,0,0,0,1
sea walls,0,1,0,0,0,0,0,1
sea yeah,0,0,0,1,0,0,0,1
sea.the european,0,1,0,0,0,0,0,1
sea's main,0,1,0,0,0,0,0,1
sea's receding,0,1,0,0,0,0,0,1
seal hunting,0,0,1,0,0,0,0,1
seals polar,0,0,0,0,0,1,0,1
seals resting,0,1,0,0,0,0,0,1
sean gladwell,0,0,0,0,1,0,0,1
sean hannity,0,0,0,1,0,0,0,1
sean kilpatrick,0,0,1,0,0,0,0,1
sean o'donnell,0,0,0,0,0,0,1,1
sean waugh,1,0,0,0,0,0,0,1
search teams,0,1,0,0,0,0,0,1
seas heavy,0,1,0,0,0,0,0,1
seas national,0,1,0,0,0,0,0,1
season continues,0,0,1,0,0,0,0,1
season greg,0,1,0,0,0,0,0,1
season increases,0,0,0,1,0,0,0,1
season runs,0,1,0,0,0,0,0,1
season tuesday,0,0,1,0,0,0,0,1
seasonal change,0,0,1,0,0,0,0,1
seasonal clash,0,0,0,0,0,0,1,1
seasonal cycle,0,0,0,0,0,1,0,1
seasonal rains,0,0,0,0,0,1,0,1
seasonal unfettered,0,1,0,0,0,0,0,1
seat leaned,0,1,0,0,0,0,0,1
seattle begins,0,0,0,0,1,0,0,1
seawallsor safeguarding,0,0,1,0,0,0,0,1
secluded ranch,0,0,0,0,1,0,0,1
secondary coursework,0,0,0,0,1,0,0,1
secret cia,0,0,0,0,1,0,0,1
secret research,0,0,0,0,0,0,1,1
secretary alejandro,0,1,0,0,0,0,0,1
secretary overseeing,1,0,0,0,0,0,0,1
secretary therese,0,0,0,1,0,0,0,1
secretions organs,0,0,0,0,0,1,0,1
secretly driven,0,0,1,0,0,0,0,1
secretly engaging,0,0,1,0,0,0,0,1
sector accounts,0,0,0,0,0,1,0,1
sector based,0,1,0,0,0,0,0,1
sector canadian,0,0,0,0,0,1,0,1
sector continues,0,0,0,0,0,1,0,1
sector decline,0,0,0,0,0,1,0,1
sector earlier,0,0,0,0,0,1,0,1
sector guilanpour,0,1,0,0,0,0,0,1
sector mehdi,0,0,0,0,0,1,0,1
sector plays,0,0,0,0,0,1,0,1
sectors due,0,0,0,0,1,0,0,1
sectors water,0,0,0,0,0,1,0,1
secure clean,0,0,0,0,0,1,0,1
secure food,0,1,0,0,0,0,0,1
secure larger,0,1,0,0,0,0,0,1
secure shelter,0,1,0,0,0,0,0,1
securing commitments,0,1,0,0,0,0,0,1
securing potential,1,0,0,0,0,0,0,1
securities fraud,0,0,0,1,0,0,0,1
security assurances,0,0,0,0,1,0,0,1
security benefits,0,0,0,0,0,1,0,1
security experts,0,0,0,0,0,1,0,1
security program,0,0,0,0,0,1,0,1
security secretary,0,1,0,0,0,0,0,1
security specialist,0,0,0,1,0,0,0,1
seed fuel,0,1,0,0,0,0,0,1
seek secure,0,1,0,0,0,0,0,1
seeking asylum,0,0,1,0,0,0,0,1
seeking refuge,0,0,0,0,1,0,0,1
seeks solutions,0,0,0,0,0,1,0,1
seemingly forever,0,0,0,0,1,0,0,1
segments featuring,0,0,0,1,0,0,0,1
seifert pumpkins,0,1,0,0,0,0,0,1
seifert started,0,1,0,0,0,0,0,1
seismic reflection,1,0,0,0,0,0,0,1
sejal choksi,0,0,0,1,0,0,0,1
sekera visiting,0,0,0,0,1,0,0,1
selected ontario,0,0,0,0,0,1,0,1
sell cell,0,1,0,0,0,0,0,1
sell cultivated,0,1,0,0,0,0,0,1
sell power,0,0,0,0,1,0,0,1
sell real,1,0,0,0,0,0,0,1
selling carbon,0,1,0,0,0,0,0,1
selling cattle,0,0,0,0,1,0,0,1
selling dairy,0,1,0,0,0,0,0,1
selling food,1,0,0,0,0,0,0,1
selma holds,0,0,0,1,0,0,0,1
selma pray,0,0,0,1,0,0,0,1
seminole county,0,1,0,0,0,0,0,1
seminole county's,0,1,0,0,0,0,0,1
sen bob,1,0,0,0,0,0,0,1
sen dan,0,0,0,0,0,1,0,1
sen elizabeth,1,0,0,0,0,0,0,1
sen thom,0,1,0,0,0,0,0,1
senate committee,0,1,0,0,0,0,0,1
senate conservation,0,0,1,0,0,0,0,1
senate energy,0,1,0,0,0,0,0,1
senate leadership,0,0,0,0,1,0,0,1
senator elizabeth,0,0,0,0,0,1,0,1
senator john,0,1,0,0,0,0,0,1
senator michael,0,0,0,0,0,0,1,1
senator scott,0,0,1,0,0,0,0,1
senators sinema,0,1,0,0,0,0,0,1
send fewer,0,0,0,0,1,0,0,1
send leopard,0,0,0,1,0,0,0,1
send love,0,0,0,1,0,0,0,1
send offensive,0,0,0,1,0,0,0,1
send western,0,0,0,1,0,0,0,1
sending debris,0,0,0,0,0,1,0,1
sending enormous,0,1,0,0,0,0,0,1
sending germany,0,0,0,1,0,0,0,1
sending massive,0,1,0,0,0,0,0,1
sending people,0,1,0,0,0,0,0,1
sending prices,1,0,0,0,0,0,0,1
sending rapists,1,0,0,0,0,0,0,1
seneca falls,0,0,0,0,0,1,0,1
senegal feel,0,1,0,0,0,0,0,1
senegal john,1,0,0,0,0,0,0,1
senegal rising,0,1,0,0,0,0,0,1
senegal river,0,0,0,0,1,0,0,1
senegal's main,1,0,0,0,0,0,0,1
senegalese expression,1,0,0,0,0,0,0,1
senior adviser,0,0,0,0,1,0,0,1
senior advocate,0,0,1,0,0,0,0,1
senior analyst,0,0,0,0,0,1,0,1
senior center,0,0,0,1,0,0,0,1
senior climate,0,0,0,1,0,0,0,1
senior defense,0,0,0,0,1,0,0,1
senior director,0,0,0,0,1,0,0,1
senior manager,0,0,0,0,1,0,0,1
senior official,1,0,0,0,0,0,0,1
senior pentagon,0,1,0,0,0,0,0,1
senior plastic,1,0,0,0,0,0,0,1
senior producer,0,0,1,0,0,0,0,1
senior research,0,0,0,1,0,0,0,1
senior supervising,0,1,0,0,0,0,0,1
senior vice,0,0,0,0,1,0,0,1
senior white,0,0,0,0,0,1,0,1
senna afp,1,0,0,0,0,0,0,1
sense anissa,0,0,0,0,1,0,0,1
sense champenois,0,0,0,0,1,0,0,1
sense fits,0,0,0,1,0,0,0,1
sense forgive,0,0,1,0,0,0,0,1
sense ordinances,0,0,0,0,1,0,0,1
sense suharsono,0,0,0,0,1,0,0,1
sensitive matters,0,0,0,1,0,0,0,1
sensitive subject,0,0,0,1,0,0,0,1
sentence watch,0,1,0,0,0,0,0,1
sentinal tribune,0,1,0,0,0,0,0,1
separate data,1,0,0,0,0,0,0,1
separate investigation,0,0,0,1,0,0,0,1
separate report,0,1,0,0,0,0,0,1
separate scheme,0,0,0,1,0,0,0,1
separate worlds,0,1,0,0,0,0,0,1
separately defend,0,0,1,0,0,0,0,1
separately environmental,0,0,0,1,0,0,0,1
separatist guerrillas,1,0,0,0,0,0,0,1
september hurricane,0,0,0,1,0,0,0,1
september rodríguez,0,1,0,0,0,0,0,1
sequential storms,0,0,0,0,1,0,0,1
sequoia ponderosa,0,0,0,0,0,1,0,1
series creator,0,0,0,0,0,0,1,1
series depicts,0,0,0,0,0,0,1,1
series finding,0,0,0,1,0,0,0,1
series yeah,1,0,0,0,0,0,0,1
serrato explain,0,0,0,0,0,1,0,1
servants line,0,0,1,0,0,0,0,1
serve upside's,0,1,0,0,0,0,0,1
served downtown,1,0,0,0,0,0,0,1
serves tomatoes,0,0,0,0,0,1,0,1
service burdens,1,0,0,0,0,0,0,1
service confirmed,0,0,0,0,0,0,1,1
service controlled,1,0,0,0,0,0,0,1
service director,1,0,0,0,0,0,0,1
service forecast,0,0,0,0,1,0,0,1
service forecasters,0,0,0,1,0,0,0,1
service hide,0,0,1,0,0,0,0,1
service interruptions,1,0,0,0,0,0,0,1
service issued,0,0,0,1,0,0,0,1
service juana,0,0,0,1,0,0,0,1
service listed,0,0,0,0,0,1,0,1
service meteosuisse,0,0,0,1,0,0,0,1
service office,0,0,0,0,1,0,0,1
service officials,0,0,0,0,1,0,0,1
service spokesperson,0,0,0,0,1,0,0,1
service told,0,0,1,0,0,0,0,1
service warned,0,0,0,1,0,0,0,1
service's satellite,0,0,0,1,0,0,0,1
service's study,0,0,1,0,0,0,0,1
services company,0,0,0,0,0,1,0,1
services damaged,0,0,0,0,0,1,0,1
services industry,0,0,0,1,0,0,0,1
services manufacturers,0,0,0,0,0,1,0,1
services reform,0,0,0,0,1,0,0,1
services sector,0,0,0,0,0,1,0,1
services workers,0,0,0,0,1,0,0,1
serving multiple,1,0,0,0,0,0,0,1
set ambitious,0,0,0,0,1,0,0,1
set daily,0,0,0,0,1,0,0,1
set foot,0,1,0,0,0,0,0,1
set fuel,1,0,0,0,0,0,0,1
set goals,0,0,1,0,0,0,0,1
set included,0,1,0,0,0,0,0,1
set schedule,1,0,0,0,0,0,0,1
set windows,0,0,0,0,0,0,1,1
setback lajas,0,1,0,0,0,0,0,1
setback moving,1,0,0,0,0,0,0,1
setbacks reduced,1,0,0,0,0,0,0,1
sets energy,0,0,1,0,0,0,0,1
sets goals,0,0,1,0,0,0,0,1
sets ground,0,0,0,0,0,1,0,1
setting ambitious,0,0,0,0,0,1,0,1
setting meeting,0,0,0,0,0,1,0,1
setting precipitation,0,0,0,0,1,0,0,1
settled viana's,0,0,0,1,0,0,0,1
seva 1st,0,0,0,0,1,0,0,1
seventh busiest,0,1,0,0,0,0,0,1
seventh flavio,0,0,0,0,0,1,0,1
seventh worst,0,0,1,0,0,0,0,1
severe communicating,0,1,0,0,0,0,0,1
severe flooding,0,0,0,0,0,0,1,1
severe floods,0,0,0,0,0,1,0,1
severe heat,0,1,0,0,0,0,0,1
severe hurricanes,0,1,0,0,0,0,0,1
severe including,0,0,0,0,0,1,0,1
severe post,0,0,0,0,1,0,0,1
severe shortage,1,0,0,0,0,0,0,1
severe symptoms,0,0,0,0,0,1,0,1
severe threat,0,0,0,1,0,0,0,1
severe warming,0,0,0,0,0,1,0,1
severe weight,0,0,0,0,0,1,0,1
severe wildfires,0,0,0,0,0,0,1,1
severe winter,0,0,0,0,0,1,0,1
severely impacted,0,0,1,0,0,0,0,1
severely restricted,0,0,1,0,0,0,0,1
sewer system,0,0,0,1,0,0,0,1
sewing machine,0,0,1,0,0,0,0,1
sexual orientation,0,0,0,0,1,0,0,1
seyma bayram,0,0,0,0,0,1,0,1
seymour senior,0,0,0,0,0,0,1,1
shack laughter,0,1,0,0,0,0,0,1
shade canopy,0,0,0,1,0,0,0,1
shade mohamed,0,0,0,1,0,0,0,1
shade slowing,0,0,0,0,0,1,0,1
shadow government,0,0,0,0,0,1,0,1
shady spots,0,0,0,1,0,0,0,1
shallow mangrove,1,0,0,0,0,0,0,1
shallow sea,0,0,0,0,0,1,0,1
shallow skiffs,1,0,0,0,0,0,0,1
shannon 1st,0,0,0,0,1,0,0,1
shannon dicus,0,0,0,0,0,1,0,1
shape climate,0,1,0,0,0,0,0,1
shape people's,0,0,0,0,0,1,0,1
shaped archipelagos,0,0,0,1,0,0,0,1
shaped asteroid,0,0,0,0,0,1,0,1
shaped dulcimer,0,1,0,0,0,0,0,1
shaped louisiana,0,1,0,0,0,0,0,1
shapeshifting conspiracy,0,0,0,0,0,1,0,1
shaping global,0,1,0,0,0,0,0,1
share information,0,0,0,0,1,0,0,1
share messages,0,0,1,0,0,0,0,1
shared capacity,0,1,0,0,0,0,0,1
shared materials,0,0,0,0,1,0,0,1
shared repeatedly,0,0,0,0,1,0,0,1
shared resource,0,0,0,0,0,1,0,1
shared scientific,0,0,0,0,0,1,0,1
shared understanding,0,0,0,0,0,1,0,1
shareholder countries,1,0,0,0,0,0,0,1
shareholder pressure,0,0,0,0,0,0,1,1
shares significant,0,1,0,0,0,0,0,1
sharif called,0,1,0,0,0,0,0,1
sharif prime,0,1,0,0,0,0,0,1
sharif told,0,1,0,0,0,0,0,1
sharp cuts,0,1,0,0,0,0,0,1
sharp increase,0,0,0,0,0,1,0,1
sharply critical,0,0,1,0,0,0,0,1
sharply reduce,0,1,0,0,0,0,0,1
shattering previous,1,0,0,0,0,0,0,1
shaw chief,0,0,1,0,0,0,0,1
shay dvoretzky,0,0,0,0,0,1,0,1
shay rabineau,0,1,0,0,0,0,0,1
shaye wolf,1,0,0,0,0,0,0,1
shearer apple,0,0,0,0,0,0,1,1
shearer laments,0,0,0,0,0,0,1,1
shed light,0,0,1,0,0,0,0,1
sheehan director,0,0,0,0,0,0,1,1
sheer scale,0,0,1,0,0,0,0,1
sheet melt,1,0,0,0,0,0,0,1
sheet melts,0,1,0,0,0,0,0,1
sheets decay,0,1,0,0,0,0,0,1
sheets experiencing,1,0,0,0,0,0,0,1
sheets remain,1,0,0,0,0,0,0,1
sheets researchers,1,0,0,0,0,0,0,1
shehzadi walks,1,0,0,0,0,0,0,1
sheikh daro,1,0,0,0,0,0,0,1
sheikh mohammed,0,0,0,1,0,0,0,1
sheikh reads,0,1,0,0,0,0,0,1
shelbie villalpando,0,1,0,0,0,0,0,1
shelf nicknamed,0,0,0,0,1,0,0,1
shell companies,0,0,1,0,0,0,0,1
shell dardar,1,0,0,0,0,0,0,1
shell market,0,0,0,0,0,0,1,1
shell recycling,1,0,0,0,0,0,0,1
shells fall,0,0,0,0,0,1,0,1
shelter communities,0,1,0,0,0,0,0,1
shelter created,0,1,0,0,0,0,0,1
shelter huq,0,0,0,0,0,1,0,1
shelter studies,0,0,0,0,1,0,0,1
shelter temporary,0,1,0,0,0,0,0,1
shelters firefighters,0,0,0,0,0,1,0,1
shelters including,0,0,0,0,1,0,0,1
shelters local,1,0,0,0,0,0,0,1
sheriff bill,0,0,0,0,0,0,1,1
sheriff shannon,0,0,0,0,0,1,0,1
sheriff william,0,0,0,0,0,1,0,1
sherlock joins,0,1,0,0,0,0,0,1
sherpa recently,0,1,0,0,0,0,0,1
sherry rehman,0,1,0,0,0,0,0,1
shield farmers,1,0,0,0,0,0,0,1
shift charlie,0,0,0,0,0,1,0,1
shift friday,0,0,0,1,0,0,0,1
shift investments,0,0,0,0,0,1,0,1
shifted slightly,0,1,0,0,0,0,0,1
shifting baselines,0,0,0,1,0,0,0,1
shifting patterns,0,0,0,0,0,0,1,1
shifting political,0,1,0,0,0,0,0,1
shifts involve,0,0,0,0,0,1,0,1
shimmering gray,0,0,0,0,1,0,0,1
shimmery critical,0,0,0,0,1,0,0,1
shinaasha pete,0,0,0,0,0,1,0,1
shinaasha tells,0,0,0,0,0,1,0,1
shiny brewery,0,1,0,0,0,0,0,1
shiny stainless,0,1,0,0,0,0,0,1
ship called,0,1,0,0,0,0,0,1
shipments including,0,1,0,0,0,0,0,1
shipper association,0,0,0,0,0,1,0,1
shipping container,0,0,0,1,0,0,0,1
shipping lane,0,1,0,0,0,0,0,1
shirtsleeve weather,0,0,0,1,0,0,0,1
shocking discoveries,0,0,1,0,0,0,0,1
shocking levels,0,0,0,1,0,0,0,1
shook latur,0,1,0,0,0,0,0,1
shooting ranges,0,1,0,0,0,0,0,1
shoppers kazuhiro,0,0,0,0,1,0,0,1
shoppers shop,0,0,0,0,1,0,0,1
shopping bags,1,0,0,0,0,0,0,1
shopping figures,0,0,0,0,1,0,0,1
shore hoping,1,0,0,0,0,0,0,1
shoreline kirk,0,0,0,0,1,0,0,1
shoreline stayed,1,0,0,0,0,0,0,1
short article,0,0,0,1,0,0,0,1
short duration,0,0,0,0,1,0,0,1
short film,0,1,0,0,0,0,0,1
short hike,1,0,0,0,0,0,0,1
short hours,1,0,0,0,0,0,0,1
short period,0,0,0,0,0,0,1,1
short periods,0,0,1,0,0,0,0,1
short story,0,0,0,0,0,1,0,1
short time,1,0,0,0,0,0,0,1
short trip,0,0,0,0,1,0,0,1
short walk,0,1,0,0,0,0,0,1
short warning,0,0,0,0,0,1,0,1
short windows,1,0,0,0,0,0,0,1
shortages investors,1,0,0,0,0,0,0,1
shortcomings howard,0,0,0,0,1,0,0,1
shorter time,0,0,0,1,0,0,0,1
shortfalls due,0,0,1,0,0,0,0,1
shot tillis,0,1,0,0,0,0,0,1
shot today's,1,0,0,0,0,0,0,1
shot told,0,0,1,0,0,0,0,1
shoukry controlled,0,0,0,1,0,0,0,1
shouted encouragement,1,0,0,0,0,0,0,1
shovel snow,0,0,0,1,0,0,0,1
show's sense,0,0,0,0,0,0,1,1
shown hotter,0,0,0,0,0,1,0,1
shredded leaves,1,0,0,0,0,0,0,1
shreveport louisiana,0,1,0,0,0,0,0,1
shrimp fishing,0,0,0,0,1,0,0,1
shrimping crabbing,1,0,0,0,0,0,0,1
shrinking quickly,0,1,0,0,0,0,0,1
shrinking waters,0,0,1,0,0,0,0,1
shryock reports,0,0,0,1,0,0,0,1
shutter chest,0,1,0,0,0,0,0,1
shuttle services,0,0,0,0,0,1,0,1
si wow.months,0,1,0,0,0,0,0,1
sic batteries,0,0,0,0,0,1,0,1
sick czajkowski,0,0,0,1,0,0,0,1
sided story,0,0,0,0,1,0,0,1
sidewalk cafe,0,1,0,0,0,0,0,1
siegler joining,0,0,0,0,1,0,0,1
siegler spoke,0,0,0,0,1,0,0,1
sierra juarez,0,0,1,0,0,0,0,1
sierra mountains,0,0,0,1,0,0,0,1
sierras avery,0,0,0,0,0,1,0,1
sight anytime,0,0,0,0,0,0,1,1
sight uneven,0,1,0,0,0,0,0,1
sightseeing boat,0,1,0,0,0,0,0,1
sign advertises,0,0,0,0,1,0,0,1
sign eat,0,0,0,0,0,1,0,1
sign pratt,0,0,1,0,0,0,0,1
signal transparency,0,1,0,0,0,0,0,1
signature lake,0,0,0,0,1,0,0,1
signature tall,1,0,0,0,0,0,0,1
signed petitions,0,1,0,0,0,0,0,1
significant additional,0,0,0,1,0,0,0,1
significant air,0,0,0,0,1,0,0,1
significant benefits,0,0,1,0,0,0,0,1
significant carbon,1,0,0,0,0,0,0,1
significant cutbacks,0,0,0,1,0,0,0,1
significant damage,0,0,0,1,0,0,0,1
significant danger,1,0,0,0,0,0,0,1
significant effort,0,0,1,0,0,0,0,1
significant energy,1,0,0,0,0,0,0,1
significant event,0,0,1,0,0,0,0,1
significant evidence,0,0,0,1,0,0,0,1
significant habitat,0,0,0,0,0,1,0,1
significant impact,0,0,0,0,1,0,0,1
significant issues,0,1,0,0,0,0,0,1
significant local,0,0,0,0,1,0,0,1
significant moments,0,1,0,0,0,0,0,1
significant proportion,1,0,0,0,0,0,0,1
significant pushback,0,1,0,0,0,0,0,1
significant role,0,0,0,1,0,0,0,1
significant step,0,0,0,0,0,1,0,1
significant tornadoes,0,0,0,0,0,1,0,1
significant weather,0,0,0,0,1,0,0,1
significantly cheaper,0,0,0,0,1,0,0,1
significantly contribute,0,0,0,0,0,1,0,1
significantly expand,1,0,0,0,0,0,0,1
significantly slash,0,0,0,0,0,0,1,1
significantly underreporting,0,1,0,0,0,0,0,1
significantly warmer,0,0,0,1,0,0,0,1
silagy wrote,0,0,1,0,0,0,0,1
silo risi,0,0,0,0,0,1,0,1
silvana flores,0,0,0,0,0,1,0,1
silver bullet,0,0,0,1,0,0,0,1
silver city,0,0,0,0,0,1,0,1
silver delivery,0,0,0,0,1,0,0,1
silver jacks,0,1,0,0,0,0,0,1
simi valley,0,0,0,1,0,0,0,1
similar accusation,0,0,0,0,0,1,0,1
similar baseless,0,0,0,0,1,0,0,1
similar bets,0,0,1,0,0,0,0,1
similar concerns,0,1,0,0,0,0,0,1
similar demonstrations,0,1,0,0,0,0,0,1
similar efforts,0,0,0,0,0,1,0,1
similar findings,0,0,0,1,0,0,0,1
similar framings,0,0,0,1,0,0,0,1
similar happen,0,0,0,1,0,0,0,1
similar lists,0,0,0,1,0,0,0,1
similar move,0,1,0,0,0,0,0,1
similar parallel,0,0,0,0,1,0,0,1
similar plot,0,0,0,0,0,1,0,1
similar projects,0,0,0,1,0,0,0,1
similar promises,0,1,0,0,0,0,0,1
similar proposals,1,0,0,0,0,0,0,1
similar rate,0,0,0,0,0,1,0,1
similar science,0,1,0,0,0,0,0,1
similar stories,1,0,0,0,0,0,0,1
similar story,0,0,0,0,0,1,0,1
similar study,0,0,0,0,0,0,1,1
similar success,0,1,0,0,0,0,0,1
similar weather,0,0,0,1,0,0,0,1
similar wording,0,0,0,0,0,1,0,1
similarly official,0,1,0,0,0,0,0,1
simon ingram,0,0,0,0,1,0,0,1
simon npr's,0,0,0,0,1,0,0,1
simon stiell,1,0,0,0,0,0,0,1
simple answer,0,1,0,0,0,0,0,1
simple electric,0,0,0,1,0,0,0,1
simple experimental,0,0,0,0,0,1,0,1
simple idea,1,0,0,0,0,0,0,1
simple question,1,0,0,0,0,0,0,1
simple sleeping,0,1,0,0,0,0,0,1
simply listeners,0,1,0,0,0,0,0,1
simply obvious,1,0,0,0,0,0,0,1
simply owning,0,0,0,1,0,0,0,1
simply pour,1,0,0,0,0,0,0,1
simply unjust,0,1,0,0,0,0,0,1
simply unprepared,0,0,0,0,1,0,0,1
simulated storms,0,0,0,0,0,1,0,1
simulation projects,0,0,0,0,0,1,0,1
sinarimbo told,1,0,0,0,0,0,0,1
sindh's provincial,1,0,0,0,0,0,0,1
singing rolling,0,1,0,0,0,0,0,1
singing yeah,0,1,0,0,0,0,0,1
single credit,0,1,0,0,0,0,0,1
single decade,0,0,0,1,0,0,0,1
single event,0,0,0,0,0,1,0,1
single family,0,1,0,0,0,0,0,1
single farmer,0,0,0,0,0,0,1,1
single farming,0,0,0,0,0,0,1,1
single highway,1,0,0,0,0,0,0,1
single month's,0,0,0,0,0,1,0,1
single party,1,0,0,0,0,0,0,1
single piece,0,1,0,0,0,0,0,1
single platform,0,0,0,0,0,1,0,1
single question,0,0,0,0,0,1,0,1
single scientist,0,1,0,0,0,0,0,1
single syrian,0,1,0,0,0,0,0,1
single vote,0,0,0,0,1,0,0,1
single weather,0,0,0,0,0,1,0,1
single wet,0,0,0,0,1,0,0,1
single word,0,0,0,1,0,0,0,1
singular focus,0,1,0,0,0,0,0,1
sink reusing,0,0,0,0,1,0,0,1
sinkhole closed,0,0,0,1,0,0,0,1
sinkhole dead,0,1,0,0,0,0,0,1
sinkhole swallowed,0,1,0,0,0,0,0,1
sinking land,0,0,0,0,1,0,0,1
sinking ship,1,0,0,0,0,0,0,1
sip coffee,0,1,0,0,0,0,0,1
sir david,0,1,0,0,0,0,0,1
sirens prompted,0,1,0,0,0,0,0,1
siri chilukuri,0,0,0,0,1,0,0,1
sisi taher,0,1,0,0,0,0,0,1
sissi giving,0,1,0,0,0,0,0,1
site apartment,0,1,0,0,0,0,0,1
site instrumentation,0,0,0,1,0,0,0,1
site thirteen,0,0,0,0,1,0,0,1
site warren,0,1,0,0,0,0,0,1
site yeah,0,0,0,0,0,0,1,1
site's relationship,0,0,1,0,0,0,0,1
sites arguing,0,1,0,0,0,0,0,1
sites connected,0,0,0,1,0,0,0,1
sites ebbed,0,0,1,0,0,0,0,1
sites include,0,0,1,0,0,0,0,1
sites separately,0,0,1,0,0,0,0,1
siting agreement,0,0,0,0,1,0,0,1
sitrang killed,0,0,0,0,0,1,0,1
sitting closest,0,0,0,0,0,1,0,1
situation local,1,0,0,0,0,0,0,1
situation misrepresenting,0,0,0,1,0,0,0,1
situation progresses,0,0,0,1,0,0,0,1
sixteen humpback,0,0,0,0,1,0,0,1
sixth automaker,0,0,0,0,0,1,0,1
size fits,0,1,0,0,0,0,0,1
size ice,0,1,0,0,0,0,0,1
sized businesses,0,1,0,0,0,0,0,1
sized glacier,0,0,0,0,1,0,0,1
skaggs patty,0,1,0,0,0,0,0,1
skating action,0,0,0,0,1,0,0,1
skating rink,0,0,0,0,1,0,0,1
skeptical public,0,0,0,0,1,0,0,1
sketchbooks buzz,0,1,0,0,0,0,0,1
ski resort,0,0,0,0,1,0,0,1
ski resorts,0,0,0,0,1,0,0,1
skies clouded,0,0,0,0,0,1,0,1
skies looked,0,0,0,0,0,1,0,1
skiffs propelled,1,0,0,0,0,0,0,1
skin exposed,0,0,0,0,1,0,0,1
skinny robot,0,0,0,0,1,0,0,1
skip natural,0,1,0,0,0,0,0,1
skolstrejk för,0,0,0,0,1,0,0,1
sky cloud,0,0,0,0,0,1,0,1
sky filling,0,0,0,0,0,1,0,1
sky grew,0,0,0,0,0,1,0,1
skyler zunk,0,0,0,0,1,0,0,1
skypark paul,0,0,0,0,0,1,0,1
slack aims,0,0,0,1,0,0,0,1
slack combines,0,0,0,1,0,0,0,1
slack measuring,0,0,0,1,0,0,0,1
slack reminds,0,0,0,1,0,0,0,1
slack tells,0,0,0,1,0,0,0,1
slack's desk,0,0,0,1,0,0,0,1
slang term,0,0,0,0,0,1,0,1
slash carbon,1,0,0,0,0,0,0,1
slash greenhouse,0,0,0,0,0,1,0,1
slash planet,0,0,0,0,0,0,1,1
slashing emissions,0,1,0,0,0,0,0,1
slashing greenhouse,0,0,0,1,0,0,0,1
slashing u.s,0,1,0,0,0,0,0,1
slaughterhouses valeti,0,1,0,0,0,0,0,1
slaughtering animals,0,1,0,0,0,0,0,1
slavica getty,0,0,1,0,0,0,0,1
sleek understated,0,1,0,0,0,0,0,1
sleeping bags,0,0,0,0,1,0,0,1
sleeping pallet,0,1,0,0,0,0,0,1
sleeve taylor,1,0,0,0,0,0,0,1
slick layer,0,0,0,0,1,0,0,1
slides razed,0,0,0,0,1,0,0,1
slides worsened,0,0,0,1,0,0,0,1
slight decrease,1,0,0,0,0,0,0,1
slightly north,0,1,0,0,0,0,0,1
slightly read,0,1,0,0,0,0,0,1
slightly tomorrow,0,0,0,0,1,0,0,1
slim summary,0,0,0,0,0,1,0,1
sloan checked,0,0,1,0,0,0,0,1
slope conocophillips,0,0,0,0,0,1,0,1
slope leaders,0,0,0,0,0,1,0,1
slope set,0,0,0,0,0,1,0,1
slow change,0,0,0,0,1,0,0,1
slow global,0,0,0,1,0,0,0,1
slow nature,0,0,1,0,0,0,0,1
slower change,0,0,0,0,1,0,0,1
slower growth,0,1,0,0,0,0,0,1
slowing glacial,0,0,0,0,0,1,0,1
slowly begun,1,0,0,0,0,0,0,1
slowly carved,0,0,0,0,1,0,0,1
slowly gossiping,0,0,0,1,0,0,0,1
slowly growing,0,1,0,0,0,0,0,1
slowly migrating,0,0,0,0,1,0,0,1
slurry holds,1,0,0,0,0,0,0,1
smartphone push,0,0,0,0,0,1,0,1
smash pumpkins,0,1,0,0,0,0,0,1
smears attacks,0,0,1,0,0,0,0,1
smi taskforce,0,1,0,0,0,0,0,1
smialowski afp,0,1,0,0,0,0,0,1
smichael dantas,0,0,1,0,0,0,0,1
smiles sunnily,1,0,0,0,0,0,0,1
smith microsoft's,0,1,0,0,0,0,0,1
smith specifically,0,0,1,0,0,0,0,1
smithsonian joseph,0,0,0,0,0,1,0,1
smithsonian tropical,0,0,1,0,0,0,0,1
smithsonian's national,0,1,0,0,0,0,0,1
smog andasan,0,0,0,0,0,1,0,1
smoke blew,1,0,0,0,0,0,0,1
smoking meth,1,0,0,0,0,0,0,1
smoldering scene,0,0,1,0,0,0,0,1
smothers coral,0,0,0,0,0,1,0,1
sms bangladesh,0,0,0,0,0,1,0,1
sms fatima,0,0,0,0,0,1,0,1
sms text,0,0,0,0,0,1,0,1
smuggle human,0,0,0,0,1,0,0,1
smugglers.i spoke,0,1,0,0,0,0,0,1
snarky comments,0,1,0,0,0,0,0,1
snarling highway,1,0,0,0,0,0,0,1
sneakily difficult,0,1,0,0,0,0,0,1
sneha srivastava,0,1,0,0,0,0,0,1
sniffer dogs,1,0,0,0,0,0,0,1
sno cat,0,0,0,0,0,1,0,1
snow accumulating,0,0,0,0,1,0,0,1
snow adding,0,0,0,0,0,1,0,1
snow banks,0,0,0,1,0,0,0,1
snow bowl,0,0,0,0,1,0,0,1
snow buffalo,0,0,0,1,0,0,0,1
snow falls,0,0,0,0,1,0,0,1
snow fed,0,0,0,0,1,0,0,1
snow fell,0,0,0,0,1,0,0,1
snow field,0,1,0,0,0,0,0,1
snow impassable,0,0,0,0,0,1,0,1
snow laden,0,0,0,1,0,0,0,1
snow loss,0,0,0,1,0,0,0,1
snow meaning,0,0,0,0,1,0,0,1
snow meteorologists,0,0,0,0,1,0,0,1
snow oregon,0,0,0,0,1,0,0,1
snow piled,0,0,0,1,0,0,0,1
snow plow,0,0,0,1,0,0,0,1
snow plowing,0,0,0,1,0,0,0,1
snow plows,0,0,0,1,0,0,0,1
snow resembling,0,1,0,0,0,0,0,1
snow runoff,0,0,0,0,0,1,0,1
snow sculptors,0,1,0,0,0,0,0,1
snow sculpture,0,1,0,0,0,0,0,1
snow shovels,0,0,0,0,0,1,0,1
snow showers,0,0,0,0,1,0,0,1
snow spalding,0,0,0,0,0,0,1,1
snow sport,0,0,0,0,1,0,0,1
snow starts,0,0,0,1,0,0,0,1
snow storms,0,0,0,0,1,0,0,1
snow tornadoes,0,0,0,0,1,0,0,1
snow valley,0,0,0,0,1,0,0,1
snow whirls,0,0,0,0,1,0,0,1
snow winter,0,0,0,1,0,0,0,1
snow.martí yeah,0,0,0,0,0,1,0,1
snowball effect,0,1,0,0,0,0,0,1
snowed out.martí,0,0,0,0,1,0,0,1
snowfall event,0,0,0,0,1,0,0,1
snowfall humboldt,0,0,0,0,0,1,0,1
snowmass makes,0,0,0,1,0,0,0,1
snowpack data,0,0,0,1,0,0,0,1
snowpack statewide,0,0,0,0,1,0,0,1
snowpack udall,0,0,0,1,0,0,0,1
snowpiercer extrapolations,0,0,0,0,0,0,1,1
snowplow authorities,0,0,0,0,1,0,0,1
snowplow business,0,0,0,1,0,0,0,1
snowplow driver,0,0,0,1,0,0,0,1
snowstorm arrived,0,0,0,0,1,0,0,1
snowstorm melts,0,0,0,1,0,0,0,1
snowstorms happen,0,0,0,1,0,0,0,1
snowy storm,0,0,0,0,1,0,0,1
sobering trend,0,0,0,0,1,0,0,1
social connections,0,1,0,0,0,0,0,1
social costs,0,0,0,0,1,0,0,1
social democrat,0,0,0,1,0,0,0,1
social democratic,0,0,1,0,0,0,0,1
social gatherings,0,0,0,0,0,1,0,1
social issue,0,0,0,0,0,1,0,1
social lodge,1,0,0,0,0,0,0,1
social movements,0,0,0,0,1,0,0,1
social platforms,0,0,0,0,0,1,0,1
social science,0,0,0,0,0,1,0,1
social scientist,0,1,0,0,0,0,0,1
social services,0,0,0,0,1,0,0,1
social unit,0,0,0,0,1,0,0,1
social worker,1,0,0,0,0,0,0,1
socially tied,0,0,0,0,1,0,0,1
societal choices,0,0,0,1,0,0,0,1
societal conditions,0,0,1,0,0,0,0,1
societal fissures,0,0,0,1,0,0,0,1
society dilling,0,0,1,0,0,0,0,1
society npr,0,0,0,0,1,0,0,1
society predicts,0,0,0,0,0,1,0,1
socio economic,0,0,0,0,0,1,0,1
socioeconomic situations,0,0,0,0,1,0,0,1
sociology professor,0,0,1,0,0,0,0,1
socks sweaters,0,0,0,0,1,0,0,1
sofía gallisá,0,0,0,1,0,0,0,1
soft officials,1,0,0,0,0,0,0,1
softball coach,0,1,0,0,0,0,0,1
softball team,1,0,0,0,0,0,0,1
soil acts,0,0,0,1,0,0,0,1
soil beneath,0,0,1,0,0,0,0,1
soil conservation,0,0,0,0,0,1,0,1
soil day,0,0,1,0,0,0,0,1
soil degraded,0,0,1,0,0,0,0,1
soil dislodging,0,0,0,1,0,0,0,1
soil moisture,0,0,0,0,0,1,0,1
soil moving,0,0,0,1,0,0,0,1
soil releasing,0,1,0,0,0,0,0,1
soil scientist,0,0,1,0,0,0,0,1
soil susan,1,0,0,0,0,0,0,1
soil underneath,0,0,0,0,1,0,0,1
soil wraps,0,0,1,0,0,0,0,1
soils drying,0,0,0,1,0,0,0,1
solar analysts,0,0,0,0,1,0,0,1
solar appears,0,0,0,0,1,0,0,1
solar combined,0,0,0,1,0,0,0,1
solar connected,0,0,0,0,1,0,0,1
solar created,0,0,0,0,1,0,0,1
solar droz,0,0,0,0,1,0,0,1
solar electricity,0,1,0,0,0,0,0,1
solar generation,0,1,0,0,0,0,0,1
solar george,0,1,0,0,0,0,0,1
solar grew,0,0,0,0,1,0,0,1
solar industry,0,0,0,0,1,0,0,1
solar ordinance,0,0,0,0,1,0,0,1
solar paul,0,0,0,0,1,0,0,1
solar people,0,0,0,0,1,0,0,1
solar potential,0,0,0,0,1,0,0,1
solar received,0,0,0,0,1,0,0,1
solar requires,0,0,0,0,1,0,0,1
solar stokes,0,0,0,0,1,0,0,1
solar torchinsky,0,0,0,0,1,0,0,1
solar wind,0,0,0,1,0,0,0,1
soldiers set,1,0,0,0,0,0,0,1
solely responsible,0,0,0,1,0,0,0,1
soliciting public,0,0,0,1,0,0,0,1
solid foundations,0,0,0,1,0,0,0,1
solidarity pact,0,1,0,0,0,0,0,1
solitary survival,0,0,1,0,0,0,0,1
solomon found,0,0,0,0,1,0,0,1
solomon hsiang,0,0,0,0,0,1,0,1
solution julia,0,0,0,0,0,1,0,1
solution rainforests,0,0,0,0,0,0,1,1
solution versus,1,0,0,0,0,0,0,1
solutions immediately,0,0,0,0,1,0,0,1
solutions lges,0,0,0,0,0,1,0,1
solutions oriented,0,0,0,1,0,0,0,1
solutions president,0,0,0,0,1,0,0,1
solutions requires,0,0,1,0,0,0,0,1
solutions successfully,1,0,0,0,0,0,0,1
solve climate,0,1,0,0,0,0,0,1
solve environmental,0,0,0,0,0,0,1,1
somalia vaibhav,0,0,0,0,1,0,0,1
someday marry,0,1,0,0,0,0,0,1
sommer hang,0,0,0,0,0,1,0,1
sommer npr,0,0,0,0,0,1,0,1
sommer walks,0,0,0,1,0,0,0,1
somodevilla getty,0,0,0,0,0,1,0,1
son alex,0,0,0,0,0,0,1,1
son perkins,0,0,1,0,0,0,0,1
son told,0,0,0,0,0,0,1,1
song ryan,0,0,0,0,1,0,0,1
sonoma sacramento,0,0,0,1,0,0,0,1
sons tugged,0,1,0,0,0,0,0,1
sophisticated experimental,0,0,0,0,0,1,0,1
soquel village,0,0,0,1,0,0,0,1
sore throat,0,0,0,0,0,1,0,1
sorely mistaken,0,0,1,0,0,0,0,1
sorensen climate,0,1,0,0,0,0,0,1
sortation advanced,1,0,0,0,0,0,0,1
sothy afp,0,0,0,0,0,1,0,1
sought public,0,0,0,1,0,0,0,1
soul tours,0,0,0,1,0,0,0,1
souls shannon,0,0,0,0,1,0,0,1
sound equipment,0,1,0,0,0,0,0,1
sound georgia,0,1,0,0,0,0,0,1
sound waves,0,0,0,0,0,1,0,1
sounded cindy,0,0,0,1,0,0,0,1
sounded exciting,0,0,0,0,0,0,1,1
sounding philosophical,0,1,0,0,0,0,0,1
sounds familiar,0,0,0,0,0,0,1,1
sounds hunting,0,0,0,0,0,1,0,1
soup walked,0,0,0,0,1,0,0,1
source krill,1,0,0,0,0,0,0,1
source pollutant,0,0,0,0,1,0,0,1
source reduction,0,0,0,1,0,0,0,1
source vast,0,0,0,0,0,1,0,1
sources bottom,0,1,0,0,0,0,0,1
sources form,0,0,0,0,1,0,0,1
sources harbeck,0,0,0,1,0,0,0,1
sources including,0,0,0,1,0,0,0,1
sources offers,1,0,0,0,0,0,0,1
sources telling,1,0,0,0,0,0,0,1
sourcing battery,0,0,0,0,1,0,0,1
sourdough bread,0,1,0,0,0,0,0,1
south american,0,0,1,0,0,0,0,1
south asia,0,1,0,0,0,0,0,1
south band,0,1,0,0,0,0,0,1
south china,1,0,0,0,0,0,0,1
south dakota,0,0,0,0,1,0,0,1
south farmers,0,0,0,0,0,1,0,1
south fueled,0,0,0,0,0,1,0,1
south highway,0,0,0,0,1,0,0,1
south including,0,0,0,0,0,1,0,1
south korean,0,0,0,0,0,1,0,1
south lessens,0,0,0,0,1,0,0,1
south louisiana,1,0,0,0,0,0,0,1
south louisiana's,1,0,0,0,0,0,0,1
south philadelphia,1,0,0,0,0,0,0,1
south santee,0,1,0,0,0,0,0,1
south staff,0,0,0,1,0,0,0,1
south west,0,0,0,0,1,0,0,1
southeast alabama,0,0,1,0,0,0,0,1
southeast kentucky,0,1,0,0,0,0,0,1
southeast portland,0,0,0,0,1,0,0,1
southeast u.s,0,0,0,0,0,1,0,1
southeastern louisiana,0,1,0,0,0,0,0,1
southeastern oklahoma,0,1,0,0,0,0,0,1
southeastern u.s,0,0,1,0,0,0,0,1
southern announced,0,0,1,0,0,0,0,1
southern arizona,0,1,0,0,0,0,0,1
southern border,0,1,0,0,0,0,0,1
southern california.jake,0,0,0,0,1,0,0,1
southern community,1,0,0,0,0,0,0,1
southern india,0,1,0,0,0,0,0,1
southern kusiong,1,0,0,0,0,0,0,1
southern louisiana,0,0,0,0,1,0,0,1
southern mexico,1,0,0,0,0,0,0,1
southern missouri,0,0,0,0,0,1,0,1
southern nevada,0,0,0,0,1,0,0,1
southern oregon,1,0,0,0,0,0,0,1
southern pakistani,1,0,0,0,0,0,0,1
southern plains,0,0,0,0,0,1,0,1
southern province,1,0,0,0,0,0,0,1
southern region,0,0,0,0,0,1,0,1
southern set,0,0,1,0,0,0,0,1
southern spokesperson,0,0,1,0,0,0,0,1
southern tip,1,0,0,0,0,0,0,1
southern u.s,1,0,0,0,0,0,0,1
southern west,1,0,0,0,0,0,0,1
southern's ceo,0,0,1,0,0,0,0,1
southern's subsidiary,0,0,1,0,0,0,0,1
southern's walking,0,0,1,0,0,0,0,1
southernmost land,0,1,0,0,0,0,0,1
southwest airlines,0,0,1,0,0,0,0,1
southwest canceled,0,0,1,0,0,0,0,1
southwest delayed,0,0,1,0,0,0,0,1
southwest employees,0,0,1,0,0,0,0,1
southwest florida,1,0,0,0,0,0,0,1
southwest ironically,1,0,0,0,0,0,0,1
southwest oregon,0,0,1,0,0,0,0,1
southwest united,0,0,0,0,0,1,0,1
southwest's ceo,0,0,1,0,0,0,0,1
southwest's unacceptable,0,0,1,0,0,0,0,1
southwestern florida,0,1,0,0,0,0,0,1
sovereign wealth,0,0,0,1,0,0,0,1
soviet forces,0,0,0,1,0,0,0,1
soviet soldiers,0,0,0,1,0,0,0,1
sow pulses,0,1,0,0,0,0,0,1
sowed multiple,0,1,0,0,0,0,0,1
sowing seeds,0,1,0,0,0,0,0,1
soy cultivation,0,0,0,0,0,0,1,1
soy fields,1,0,0,0,0,0,0,1
soy sauce,0,0,0,0,0,1,0,1
soybean fields,0,0,1,0,0,0,0,1
space afp,0,0,0,0,0,1,0,1
space brian,0,1,0,0,0,0,0,1
space called,0,1,0,0,0,0,0,1
space heaters,0,0,0,1,0,0,0,1
space lined,0,0,0,0,0,1,0,1
space luckily,0,1,0,0,0,0,0,1
space providing,1,0,0,0,0,0,0,1
space station,1,0,0,0,0,0,0,1
spacecraft named,0,0,0,0,0,1,0,1
spaces tree,1,0,0,0,0,0,0,1
spain canada,0,0,0,0,0,1,0,1
spain geographically,0,1,0,0,0,0,0,1
spain.we're pulling,0,1,0,0,0,0,0,1
span national,0,1,0,0,0,0,0,1
spanish cities,0,1,0,0,0,0,0,1
spanish city.this,0,1,0,0,0,0,0,1
spanish european,0,1,0,0,0,0,0,1
spanish interior,0,1,0,0,0,0,0,1
spanish san,0,0,0,0,1,0,0,1
spanned roughly,0,0,0,0,0,1,0,1
spans thousands,0,1,0,0,0,0,0,1
spare change,0,0,1,0,0,0,0,1
spare climate,0,0,0,1,0,0,0,1
spark protests,0,0,0,0,0,1,0,1
sparking climate,1,0,0,0,0,0,0,1
sparking real,0,1,0,0,0,0,0,1
sparkling stars,0,0,0,0,1,0,0,1
sparse blades,0,0,0,1,0,0,0,1
sparse population,0,0,0,0,0,1,0,1
spawned possibly,0,0,0,0,0,0,1,1
spawned tornadoes,0,1,0,0,0,0,0,1
spawning supercells,0,0,0,0,0,1,0,1
speak english,0,0,0,0,1,0,0,1
speaker kevin,0,0,0,1,0,0,0,1
speaker running,1,0,0,0,0,0,0,1
speakers list,0,0,0,0,0,1,0,1
speaking babanki,0,0,0,1,0,0,0,1
speaking country,0,0,0,0,1,0,0,1
speaking nalik,0,0,0,1,0,0,0,1
speaking renewables,0,0,1,0,0,0,0,1
spear president,0,0,0,0,0,1,0,1
spearheading lobbying,0,0,1,0,0,0,0,1
special assistant,0,0,0,0,1,0,0,1
special concerns,0,0,0,1,0,0,0,1
special counsels,0,0,0,1,0,0,0,1
special funding,1,0,0,0,0,0,0,1
special genetics,0,0,1,0,0,0,0,1
special gravesite,0,0,0,1,0,0,0,1
special israeli,0,1,0,0,0,0,0,1
special prosecutor,0,0,0,1,0,0,0,1
special treat,1,0,0,0,0,0,0,1
specialist danny,0,0,1,0,0,0,0,1
specialist michael,0,0,0,0,0,1,0,1
specialists expected,0,0,1,0,0,0,0,1
specialists policy,0,0,0,0,1,0,0,1
species corals,0,1,0,0,0,0,0,1
species designation,1,0,0,0,0,0,0,1
species emperor,1,0,0,0,0,0,0,1
species meaning,0,0,0,0,0,1,0,1
species plants,0,0,1,0,0,0,0,1
species pratt,0,0,1,0,0,0,0,1
species preserving,0,0,1,0,0,0,0,1
species routinely,0,0,1,0,0,0,0,1
specific challenges,0,1,0,0,0,0,0,1
specific flood,0,1,0,0,0,0,0,1
specific goals,0,0,1,0,0,0,0,1
specific individuals,0,0,0,0,1,0,0,1
specific locations,0,1,0,0,0,0,0,1
specific marine,0,0,0,0,1,0,0,1
specific matrix,0,0,1,0,0,0,0,1
specific meaning,0,0,0,1,0,0,0,1
specific metals,0,0,0,1,0,0,0,1
specific policies,0,0,0,0,0,1,0,1
specific quandary,0,0,1,0,0,0,0,1
specific reforms,0,0,0,0,1,0,0,1
specific tent,1,0,0,0,0,0,0,1
specifically data,0,0,0,1,0,0,0,1
specifically highlighted,0,0,0,1,0,0,0,1
specifically oil,0,1,0,0,0,0,0,1
specifically tied,0,0,1,0,0,0,0,1
specificity lays,0,1,0,0,0,0,0,1
spectacle petrosova,0,0,1,0,0,0,0,1
spectacular valleys,1,0,0,0,0,0,0,1
spectrum corvette,0,0,0,0,1,0,0,1
spectrum ray,0,0,0,0,1,0,0,1
speech biden,0,1,0,0,0,0,0,1
speech thursday,0,1,0,0,0,0,0,1
speed ahead,0,1,0,0,0,0,0,1
speed climate,0,0,0,0,0,1,0,1
speed clutter,0,0,0,0,1,0,0,1
speed connectivity,1,0,0,0,0,0,0,1
spell disaster,0,0,0,0,0,1,0,1
spell unlike,0,0,1,0,0,0,0,1
spencer platt,0,0,0,0,1,0,0,1
spend approximately,0,0,0,0,1,0,0,1
spend effectively,0,0,1,0,0,0,0,1
spend millions,0,1,0,0,0,0,0,1
spending bill,0,0,0,1,0,0,0,1
spending chancellor,0,0,0,1,0,0,0,1
spending hundreds,0,1,0,0,0,0,0,1
spent billions,0,1,0,0,0,0,0,1
spent centuries,0,0,0,0,1,0,0,1
spent close,0,0,0,1,0,0,0,1
spent days,0,0,0,1,0,0,0,1
spent huge,0,1,0,0,0,0,0,1
spent millions,0,0,0,0,1,0,0,1
spent tens,0,0,1,0,0,0,0,1
spent time,0,0,0,0,1,0,0,1
sperm whales,0,0,0,0,0,1,0,1
spewing methane,1,0,0,0,0,0,0,1
spicer steps,0,0,0,1,0,0,0,1
spicer tosses,0,0,0,1,0,0,0,1
spiders slugs,1,0,0,0,0,0,0,1
spiegel represents,0,0,0,0,1,0,0,1
spinach speaking,0,0,0,0,0,1,0,1
spindly trees,0,0,0,1,0,0,0,1
spinrad administrator,0,1,0,0,0,0,0,1
spinrad recently,0,0,1,0,0,0,0,1
spiritual ceremonies,0,0,0,1,0,0,0,1
splintered trees,0,0,0,0,0,0,1,1
spodumene belt,0,1,0,0,0,0,0,1
spoiled groceries,0,0,0,0,1,0,0,1
spoke model,0,0,0,0,1,0,0,1
spoken jobe,0,0,1,0,0,0,0,1
spoken languages,0,0,0,1,0,0,0,1
spoken laughter,0,0,1,0,0,0,0,1
spoken miguel,0,1,0,0,0,0,0,1
spokesman mason,0,1,0,0,0,0,0,1
spokesman todd,0,0,0,1,0,0,0,1
spokesperson brian,0,0,0,0,1,0,0,1
spokesperson called,0,0,1,0,0,0,0,1
spokesperson confirmed,0,0,0,1,0,0,0,1
spokesperson olivia,1,0,0,0,0,0,0,1
spokesperson susan,0,0,0,0,1,0,0,1
spokesperson tells,0,0,0,0,0,0,1,1
spokesperson tim,0,0,0,0,0,0,1,1
spokesperson told,0,0,0,0,0,1,0,1
spokesperson wrote,0,1,0,0,0,0,0,1
sponge cities,0,0,0,0,1,0,0,1
sporadic hail,0,1,0,0,0,0,0,1
sporadic solar,0,1,0,0,0,0,0,1
sporadically updated,0,0,0,1,0,0,0,1
sport events,0,0,0,0,1,0,0,1
spot market,0,0,0,0,1,0,0,1
spot seals,0,0,1,0,0,0,0,1
spotify google,0,0,1,0,0,0,0,1
spotsylvania county,0,0,0,0,1,0,0,1
spotsylvania va,0,0,0,0,1,0,0,1
spr release,1,0,0,0,0,0,0,1
sprawling fields,0,0,0,1,0,0,0,1
sprawling golf,1,0,0,0,0,0,0,1
sprawling reports,0,0,0,0,0,1,0,1
sprawling west,0,0,0,0,1,0,0,1
spray painting,0,1,0,0,0,0,0,1
spraying insecticides,0,0,0,1,0,0,0,1
spread anti,0,0,0,0,1,0,0,1
spread delaplane,0,0,0,1,0,0,0,1
spread disease,0,1,0,0,0,0,0,1
spread flooding,0,1,0,0,0,0,0,1
spreading awareness,0,0,0,0,0,1,0,1
spreading misinformation,0,0,0,0,1,0,0,1
spreading ralston's,0,0,0,0,1,0,0,1
spreads easily,0,0,0,0,1,0,0,1
spring npr's,0,0,0,0,0,1,0,1
spring runoff,0,0,0,1,0,0,0,1
spring salads,0,0,0,0,0,1,0,1
spring time,0,0,0,0,0,1,0,1
spring tornados,0,1,0,0,0,0,0,1
spring weather,0,0,0,0,0,1,0,1
springbreak posts,0,0,0,0,0,1,0,1
springs colo,0,0,0,0,0,0,1,1
springs deputy,1,0,0,0,0,0,0,1
springtime boost,0,0,0,1,0,0,0,1
sprinkler irrigation,1,0,0,0,0,0,0,1
sprinkles gin,0,0,0,1,0,0,0,1
spritz water,0,0,0,1,0,0,0,1
spurring economic,0,1,0,0,0,0,0,1
spy balloon,0,0,0,0,1,0,0,1
spyboy al,0,1,0,0,0,0,0,1
square foot,0,1,0,0,0,0,0,1
square kilometers,0,1,0,0,0,0,0,1
square meter,0,0,0,1,0,0,0,1
square mile,0,0,0,0,1,0,0,1
square park,0,1,0,0,0,0,0,1
squarely focused,0,0,0,0,1,0,0,1
squash cutting,0,1,0,0,0,0,0,1
squash plants,0,0,0,0,0,1,0,1
squeeze billions,0,0,0,0,0,1,0,1
squirrel cousins,0,0,1,0,0,0,0,1
squirrelly critters,0,0,1,0,0,0,0,1
squishy sound,0,0,0,0,0,0,1,1
srivastava mint,0,1,0,0,0,0,0,1
srivastava npr,0,1,0,0,0,0,0,1
ssp director,0,1,0,0,0,0,0,1
ssp established,0,1,0,0,0,0,0,1
st peter's,0,1,0,0,0,0,0,1
stabilize glacial,1,0,0,0,0,0,0,1
stabilizing environments,0,1,0,0,0,0,0,1
stable condition,0,0,0,1,0,0,0,1
stable eastern,0,0,0,0,1,0,0,1
stable housing,0,0,0,0,1,0,0,1
stable thick,0,0,0,0,0,1,0,1
staff capacity,0,1,0,0,0,0,0,1
staff writer,0,0,0,1,0,0,0,1
staffs fiedler,0,0,1,0,0,0,0,1
staging similar,0,1,0,0,0,0,0,1
stagnating water,1,0,0,0,0,0,0,1
stakeholders grove,1,0,0,0,0,0,0,1
stalling conversations,0,1,0,0,0,0,0,1
standard bellamy,0,0,0,0,1,0,0,1
standard configuration,0,0,0,0,1,0,0,1
standardized definition,0,1,0,0,0,0,0,1
standards newsom's,0,0,0,0,0,1,0,1
standards set,1,0,0,0,0,0,0,1
standing demand,0,1,0,0,0,0,0,1
standpoint meaning,0,0,0,1,0,0,0,1
stands atop,0,1,0,0,0,0,0,1
stanford law,0,0,0,0,0,1,0,1
stanford university's,0,0,0,1,0,0,0,1
stanley robinson's,0,1,0,0,0,0,0,1
staple crop,1,0,0,0,0,0,0,1
stapleton ricky,0,1,0,0,0,0,0,1
stapleton told,0,1,0,0,0,0,0,1
star cold,0,0,0,0,0,0,1,1
stark divide,1,0,0,0,0,0,0,1
stark future,0,0,0,1,0,0,0,1
stark picture,0,0,0,0,0,1,0,1
stark reports,0,1,0,0,0,0,0,1
stark warnings,0,1,0,0,0,0,0,1
starlink satellites,1,0,0,0,0,0,0,1
starred restaurant,0,1,0,0,0,0,0,1
starring peter,0,1,0,0,0,0,0,1
stars dieye,0,0,0,0,1,0,0,1
start adding,1,0,0,0,0,0,0,1
start disclosing,0,0,0,0,1,0,0,1
start drawing,0,1,0,0,0,0,0,1
start falling,0,1,0,0,0,0,0,1
start farms,1,0,0,0,0,0,0,1
start feeling,0,0,0,0,0,0,1,1
start flying,0,0,0,0,1,0,0,1
start harvesting,0,0,0,0,0,1,0,1
start listening,0,1,0,0,0,0,0,1
start local,0,1,0,0,0,0,0,1
start planting,0,0,0,0,0,1,0,1
start preparing,0,0,1,0,0,0,0,1
start ramping,0,0,0,0,0,1,0,1
start selling,0,1,0,0,0,0,0,1
start sending,0,0,0,0,1,0,0,1
start speaking,0,0,0,0,1,0,0,1
start talking,0,0,0,0,1,0,0,1
start ups,0,1,0,0,0,0,0,1
started appearing,1,0,0,0,0,0,0,1
started businesses,0,0,0,1,0,0,0,1
started collapsing,1,0,0,0,0,0,0,1
started coming,0,0,0,0,1,0,0,1
started earlier,0,0,0,0,0,1,0,1
started exploiting,0,1,0,0,0,0,0,1
started hearing,0,1,0,0,0,0,0,1
started heating,1,0,0,0,0,0,0,1
started learning,0,1,0,0,0,0,0,1
started months,0,1,0,0,0,0,0,1
started overnight,1,0,0,0,0,0,0,1
started panicking,0,0,0,0,0,1,0,1
started phasing,0,0,1,0,0,0,0,1
started putting,1,0,0,0,0,0,0,1
started raindrops,1,0,0,0,0,0,0,1
started realizing,0,0,0,0,0,1,0,1
started removing,0,1,0,0,0,0,0,1
started shortly,0,0,0,0,1,0,0,1
started thinking,0,0,0,0,1,0,0,1
started upside,0,1,0,0,0,0,0,1
started venturing,0,1,0,0,0,0,0,1
started women,0,1,0,0,0,0,0,1
started wondering,1,0,0,0,0,0,0,1
started yesterday,0,0,0,0,0,1,0,1
starting saturday,1,0,0,0,0,0,0,1
starting sunday,0,1,0,0,0,0,0,1
starting thursday,0,0,0,0,1,0,0,1
starts beeping,0,0,0,1,0,0,0,1
starts producing,0,0,1,0,0,0,0,1
startups staking,0,1,0,0,0,0,0,1
state's air,0,1,0,0,0,0,0,1
state's airwaves,1,0,0,0,0,0,0,1
state's annual,1,0,0,0,0,0,0,1
state's capacity,0,1,0,0,0,0,0,1
state's carbon,1,0,0,0,0,0,0,1
state's chronic,0,0,0,0,0,1,0,1
state's climatologist,0,0,0,0,0,1,0,1
state's congressional,0,0,0,0,0,1,0,1
state's department,0,1,0,0,0,0,0,1
state's dependence,0,1,0,0,0,0,0,1
state's driest,0,0,0,1,0,0,0,1
state's economy,0,1,0,0,0,0,0,1
state's electric,0,0,0,0,1,0,0,1
state's grid,0,0,0,0,1,0,0,1
state's growth,1,0,0,0,0,0,0,1
state's history,0,0,0,0,0,1,0,1
state's land,1,0,0,0,0,0,0,1
state's mandate,0,1,0,0,0,0,0,1
state's oil,0,0,0,0,1,0,0,1
state's oyster,0,0,0,0,0,0,1,1
state's persistent,0,1,0,0,0,0,0,1
state's preparations,0,0,0,1,0,0,0,1
state's prolonged,0,0,0,1,0,0,0,1
state's recent,0,0,1,0,0,0,0,1
state's role,0,0,0,0,0,1,0,1
state's signature,0,0,0,0,1,0,0,1
state's southwestern,1,0,0,0,0,0,0,1
state's top,0,1,0,0,0,0,0,1
state's trees,0,0,1,0,0,0,0,1
state's zombie,0,0,0,0,0,1,0,1
stated strategy,0,1,0,0,0,0,0,1
stately trees,0,0,0,0,0,1,0,1
statement accompanying,0,0,0,1,0,0,0,1
statement beth,0,0,1,0,0,0,0,1
statement biden,0,0,0,0,0,0,1,1
statement calling,0,0,0,1,0,0,0,1
statement climate,1,0,0,0,0,0,0,1
statement critics,0,1,0,0,0,0,0,1
statement epa,0,0,0,0,0,0,1,1
statement faced,0,1,0,0,0,0,0,1
statement gov,0,0,0,0,0,1,0,1
statement indonesia,0,0,0,0,1,0,0,1
statement oil,0,0,0,0,0,1,0,1
statement praising,0,0,1,0,0,0,0,1
statement released,0,1,0,0,0,0,0,1
statement sharp,0,1,0,0,0,0,0,1
statements mourning,0,0,1,0,0,0,0,1
statements pyne,0,0,1,0,0,0,0,1
statewide agency,1,0,0,0,0,0,0,1
statewide growth,1,0,0,0,0,0,0,1
statewide scale,0,0,0,0,1,0,0,1
station atop,0,0,0,0,1,0,0,1
station designed,1,0,0,0,0,0,0,1
station kcrw's,0,0,0,0,0,1,0,1
station knkx,0,0,0,0,1,0,0,1
station ktoo,0,0,0,0,0,1,0,1
station kunm,1,0,0,0,0,0,0,1
station kuow,0,0,0,0,1,0,0,1
station kvcr,0,0,0,0,0,1,0,1
station lbc,0,0,0,1,0,0,0,1
station san,0,1,0,0,0,0,0,1
station vermont,0,0,0,1,0,0,0,1
station wabe,0,0,0,1,0,0,0,1
station wagon,1,0,0,0,0,0,0,1
station wbur,0,0,0,0,0,1,0,1
station wfpl,0,1,0,0,0,0,0,1
station wkno,0,1,0,0,0,0,0,1
station wnyc,0,0,0,0,1,0,0,1
station wunc,0,1,0,0,0,0,0,1
stations drilling,0,0,0,1,0,0,0,1
stations tilt,0,0,0,1,0,0,0,1
statistics reported,0,0,0,1,0,0,0,1
status quo,0,0,1,0,0,0,0,1
statute enacted,0,0,1,0,0,0,0,1
stay ahead,0,1,0,0,0,0,0,1
stay busy,0,1,0,0,0,0,0,1
stay music,0,0,1,0,0,0,0,1
stay niche,0,1,0,0,0,0,0,1
stay positive,0,0,0,0,0,1,0,1
stay quiet,0,1,0,0,0,0,0,1
stayed dry,1,0,0,0,0,0,0,1
staying safe,0,0,0,0,0,1,0,1
stays cooler,0,0,0,0,1,0,0,1
steadily accelerate,0,1,0,0,0,0,0,1
steadily increased,0,0,0,0,1,0,0,1
steady militarization,0,1,0,0,0,0,0,1
steady thump,1,0,0,0,0,0,0,1
steady winter,0,0,0,1,0,0,0,1
steam generation,1,0,0,0,0,0,0,1
steam loops,1,0,0,0,0,0,0,1
steam lube,1,0,0,0,0,0,0,1
steam travels,1,0,0,0,0,0,0,1
steel flood,0,1,0,0,0,0,0,1
steep absolute,0,1,0,0,0,0,0,1
steep cliffs,0,0,0,0,0,1,0,1
steep mountains,0,0,0,1,0,0,0,1
steep resistance,1,0,0,0,0,0,0,1
steep terrain,0,0,0,1,0,0,0,1
steep valley,0,1,0,0,0,0,0,1
stefania pelfini,0,1,0,0,0,0,0,1
stegner retired,0,0,0,0,1,0,0,1
steinbeck quote,0,0,0,0,0,1,0,1
stemmed cotton,0,0,0,1,0,0,0,1
step closer,0,1,0,0,0,0,0,1
step guide,0,1,0,0,0,0,0,1
stephen atkinson,0,0,1,0,0,0,0,1
stephen maturen,0,0,0,0,1,0,0,1
stephen myers,0,1,0,0,0,0,0,1
stephen russell,0,1,0,0,0,0,0,1
stepping backwards,0,1,0,0,0,0,0,1
steps forward,0,0,0,0,1,0,0,1
steps ryan,1,0,0,0,0,0,0,1
sterile plastic,1,0,0,0,0,0,0,1
sterilize equipment,1,0,0,0,0,0,0,1
steroids era,0,0,0,0,0,1,0,1
steve bannon's,0,0,0,0,0,1,0,1
steve bond,0,0,0,0,1,0,0,1
steve hyndside,0,0,0,1,0,0,0,1
steve inskeep,0,1,0,0,0,0,0,1
steve pyne,0,0,1,0,0,0,0,1
steve winter,0,0,1,0,0,0,0,1
steve yanoviak,0,0,1,0,0,0,0,1
steven husein,0,1,0,0,0,0,0,1
steven nadel,0,0,0,0,0,0,1,1
steven reached,0,1,0,0,0,0,0,1
steven's story,0,1,0,0,0,0,0,1
stewart remembers,1,0,0,0,0,0,0,1
stick water,0,0,0,0,0,1,0,1
sticky mud,0,0,0,0,0,1,0,1
sticky residue,0,0,0,1,0,0,0,1
sticky wings,1,0,0,0,0,0,0,1
stiles director,0,1,0,0,0,0,0,1
stink anymore,0,0,0,0,1,0,0,1
stitt declared,0,1,0,0,0,0,0,1
stock exchanges,0,1,0,0,0,0,0,1
stock market,0,0,0,0,1,0,0,1
stoic climate,0,0,0,0,1,0,0,1
stokes opposition,0,0,0,0,1,0,0,1
stoking outrage,0,0,0,1,0,0,0,1
stoltman hide,0,1,0,0,0,0,0,1
stomach sank,0,1,0,0,0,0,0,1
stone tile,0,1,0,0,0,0,0,1
stop abruptly,0,1,0,0,0,0,0,1
stop climate,0,1,0,0,0,0,0,1
stop deforestation,0,0,0,0,0,0,1,1
stop destroying,0,1,0,0,0,0,0,1
stop developing,0,0,0,0,1,0,0,1
stop drinking,0,0,0,1,0,0,0,1
stop flowing,0,0,0,0,1,0,0,1
stop giving,1,0,0,0,0,0,0,1
stop lawsuits,0,0,0,1,0,0,0,1
stop people,0,0,1,0,0,0,0,1
stop pretending,0,0,0,1,0,0,0,1
stop rising,0,0,0,0,0,0,1,1
stop route,0,0,0,1,0,0,0,1
stop routine,0,1,0,0,0,0,0,1
stop storm,0,0,0,0,1,0,0,1
stop talking,0,0,0,1,0,0,0,1
stop trashing,0,0,0,0,1,0,0,1
stop wednesday,0,1,0,0,0,0,0,1
stopped buying,0,1,0,0,0,0,0,1
stopped drinking,0,0,0,1,0,0,0,1
stopped eating,0,0,0,1,0,0,0,1
stopped florida,1,0,0,0,0,0,0,1
stopped producing,1,0,0,0,0,0,0,1
stopped short,0,0,0,0,0,1,0,1
stopping deforestation,0,0,0,0,0,0,1,1
stopping gas,0,0,0,0,1,0,0,1
stopping oil,0,0,0,0,0,1,0,1
stopping solar,0,0,0,0,1,0,0,1
storage applications,0,1,0,0,0,0,0,1
storage benefits,1,0,0,0,0,0,0,1
storage challenge,0,0,0,1,0,0,0,1
storage device,0,1,0,0,0,0,0,1
storage issue,0,0,0,1,0,0,0,1
storage medium,0,1,0,0,0,0,0,1
storage online,0,0,0,0,0,1,0,1
storage tanks,0,0,0,1,0,0,0,1
store climate,0,0,1,0,0,0,0,1
store doorstep,0,0,1,0,0,0,0,1
store food,0,0,0,0,1,0,0,1
store material,0,1,0,0,0,0,0,1
store's roof,0,0,0,0,0,1,0,1
stores earlier,0,1,0,0,0,0,0,1
storied music,0,1,0,0,0,0,0,1
stories anna,0,0,0,0,0,0,1,1
stories edited,0,0,0,0,0,0,1,1
stories set,0,0,1,0,0,0,0,1
stories starting,0,0,1,0,0,0,0,1
storing wind,1,0,0,0,0,0,0,1
storm arrives,0,0,0,0,1,0,0,1
storm barrier,1,0,0,0,0,0,0,1
storm blew,1,0,0,0,0,0,0,1
storm brought,0,0,0,1,0,0,0,1
storm capped,0,0,0,0,0,0,1,1
storm chasers,0,0,0,0,0,1,0,1
storm coming,0,0,0,1,0,0,0,1
storm conditions,0,1,0,0,0,0,0,1
storm deaths,1,0,0,0,0,0,0,1
storm delivering,1,0,0,0,0,0,0,1
storm destroyed,0,1,0,0,0,0,0,1
storm doug,0,0,0,0,0,0,1,1
storm dropped,0,0,0,0,1,0,0,1
storm dumped,0,0,0,0,1,0,0,1
storm engorged,1,0,0,0,0,0,0,1
storm eta,0,1,0,0,0,0,0,1
storm friday's,0,0,0,1,0,0,0,1
storm gathered,0,1,0,0,0,0,0,1
storm hey,0,0,0,1,0,0,0,1
storm including,1,0,0,0,0,0,0,1
storm killed,1,0,0,0,0,0,0,1
storm leaving,1,0,0,0,0,0,0,1
storm linguists,0,0,0,1,0,0,0,1
storm moves,0,0,0,0,1,0,0,1
storm nears,0,1,0,0,0,0,0,1
storm npr's,0,1,0,0,0,0,0,1
storm pattern,0,0,0,0,0,0,1,1
storm produced,0,1,0,0,0,0,0,1
storm rampaged,1,0,0,0,0,0,0,1
storm reached,0,0,0,0,0,1,0,1
storm resistant,0,1,0,0,0,0,0,1
storm response,0,0,0,0,0,1,0,1
storm ripped,0,1,0,0,0,0,0,1
storm saturday,0,0,0,0,0,0,1,1
storm season,0,0,0,0,0,0,1,1
storm sept,0,1,0,0,0,0,0,1
storm sequence,0,0,0,1,0,0,0,1
storm sequences,0,0,0,1,0,0,0,1
storm sewers,0,0,0,0,0,1,0,1
storm sounded,0,0,0,0,1,0,0,1
storm started,0,1,0,0,0,0,0,1
storm status,0,1,0,0,0,0,0,1
storm stretching,0,1,0,0,0,0,0,1
storm tapered,0,0,0,0,1,0,0,1
storm tennessee,0,0,0,0,0,0,1,1
storm thursday,0,1,0,0,0,0,0,1
storm toppled,0,0,0,1,0,0,0,1
storm tree,1,0,0,0,0,0,0,1
storm victims,1,0,0,0,0,0,0,1
storm warm,0,0,0,0,0,1,0,1
storm warning,0,1,0,0,0,0,0,1
storm warnings,0,1,0,0,0,0,0,1
storm watch,0,1,0,0,0,0,0,1
storm watches,0,1,0,0,0,0,0,1
storm watching,0,0,0,1,0,0,0,1
storm whipped,1,0,0,0,0,0,0,1
storm white,0,0,0,1,0,0,0,1
storm yeah,0,0,0,0,0,1,0,1
storm's intensification,0,1,0,0,0,0,0,1
storm's path,0,0,0,0,1,0,0,1
storm's surge,0,1,0,0,0,0,0,1
storm's track,0,1,0,0,0,0,0,1
stormier future,0,0,0,0,0,1,0,1
storms andrew,0,0,0,1,0,0,0,1
storms batter,1,0,0,0,0,0,0,1
storms battering,0,0,0,0,0,1,0,1
storms bringing,0,0,0,0,0,1,0,1
storms communities,0,0,0,1,0,0,0,1
storms compared,0,0,0,0,0,1,0,1
storms dip,0,0,0,1,0,0,0,1
storms displace,0,0,0,1,0,0,0,1
storms dropped,0,1,0,0,0,0,0,1
storms droughts,0,1,0,0,0,0,0,1
storms earlier,0,0,0,0,1,0,0,1
storms ensuring,1,0,0,0,0,0,0,1
storms evan,1,0,0,0,0,0,0,1
storms expected,0,0,0,1,0,0,0,1
storms flooding,0,1,0,0,0,0,0,1
storms form,0,0,0,0,0,1,0,1
storms heavy,0,0,0,1,0,0,0,1
storms helped,0,0,0,1,0,0,0,1
storms hurricanes,1,0,0,0,0,0,0,1
storms justin,0,0,0,1,0,0,0,1
storms lasting,0,0,0,0,0,1,0,1
storms lift,1,0,0,0,0,0,0,1
storms moench,0,0,0,0,1,0,0,1
storms president,1,0,0,0,0,0,0,1
storms prime,0,0,0,0,1,0,0,1
storms raw,0,0,0,1,0,0,0,1
storms severe,0,0,0,0,1,0,0,1
storms strong,0,0,0,0,0,1,0,1
storms tore,0,0,0,0,0,0,1,1
storms wednesday,0,0,0,1,0,0,0,1
storms worse,0,1,0,0,0,0,0,1
stormwater drains,0,0,0,1,0,0,0,1
stormwater runoff,0,0,0,0,1,0,0,1
stormwaters sea,0,1,0,0,0,0,0,1
story boykoff,0,0,0,1,0,0,0,1
story brick,0,0,0,1,0,0,0,1
story citing,0,0,1,0,0,0,0,1
story editor,0,0,0,0,1,0,0,1
story grew,1,0,0,0,0,0,0,1
story hemel,0,0,0,0,1,0,0,1
story home,0,0,0,0,0,0,1,1
story inspired,0,0,1,0,0,0,0,1
story mocking,0,0,1,0,0,0,0,1
story ran,0,0,1,0,0,0,0,1
story titled,0,0,0,0,0,1,0,1
story tyrone,0,1,0,0,0,0,0,1
story visit,0,1,0,0,0,0,0,1
story written,0,0,1,0,0,0,0,1
story zach,0,1,0,0,0,0,0,1
storylines related,0,0,0,0,0,0,1,1
storytelling consultancy,0,0,1,0,0,0,0,1
stove ban,0,0,0,1,0,0,0,1
stove burners,0,0,0,1,0,0,0,1
stove declarations,0,0,0,1,0,0,0,1
stove identifies,0,0,0,1,0,0,0,1
stove makers,0,0,0,1,0,0,0,1
stove manufacturer,0,0,0,0,1,0,0,1
stove run,0,1,0,0,0,0,0,1
stove themed,0,0,0,1,0,0,0,1
stoves affect,0,0,0,1,0,0,0,1
stoves gas,0,0,0,1,0,0,0,1
stoves heated,0,0,0,1,0,0,0,1
stoves scott,0,0,0,1,0,0,0,1
stoves wait,0,0,0,1,0,0,0,1
stoves wrote,0,0,0,1,0,0,0,1
straight gasoline,0,0,0,0,1,0,0,1
straight manufacturers,0,0,0,1,0,0,0,1
strain impacting,1,0,0,0,0,0,0,1
stranded assets,0,1,0,0,0,0,0,1
stranding thousands,1,0,0,0,0,0,0,1
strange phenomena,0,0,0,0,1,0,0,1
strapped eu,0,0,0,0,0,1,0,1
strategic alliance,0,1,0,0,0,0,0,1
strategic communication,0,0,0,1,0,0,0,1
strategic competition,0,0,0,0,1,0,0,1
strategic minerals,1,0,0,0,0,0,0,1
strategic reserves,1,0,0,0,0,0,0,1
strategically releasing,0,0,0,0,0,1,0,1
strategies honed,0,0,0,0,1,0,0,1
strategies including,0,0,1,0,0,0,0,1
strategies plans,0,0,0,0,0,1,0,1
strategies range,0,1,0,0,0,0,0,1
strategy faced,0,1,0,0,0,0,0,1
strategy mccormick,0,0,0,0,1,0,0,1
strategy ralston,0,0,0,0,1,0,0,1
strauss cbs,0,0,1,0,0,0,0,1
strawberry containers,1,0,0,0,0,0,0,1
straws stirrers,0,0,0,1,0,0,0,1
stream experts,0,0,0,1,0,0,0,1
stream extremes,0,0,0,1,0,0,0,1
stream generated,0,0,0,0,0,1,0,1
streams ceo,1,0,0,0,0,0,0,1
street canal,0,1,0,0,0,0,0,1
street interviews,0,0,0,0,0,1,0,1
street station,1,0,0,0,0,0,0,1
street strip,0,0,0,1,0,0,0,1
streets carry,1,0,0,0,0,0,0,1
streets lined,0,0,0,1,0,0,0,1
streets spray,0,1,0,0,0,0,0,1
strength superglue,0,0,1,0,0,0,0,1
strengthen safety,0,1,0,0,0,0,0,1
strengthen ties,0,1,0,0,0,0,0,1
strenuous journey,0,1,0,0,0,0,0,1
stress expel,0,1,0,0,0,0,0,1
stressed al,0,0,0,0,0,1,0,1
stresses corals,0,1,0,0,0,0,0,1
stressful tiresome,0,0,0,1,0,0,0,1
stretch finite,0,0,0,1,0,0,0,1
stretches inland,0,1,0,0,0,0,0,1
stretches west,0,0,0,0,0,1,0,1
stricken west,0,0,0,1,0,0,0,1
strict limits,0,0,0,0,0,1,0,1
strict regulation,0,0,0,1,0,0,0,1
stricter regulation,0,0,0,1,0,0,0,1
stricter tailpipe,0,0,0,0,0,1,0,1
strictest rules,0,0,0,1,0,0,0,1
strictly voluntary,0,1,0,0,0,0,0,1
strikes noaa,0,0,0,0,1,0,0,1
strikes shut,0,0,0,0,1,0,0,1
striking pieces,0,0,0,1,0,0,0,1
string sofía,0,0,0,1,0,0,0,1
stringed cuatro,0,1,0,0,0,0,0,1
stringed instrument,0,1,0,0,0,0,0,1
stringent choice,0,0,0,1,0,0,0,1
strip mining,0,1,0,0,0,0,0,1
striving for.one,0,1,0,0,0,0,0,1
strong action,1,0,0,0,0,0,0,1
strong afternoon,0,0,0,1,0,0,0,1
strong arctic,0,0,1,0,0,0,0,1
strong comments,0,0,0,0,0,1,0,1
strong global,0,1,0,0,0,0,0,1
strong jet,0,0,0,0,0,1,0,1
strong magnets,0,0,0,1,0,0,0,1
strong market,0,1,0,0,0,0,0,1
strong mountain,0,0,0,1,0,0,0,1
strong people,1,0,0,0,0,0,0,1
strong possibility,0,0,0,0,1,0,0,1
strong record,1,0,0,0,0,0,0,1
strong resistance,0,0,0,0,0,1,0,1
strong signals,0,0,1,0,0,0,0,1
strong storm,0,0,0,1,0,0,0,1
strong thunderstorms,0,0,0,0,0,0,1,1
strong tornado,0,0,0,0,0,0,1,1
strong warnings,0,0,0,1,0,0,0,1
stronger building,1,0,0,0,0,0,0,1
stronger cap,0,0,0,0,0,1,0,1
stronger climate,0,0,0,0,0,1,0,1
stronger financial,0,0,1,0,0,0,0,1
stronger hurricanes,0,1,0,0,0,0,0,1
stronger inflation,0,1,0,0,0,0,0,1
stronger storms,0,0,0,0,0,1,0,1
strongest job,0,0,0,0,0,1,0,1
strongest message,0,0,0,0,1,0,0,1
strongest steps,0,1,0,0,0,0,0,1
strongest storm,0,0,1,0,0,0,0,1
strongest supercells,0,0,0,0,0,1,0,1
strongest tornado,0,0,0,0,0,1,0,1
strongly advising,0,0,0,1,0,0,0,1
strongly encourage,0,0,0,1,0,0,0,1
strongly opposed,0,1,0,0,0,0,0,1
struck florida's,0,1,0,0,0,0,0,1
structural damage,0,1,0,0,0,0,0,1
structure failures,0,0,0,0,0,1,0,1
structure hide,0,0,0,0,0,1,0,1
structure reading,0,0,0,0,0,1,0,1
struggled dan,0,0,0,0,1,0,0,1
struggling farmers,0,0,0,0,1,0,0,1
struggling recipients,0,0,0,0,0,0,1,1
strung native,1,0,0,0,0,0,0,1
stu rushfield,0,0,0,0,0,1,0,1
stuck pamphlets,0,1,0,0,0,0,0,1
student called,0,0,0,1,0,0,0,1
student focusing,0,0,1,0,0,0,0,1
student reported,0,0,0,1,0,0,0,1
student told,0,0,0,1,0,0,0,1
student volunteer,0,0,0,0,1,0,0,1
student world,0,1,0,0,0,0,0,1
student's data,0,0,0,1,0,0,0,1
students clocked,0,0,0,1,0,0,0,1
students collect,0,0,0,1,0,0,0,1
students destiny,0,0,0,0,1,0,0,1
students discover,0,0,0,1,0,0,0,1
students head,0,0,0,1,0,0,0,1
students including,0,1,0,0,0,0,0,1
students lab,0,0,0,1,0,0,0,1
students measure,0,0,0,1,0,0,0,1
students mutter,0,0,0,1,0,0,0,1
students painted,0,0,0,1,0,0,0,1
students split,0,0,0,1,0,0,0,1
students stop,0,0,0,1,0,0,0,1
students study,0,1,0,0,0,0,0,1
students surround,0,0,0,1,0,0,0,1
students walk,0,1,0,0,0,0,0,1
students wishes,0,0,0,0,1,0,0,1
students wrap,0,0,0,1,0,0,0,1
studied hudson,0,0,1,0,0,0,0,1
studied polar,0,0,1,0,0,0,0,1
studied scenario,1,0,0,0,0,0,0,1
studies climate,0,0,1,0,0,0,0,1
studies demonstrate,0,0,0,0,0,0,1,1
studies extremism,0,0,0,1,0,0,0,1
studies fossils,0,0,0,0,0,1,0,1
studies lightning,0,0,1,0,0,0,0,1
studies natural,0,0,0,1,0,0,0,1
studies opposition,0,0,0,0,1,0,0,1
studies plankton,0,0,0,0,0,1,0,1
studies professor,0,0,0,0,0,0,1,1
studies recommends,0,0,1,0,0,0,0,1
studies reservoirs,0,0,0,1,0,0,0,1
studies thwaites,0,0,0,0,1,0,0,1
study agreed,0,0,0,1,0,0,0,1
study called,0,0,0,1,0,0,0,1
study commissioned,0,0,1,0,0,0,0,1
study concluded,0,0,0,0,0,0,1,1
study continued,0,1,0,0,0,0,0,1
study drought,0,0,0,1,0,0,0,1
study highlights,0,1,0,0,0,0,0,1
study lin,0,0,0,0,1,0,0,1
study makes,0,0,0,1,0,0,0,1
study puerto,0,0,0,1,0,0,0,1
study revealed,0,0,0,0,0,0,1,1
study shared,0,0,0,0,0,1,0,1
study temperatures,0,0,0,0,0,0,1,1
study toxic,0,0,1,0,0,0,0,1
studying larger,0,0,0,1,0,0,0,1
studying options,0,0,0,1,0,0,0,1
studying saint,0,0,0,0,1,0,0,1
studying samples,0,0,0,0,0,1,0,1
stuff mankani,1,0,0,0,0,0,0,1
stuff pyne,0,0,1,0,0,0,0,1
stunned survivors,1,0,0,0,0,0,0,1
stunning including,0,0,0,0,1,0,0,1
stunning people,0,0,0,0,0,0,1,1
stunning salt,0,1,0,0,0,0,0,1
sturdy chain,0,1,0,0,0,0,0,1
sturdy rubber,0,0,0,0,1,0,0,1
style freezer,0,0,0,1,0,0,0,1
style image,0,0,0,0,0,1,0,1
style mushroom,0,1,0,0,0,0,0,1
style stainless,0,1,0,0,0,0,0,1
subaru exhibit,0,0,0,0,1,0,0,1
subaru station,1,0,0,0,0,0,0,1
subdued rendition,0,1,0,0,0,0,0,1
subject maya,0,1,0,0,0,0,0,1
submerged cultures,0,1,0,0,0,0,0,1
submerged garden,1,0,0,0,0,0,0,1
submerged homes,1,0,0,0,0,0,0,1
submerged villages,1,0,0,0,0,0,0,1
submission separately,0,1,0,0,0,0,0,1
subsided tens,0,1,0,0,0,0,0,1
subsidence top,0,1,0,0,0,0,0,1
subsidies tumiwa,0,0,0,0,1,0,0,1
subsidized public,0,1,0,0,0,0,0,1
subsidized water,1,0,0,0,0,0,0,1
subsidy abraham,1,0,0,0,0,0,0,1
subsidy kenney,0,1,0,0,0,0,0,1
subsistence activities,0,0,1,0,0,0,0,1
subsistence infrastructure,0,0,1,0,0,0,0,1
subsistence lifestyle,0,0,0,0,0,1,0,1
substantial concerns,0,0,0,0,0,1,0,1
substantial resources,1,0,0,0,0,0,0,1
substantially improve,0,0,0,0,1,0,0,1
substantially limit,0,0,1,0,0,0,0,1
substantially lower,0,0,0,1,0,0,0,1
substantially rewritten,0,0,0,1,0,0,0,1
substantive email,0,0,0,0,1,0,0,1
substation joe,0,0,1,0,0,0,0,1
substation yellowhammer,0,0,1,0,0,0,0,1
subsurface imaging,1,0,0,0,0,0,0,1
subtle bit,0,0,1,0,0,0,0,1
subtropical birthplace,0,1,0,0,0,0,0,1
subtropical north,0,0,1,0,0,0,0,1
suburban santa,0,0,0,0,1,0,0,1
success scientists,0,1,0,0,0,0,0,1
successful artists,0,1,0,0,0,0,0,1
successful campaign,0,0,0,1,0,0,0,1
successful campaigns,0,0,0,0,1,0,0,1
successful climate,0,1,0,0,0,0,0,1
successful outcome,0,1,0,0,0,0,0,1
successful recycling,1,0,0,0,0,0,0,1
successful stopwillow,0,0,0,0,0,1,0,1
successfully crossed,0,1,0,0,0,0,0,1
successfully grow,0,0,0,0,0,1,0,1
successfully mitigate,1,0,0,0,0,0,0,1
sudan egypt,0,1,0,0,0,0,0,1
sudan named,0,1,0,0,0,0,0,1
sudan sudan's,0,1,0,0,0,0,0,1
sudan yeah,0,1,0,0,0,0,0,1
sudanese friends,0,1,0,0,0,0,0,1
sudanese somalians,0,1,0,0,0,0,0,1
sudden announcement,0,1,0,0,0,0,0,1
suddenly soaking,0,0,0,0,0,1,0,1
suddenly stood,0,0,0,0,0,1,0,1
suddenly trapped,1,0,0,0,0,0,0,1
sued accusing,0,0,1,0,0,0,0,1
suffer exorbitantly,0,1,0,0,0,0,0,1
suffered blunt,0,0,0,1,0,0,0,1
suffered heavy,0,1,0,0,0,0,0,1
suffering disproportionate,0,0,0,0,0,1,0,1
suffers disproportionately,0,0,0,0,0,1,0,1
sufficient oversight,0,0,0,0,0,0,1,1
sufficiently address,0,0,0,1,0,0,0,1
sufficiently emptied,0,0,0,1,0,0,0,1
suffrage movement,0,0,0,0,0,1,0,1
sugar amino,0,1,0,0,0,0,0,1
sugar cane,0,1,0,0,0,0,0,1
sugar company,0,0,1,0,0,0,0,1
sugar cubes,0,0,0,0,1,0,0,1
sugar skating,0,0,0,0,1,0,0,1
suggested brits,0,0,0,0,0,1,0,1
suggesting gas,0,0,0,1,0,0,0,1
suggesting specific,0,0,0,0,0,1,0,1
suggestion sparked,0,0,0,0,0,1,0,1
suicidal war,0,0,1,0,0,0,0,1
suicide bomber,0,0,0,1,0,0,0,1
suite sustainable,0,0,1,0,0,0,0,1
sukanya buontha,0,1,0,0,0,0,0,1
sulfur dioxide,0,0,0,0,1,0,0,1
sullivan county,0,0,0,0,0,0,1,1
summer christopher,0,1,0,0,0,0,0,1
summer crop,0,1,0,0,0,0,0,1
summer employees,0,0,0,1,0,0,0,1
summer germany,0,0,0,1,0,0,0,1
summer groove,0,0,1,0,0,0,0,1
summer includes,0,1,0,0,0,0,0,1
summer increased,1,0,0,0,0,0,0,1
summer left,1,0,0,0,0,0,0,1
summer melting,1,0,0,0,0,0,0,1
summer olympics,0,1,0,0,0,0,0,1
summer peter,0,1,0,0,0,0,0,1
summer rebecca,1,0,0,0,0,0,0,1
summer storms,1,0,0,0,0,0,0,1
summer temperatures,0,1,0,0,0,0,0,1
summer thirty,0,1,0,0,0,0,0,1
summer thunderstorm,1,0,0,0,0,0,0,1
summer wildfires,0,0,1,0,0,0,0,1
summer's heat,0,0,0,1,0,0,0,1
summer's historic,0,1,0,0,0,0,0,1
summertime thunderstorms,1,0,0,0,0,0,0,1
summit friday,0,1,0,0,0,0,0,1
summit nariman,0,1,0,0,0,0,0,1
summit negotiations,0,0,0,1,0,0,0,1
summit proclaim,0,0,0,1,0,0,0,1
summit tied,0,0,0,0,1,0,0,1
summit's windchill,0,0,0,0,1,0,0,1
sun comparing,0,0,0,1,0,0,0,1
sun glistens,0,0,0,1,0,0,0,1
sun rise,0,0,0,1,0,0,0,1
sun ryan,0,1,0,0,0,0,0,1
sun sentinel,0,1,0,0,0,0,0,1
sun sneakers,0,0,0,1,0,0,0,1
sun's heat,0,0,1,0,0,0,0,1
sunak french,0,1,0,0,0,0,0,1
sunbaked soil,0,0,1,0,0,0,0,1
sunday afternoon,0,0,0,1,0,0,0,1
sunday athan,0,0,0,0,0,1,0,1
sunday biden,0,0,0,0,0,1,0,1
sunday blessing,0,1,0,0,0,0,0,1
sunday blocks,0,0,0,0,0,1,0,1
sunday daniel,1,0,0,0,0,0,0,1
sunday evening,0,0,0,0,1,0,0,1
sunday governor,1,0,0,0,0,0,0,1
sunday hurricane,1,0,0,0,0,0,0,1
sunday jeanine,0,0,0,0,1,0,0,1
sunday leaving,1,0,0,0,0,0,0,1
sunday maine,0,0,0,0,1,0,0,1
sunday manila,1,0,0,0,0,0,0,1
sunday moises,1,0,0,0,0,0,0,1
sunday morning,0,0,0,0,1,0,0,1
sunday north,0,0,0,0,1,0,0,1
sunday richard,0,0,0,0,1,0,0,1
sunday service,0,1,0,0,0,0,0,1
sunday wilmington,0,0,0,0,0,1,0,1
sundial junior,1,0,0,0,0,0,0,1
sunflower painting,0,1,0,0,0,0,0,1
sunken ships,0,1,0,0,0,0,0,1
sunny skies,0,0,0,0,1,0,0,1
sunoco station,1,0,0,0,0,0,0,1
sunset bathes,0,1,0,0,0,0,0,1
super ambitious,0,0,0,1,0,0,0,1
super bullish,0,1,0,0,0,0,0,1
super charged,0,1,0,0,0,0,0,1
super efficient,0,0,0,0,0,0,1,1
super emitters,1,0,0,0,0,0,0,1
super low,0,0,0,0,0,1,0,1
super noisy,0,0,0,1,0,0,0,1
super outbreak,0,0,0,0,0,1,0,1
super reefs,0,1,0,0,0,0,0,1
supercell activity,0,0,0,0,0,1,0,1
supercell blow,0,0,0,0,0,1,0,1
supercell counts,0,0,0,0,0,1,0,1
supercell storm,0,0,0,0,0,1,0,1
supercell thunderstorms,0,0,0,0,0,1,0,1
supercells forming,0,0,0,0,0,1,0,1
supercells increasing,0,0,0,0,0,1,0,1
supercells spawned,0,0,0,0,0,1,0,1
supercells twist,0,0,0,0,0,1,0,1
supervising editor,0,1,0,0,0,0,0,1
supplement local,0,0,0,1,0,0,0,1
supplemental funding,0,0,0,0,0,0,1,1
supplements food,1,0,0,0,0,0,0,1
supplements infant,1,0,0,0,0,0,0,1
supplies amid,0,0,0,0,1,0,0,1
supplies avoid,0,1,0,0,0,0,0,1
supplies drinking,0,0,0,1,0,0,0,1
supplies including,0,0,0,0,0,1,0,1
supplies millions,0,0,0,0,0,1,0,1
supplies pragmatism,0,0,1,0,0,0,0,1
supplies stretch,0,0,1,0,0,0,0,1
supplies worldwide,0,0,0,0,0,1,0,1
supply delivery,1,0,0,0,0,0,0,1
supply electricity,0,0,1,0,0,0,0,1
supply fogg,0,0,0,0,0,1,0,1
supply infrastructure,0,0,0,0,0,1,0,1
supply lined,0,0,0,0,1,0,0,1
supply lithium,0,1,0,0,0,0,0,1
supply shrinks,0,0,0,1,0,0,0,1
supply steam,1,0,0,0,0,0,0,1
supply tons,0,0,0,1,0,0,0,1
supply wastewater,0,0,0,0,0,1,0,1
supply wrote,0,1,0,0,0,0,0,1
supplying people,1,0,0,0,0,0,0,1
support farms,0,0,0,0,1,0,0,1
support fossil,0,0,0,0,0,1,0,1
support future,0,0,0,0,1,0,0,1
support healthy,0,0,1,0,0,0,0,1
support jobs,1,0,0,0,0,0,0,1
support jungwoo,0,0,0,0,1,0,0,1
support local,0,0,0,1,0,0,0,1
support loss,0,1,0,0,0,0,0,1
support low,0,0,0,0,1,0,0,1
support major,0,1,0,0,0,0,0,1
support ongoing,0,0,0,0,1,0,0,1
support planet,0,0,1,0,0,0,0,1
support policies,0,0,0,1,0,0,0,1
support poor,0,1,0,0,0,0,0,1
support research,0,1,0,0,0,0,0,1
support speculation,0,0,0,0,1,0,0,1
support system,0,0,0,0,1,0,0,1
support systems,0,0,1,0,0,0,0,1
support walking,0,0,0,0,0,1,0,1
supported calls,0,1,0,0,0,0,0,1
supported eating,0,0,0,0,0,1,0,1
supported investments,0,0,0,1,0,0,0,1
supported paper,1,0,0,0,0,0,0,1
supporting countries,0,1,0,0,0,0,0,1
supporting indonesia's,0,0,0,0,1,0,0,1
supporting innovation,0,1,0,0,0,0,0,1
supporting thousands,0,0,0,0,0,1,0,1
supporting ukraine,0,0,0,1,0,0,0,1
supports creating,0,1,0,0,0,0,0,1
supports movie,0,0,0,0,0,0,1,1
supports piedmont,0,1,0,0,0,0,0,1
supports solar,0,0,0,0,1,0,0,1
supposedly restored,1,0,0,0,0,0,0,1
supposedly spotted,0,0,0,0,1,0,0,1
suppression practices,0,0,0,0,0,1,0,1
supreme court's,0,0,1,0,0,0,0,1
surface covered,0,0,0,0,1,0,0,1
surface infrastructure,0,0,0,0,0,1,0,1
surface mine,1,0,0,0,0,0,0,1
surface mining,1,0,0,0,0,0,0,1
surface playground,0,0,0,1,0,0,0,1
surface thermometer,0,0,0,1,0,0,0,1
surfaced environmental,0,0,0,1,0,0,0,1
surfaces mohamed,0,0,0,1,0,0,0,1
surfaces satellites,0,0,0,1,0,0,0,1
surge damaged,0,1,0,0,0,0,0,1
surge farmed,0,0,0,0,0,0,1,1
surge pushed,1,0,0,0,0,0,0,1
surges presently,0,1,0,0,0,0,0,1
surpassed supply,0,1,0,0,0,0,0,1
surprise appearance,0,1,0,0,0,0,0,1
surprise environmentalists,0,0,0,1,0,0,0,1
surprised inland,0,0,0,0,1,0,0,1
surrounding agricultural,0,0,0,0,0,1,0,1
surrounding blacktop,0,0,0,1,0,0,0,1
surrounding communities,0,1,0,0,0,0,0,1
surrounding fishing,0,1,0,0,0,0,0,1
surrounding neighborhood,0,0,0,1,0,0,0,1
surrounding structures,0,0,0,0,1,0,0,1
surrounding tables,0,1,0,0,0,0,0,1
surrounding water,0,0,0,0,0,1,0,1
surrounding wetlands,0,1,0,0,0,0,0,1
surveillance concerns,0,0,0,0,1,0,0,1
survey findings,0,0,1,0,0,0,0,1
survey hide,1,0,0,0,0,0,0,1
survey report,0,0,1,0,0,0,0,1
surveyed western,0,0,1,0,0,0,0,1
survival marine,0,1,0,0,0,0,0,1
survival story,0,0,1,0,0,0,0,1
survive amid,0,0,1,0,0,0,0,1
survive explained,0,0,0,0,0,0,1,1
surviving corals,0,1,0,0,0,0,0,1
susan barton,1,0,0,0,0,0,0,1
susan buchanan,0,0,0,0,1,0,0,1
susan corbett,0,0,0,0,1,0,0,1
susan guided,0,0,0,0,1,0,0,1
susana de,0,0,0,0,0,1,0,1
susana mountains,0,0,1,0,0,0,0,1
susanne gutierrez,0,0,1,0,0,0,0,1
susie lipton,0,0,0,0,1,0,0,1
suspected marburg,0,0,0,0,0,1,0,1
suspected tornadoes,0,0,0,0,0,0,1,1
suspension bridges,0,1,0,0,0,0,0,1
sustain supercell,0,0,0,0,0,0,1,1
sustainability attributes,0,0,0,1,0,0,0,1
sustainability goals,0,0,0,0,0,1,0,1
sustainability issues,0,0,0,0,0,0,1,1
sustainability teams,0,1,0,0,0,0,0,1
sustainable agriculture,0,0,0,0,0,0,1,1
sustainable amount,0,0,0,1,0,0,0,1
sustainable clean,0,0,0,0,1,0,0,1
sustainable development,0,0,0,0,1,0,0,1
sustainable farming,1,0,0,0,0,0,0,1
sustainable form,1,0,0,0,0,0,0,1
sustainable future,0,0,0,0,0,1,0,1
sustainable industrialization,1,0,0,0,0,0,0,1
sustainable investor,0,0,1,0,0,0,0,1
sustainable management,1,0,0,0,0,0,0,1
sustainable markets,0,1,0,0,0,0,0,1
sustainable oyster,0,0,0,0,0,0,1,1
sustainable passage,0,0,1,0,0,0,0,1
sustainable practices,0,1,0,0,0,0,0,1
sustainable wildlife,0,0,1,0,0,0,0,1
sustained climate,0,1,0,0,0,0,0,1
sustains hurricane,0,1,0,0,0,0,0,1
sustains life,0,0,1,0,0,0,0,1
suvs outsell,0,0,0,0,1,0,0,1
suwanee georgia,0,0,0,0,1,0,0,1
suzanne gutierrez,0,0,1,0,0,0,0,1
swain found,0,0,0,0,0,0,1,1
swain looked,0,0,0,0,0,0,1,1
swain warns,0,0,0,0,0,0,1,1
swain's predictions,0,0,0,0,0,0,1,1
swallow government,0,1,0,0,0,0,0,1
swamp bayous,0,1,0,0,0,0,0,1
swamp west,1,0,0,0,0,0,0,1
sway local,0,0,0,0,1,0,0,1
sweden jonathan,0,1,0,0,0,0,0,1
sweden poland,0,1,0,0,0,0,0,1
swedish climate,0,1,0,0,0,0,0,1
swedish parliament,0,0,0,0,1,0,0,1
sweeping blackout,0,0,0,0,1,0,0,1
sweeping definitions,1,0,0,0,0,0,0,1
sweeping international,0,1,0,0,0,0,0,1
sweeping package,0,0,0,0,1,0,0,1
sweeping vehicles,0,1,0,0,0,0,0,1
sweeping view,0,0,0,0,1,0,0,1
sweeter eating,0,0,0,0,0,1,0,1
swelling rivers,0,0,0,0,1,0,0,1
sweltering hot,0,1,0,0,0,0,0,1
swf masdar,0,0,0,1,0,0,0,1
swift approval,0,0,0,0,0,1,0,1
swift response,0,1,0,0,0,0,0,1
swift water,0,0,0,1,0,0,0,1
swift's private,1,0,0,0,0,0,0,1
swiftly cut,0,0,0,0,1,0,0,1
swimming pool,1,0,0,0,0,0,0,1
swimming pools,0,0,0,1,0,0,0,1
swirling storm,0,0,0,1,0,0,0,1
swiss weather,0,0,0,1,0,0,0,1
switches inside,0,1,0,0,0,0,0,1
switzerland laurent,0,0,0,1,0,0,0,1
swollen bellies,1,0,0,0,0,0,0,1
swollen belly,1,0,0,0,0,0,0,1
swollen rivers,1,0,0,0,0,0,0,1
swollen salinas,0,0,0,0,0,1,0,1
sylvia plath,0,1,0,0,0,0,0,1
symbiotic cycle,0,0,0,1,0,0,0,1
symbiotic dance,0,0,1,0,0,0,0,1
sympathizers egypt,0,1,0,0,0,0,0,1
symptoms vary,0,0,0,0,0,1,0,1
synoptic outbreak,0,0,0,0,0,0,1,1
synthetic rubber,0,0,0,0,1,0,0,1
syrian migrants,0,1,0,0,0,0,0,1
system accounts,0,1,0,0,0,0,0,1
system andrea,0,0,0,1,0,0,0,1
system battered,0,1,0,0,0,0,0,1
system built,1,0,0,0,0,0,0,1
system colorado,0,1,0,0,0,0,0,1
system corporations,0,1,0,0,0,0,0,1
system created,1,0,0,0,0,0,0,1
system including,0,0,0,1,0,0,0,1
system leaks,0,0,0,1,0,0,0,1
system mars,0,1,0,0,0,0,0,1
system money,1,0,0,0,0,0,0,1
system moved,0,0,0,1,0,0,0,1
system nearby,0,0,0,1,0,0,0,1
system nespresso,0,0,0,1,0,0,0,1
system schaeffer,0,0,1,0,0,0,0,1
system started,0,0,0,0,0,1,0,1
system sweezey,0,0,1,0,0,0,0,1
system tells,0,1,0,0,0,0,0,1
system ultimately,0,1,0,0,0,0,0,1
system's wiring,0,1,0,0,0,0,0,1
systems barsotti,0,0,1,0,0,0,0,1
systems commonly,0,0,0,0,0,0,1,1
systems creating,1,0,0,0,0,0,0,1
systems exist,1,0,0,0,0,0,0,1
systems including,0,0,0,0,0,0,1,1
systems initiative,0,1,0,0,0,0,0,1
systems melt,0,0,1,0,0,0,0,1
systems serving,1,0,0,0,0,0,0,1
systems sukanya,0,1,0,0,0,0,0,1
taalas methane,1,0,0,0,0,0,0,1
taalas secretary,0,1,0,0,0,0,0,1
tables growing,0,1,0,0,0,0,0,1
tackle pollution,0,0,0,0,1,0,0,1
tackling plastic,0,0,0,1,0,0,0,1
tactical component,0,0,0,0,1,0,0,1
tactile qualities,0,1,0,0,0,0,0,1
tagged bees,0,0,0,0,0,1,0,1
taher salem,0,1,0,0,0,0,0,1
tahoe cars,0,0,0,1,0,0,0,1
tailpipe emission,0,0,0,0,0,1,0,1
tailpipes vickie,0,0,0,1,0,0,0,1
tails kwasi,0,0,1,0,0,0,0,1
tajikistan's president,0,0,0,0,0,1,0,1
takes care,0,0,0,1,0,0,0,1
takes funding,0,1,0,0,0,0,0,1
takes office,0,1,0,0,0,0,0,1
takes pains,1,0,0,0,0,0,0,1
takes pride,0,0,0,0,1,0,0,1
takes strong,1,0,0,0,0,0,0,1
takes time,0,1,0,0,0,0,0,1
taking aggressive,0,0,0,1,0,0,0,1
taking aim,0,0,0,0,1,0,0,1
taking decisions,0,1,0,0,0,0,0,1
taking increasingly,0,0,0,1,0,0,0,1
taking issue,0,1,0,0,0,0,0,1
taking lesson,0,0,0,1,0,0,0,1
taking millennia,0,0,1,0,0,0,0,1
taking office,0,0,0,0,1,0,0,1
taking public,0,0,0,1,0,0,0,1
taking revenues,0,0,0,0,1,0,0,1
taking roll,0,0,1,0,0,0,0,1
taking steps,0,0,1,0,0,0,0,1
taking swain's,0,0,0,0,0,0,1,1
taking unprecedented,1,0,0,0,0,0,0,1
tales serves,0,0,0,0,0,1,0,1
taliban told,0,1,0,0,0,0,0,1
talk dan,0,1,0,0,0,0,0,1
talk louder,0,0,0,1,0,0,0,1
talk observer,0,0,0,1,0,0,0,1
talk radio,0,0,1,0,0,0,0,1
talking billions,0,0,0,1,0,0,0,1
talking western,0,0,0,0,1,0,0,1
talks developing,0,1,0,0,0,0,0,1
talks final,0,0,1,0,0,0,0,1
talks formally,0,0,0,0,1,0,0,1
talks greenpeace,0,0,0,1,0,0,0,1
talks hosts,0,0,0,1,0,0,0,1
tall anvil,0,0,0,0,0,1,0,1
tall auburn,1,0,0,0,0,0,0,1
tall chain,0,0,0,1,0,0,0,1
tall filled,0,0,0,1,0,0,0,1
tall fortified,0,1,0,0,0,0,0,1
tall stately,0,0,0,0,0,1,0,1
tall told,1,0,0,0,0,0,0,1
tallahassee additionally,0,0,1,0,0,0,0,1
tallest building,0,0,0,1,0,0,0,1
tallest trees,0,0,0,0,0,1,0,1
tally shareholders,0,0,0,0,0,0,1,1
tami chappell,0,0,1,0,0,0,0,1
tamil nadu,0,1,0,0,0,0,0,1
tamma carleton,0,0,0,0,1,0,0,1
tampa bay,0,0,1,0,0,0,0,1
tampa mayor,1,0,0,0,0,0,0,1
tana nairobi,0,0,0,0,0,1,0,1
tang chhin,0,0,0,0,0,1,0,1
tangible deadline,0,0,0,0,0,1,0,1
tangible intangible,0,0,0,1,0,0,0,1
tangible plans,1,0,0,0,0,0,0,1
tanish doshi,0,1,0,0,0,0,0,1
tank america's,0,0,0,1,0,0,0,1
tank director,0,0,1,0,0,0,0,1
tank e3g,0,0,0,1,0,0,0,1
tank germany's,0,0,0,1,0,0,0,1
tank including,0,0,0,0,1,0,0,1
tank trucks,0,0,0,0,1,0,0,1
tank tunnels,0,1,0,0,0,0,0,1
tanker truck,0,0,0,0,1,0,0,1
tanks called,0,1,0,0,0,0,0,1
tanks elicits,0,1,0,0,0,0,0,1
tanks feed,0,1,0,0,0,0,0,1
tanks reaching,0,1,0,0,0,0,0,1
tanya plibersek,0,1,0,0,0,0,0,1
tape recordings,0,1,0,0,0,0,0,1
tape surrounding,0,0,0,0,0,1,0,1
tapped conservative,0,0,0,0,1,0,0,1
tapped opportunity,0,1,0,0,0,0,0,1
taps flowing,0,1,0,0,0,0,0,1
tara neill,0,1,0,0,0,0,0,1
target stanford,0,0,0,1,0,0,0,1
targeting mexicans,1,0,0,0,0,0,0,1
targeting museums,0,1,0,0,0,0,0,1
targets issue,0,0,0,0,0,0,1,1
targets laid,0,0,0,0,0,0,1,1
targets meaningful,0,0,0,1,0,0,0,1
tarpaulin tents,1,0,0,0,0,0,0,1
taste reflects,0,0,0,0,0,0,1,1
taste texture,0,1,0,0,0,0,0,1
tasting oysters,0,0,0,0,0,0,1,1
tasty bites,0,1,0,0,0,0,0,1
tattered clothes,1,0,0,0,0,0,0,1
tattoo artist,0,1,0,0,0,0,0,1
tattoo donate,0,0,0,0,1,0,0,1
tattoo shop,0,1,0,0,0,0,0,1
tattooing pursuits,0,1,0,0,0,0,0,1
tax credits,0,0,0,0,0,1,0,1
tax filings,0,0,0,0,1,0,0,1
tax records,0,0,1,0,0,0,0,1
taxpayer money,0,0,0,0,0,1,0,1
taylor dimsdale,0,1,0,0,0,0,0,1
taylor swift's,1,0,0,0,0,0,0,1
te wahipounamu,0,1,0,0,0,0,0,1
tea lund's,1,0,0,0,0,0,0,1
teacher acharya,0,1,0,0,0,0,0,1
teachers pension,0,0,1,0,0,0,0,1
teaching kids,0,1,0,0,0,0,0,1
teaching wildlife,0,0,1,0,0,0,0,1
team analyzed,0,0,1,0,0,0,0,1
team applying,0,1,0,0,0,0,0,1
team drew,0,0,0,0,0,0,1,1
team estimated,0,0,0,0,0,1,0,1
team ice,0,1,0,0,0,0,0,1
team player,0,0,1,0,0,0,0,1
team practicing,1,0,0,0,0,0,0,1
team reseal,0,0,0,1,0,0,0,1
team scrutinized,0,0,0,0,0,1,0,1
team searching,0,0,1,0,0,0,0,1
team traveled,0,1,0,0,0,0,0,1
team won,0,1,0,0,0,0,0,1
teams taking,0,1,0,0,0,0,0,1
tear gas,0,1,0,0,0,0,0,1
tech company,0,0,0,1,0,0,0,1
tech factories,0,0,0,0,1,0,0,1
tech forecasting,0,0,0,0,0,1,0,1
tech funds,0,1,0,0,0,0,0,1
tech investment,0,0,0,0,0,1,0,1
tech relationships,0,0,0,0,0,1,0,1
tech sector,0,0,0,0,0,1,0,1
tech services,0,0,1,0,0,0,0,1
technical director,0,0,0,0,1,0,0,1
technical option,0,1,0,0,0,0,0,1
technically called,0,0,0,1,0,0,0,1
technically closed,0,1,0,0,0,0,0,1
technically hotter,0,0,0,1,0,0,0,1
technological breakthroughs,0,1,0,0,0,0,0,1
technological competition,0,0,0,0,1,0,0,1
technologies al,0,0,0,1,0,0,0,1
technology britain,0,0,0,1,0,0,0,1
technology companies,0,1,0,0,0,0,0,1
technology fund,1,0,0,0,0,0,0,1
technology gap,0,0,1,0,0,0,0,1
technology including,0,0,0,1,0,0,0,1
technology institute,0,0,0,0,1,0,0,1
technology npr's,0,0,0,0,0,1,0,1
technology sense,0,0,0,0,1,0,0,1
technology solutions,0,0,0,0,1,0,0,1
ted cooke,1,0,0,0,0,0,0,1
ted scambos,0,0,0,0,1,0,0,1
ted schuur,0,1,0,0,0,0,0,1
ted williams,0,0,0,0,1,0,0,1
tedious stressful,0,0,0,1,0,0,0,1
tedros adding,0,0,0,0,0,1,0,1
tedros adhanom,0,0,0,0,0,1,0,1
teduray ethnic,1,0,0,0,0,0,0,1
teenage girl,1,0,0,0,0,0,0,1
tejon pass,0,0,0,0,1,0,0,1
telecommunications company,0,1,0,0,0,0,0,1
telephone poles,1,0,0,0,0,0,0,1
television arts,0,1,0,0,0,0,0,1
television broadcasts,0,1,0,0,0,0,0,1
television history,0,0,1,0,0,0,0,1
television meteorologists,0,1,0,0,0,0,0,1
television producer,0,1,0,0,0,0,0,1
telling aaron,0,0,1,0,0,0,0,1
telling compelling,0,0,0,0,0,0,1,1
telling passersby,0,0,0,0,0,1,0,1
telling reporters,1,0,0,0,0,0,0,1
telling stories,0,1,0,0,0,0,0,1
tells aaron,0,0,1,0,0,0,0,1
tells farmers,0,1,0,0,0,0,0,1
tells floodlight,0,0,1,0,0,0,0,1
tells short,0,0,0,0,0,1,0,1
tells women,1,0,0,0,0,0,0,1
temperature feels,0,0,0,0,1,0,0,1
temperature gradient,0,0,0,0,1,0,0,1
temperature information,0,0,0,1,0,0,0,1
temperature meant,0,1,0,0,0,0,0,1
temperature precipitation,0,1,0,0,0,0,0,1
temperature pressure,0,0,0,0,1,0,0,1
temperature recordings,0,0,0,1,0,0,0,1
temperature sets,0,0,0,0,1,0,0,1
temperature slack,0,0,0,1,0,0,0,1
temperature taking,0,0,0,1,0,0,0,1
temperature targets,0,1,0,0,0,0,0,1
temperatures approaching,0,0,0,0,1,0,0,1
temperatures broke,0,1,0,0,0,0,0,1
temperatures documenting,0,1,0,0,0,0,0,1
temperatures driven,0,0,0,1,0,0,0,1
temperatures expected,0,0,0,0,1,0,0,1
temperatures fell,0,0,0,0,1,0,0,1
temperatures historic,0,0,0,1,0,0,0,1
temperatures increase,0,1,0,0,0,0,0,1
temperatures lower,0,0,0,1,0,0,0,1
temperatures master,0,1,0,0,0,0,0,1
temperatures record,0,0,0,0,0,1,0,1
temperatures shifted,0,0,0,0,1,0,0,1
temperatures slack,0,0,0,1,0,0,0,1
temperatures started,0,0,0,0,1,0,0,1
temperatures warming,0,0,0,1,0,0,0,1
temporary bridge,0,1,0,0,0,0,0,1
temporary cooling,0,0,0,1,0,0,0,1
temporary dented,1,0,0,0,0,0,0,1
temporary housing,0,1,0,0,0,0,0,1
temporary shelters,1,0,0,0,0,0,0,1
temporary water,0,0,0,0,0,1,0,1
temporary weather,0,0,0,1,0,0,0,1
tennessean communities,0,0,0,0,0,0,1,1
tennessee county,0,0,0,0,0,0,1,1
tennessee emergency,0,0,0,0,0,0,1,1
tennessee gov,0,0,0,0,0,0,1,1
tennessee recorded,0,0,0,0,0,0,1,1
tennessee woke,0,0,0,0,0,0,1,1
tense disaster,0,1,0,0,0,0,0,1
tent mankani's,1,0,0,0,0,0,0,1
tent set,1,0,0,0,0,0,0,1
tent window,1,0,0,0,0,0,0,1
tent's fly,1,0,0,0,0,0,0,1
tents pitched,1,0,0,0,0,0,0,1
tents relying,0,0,1,0,0,0,0,1
teresa leger,1,0,0,0,0,0,0,1
term average,0,0,0,0,0,1,0,1
term behavior,0,0,0,1,0,0,0,1
term democrat's,0,0,0,0,0,1,0,1
term fix,0,0,0,0,1,0,0,1
term growth,0,0,0,1,0,0,0,1
term investment,0,0,1,0,0,0,0,1
term issue,1,0,0,0,0,0,0,1
term jobs,0,0,0,0,1,0,0,1
term lawmaker,1,0,0,0,0,0,0,1
term meaning,0,0,0,0,0,1,0,1
term megadrought,0,0,0,0,0,1,0,1
term multiple,0,1,0,0,0,0,0,1
term oil,0,0,0,0,1,0,0,1
term planning,0,1,0,0,0,0,0,1
term plans,0,0,0,1,0,0,0,1
term political,0,1,0,0,0,0,0,1
term rebuilding,0,0,0,0,1,0,0,1
term rehabilitation,0,1,0,0,0,0,0,1
term research,0,0,1,0,0,0,0,1
term responsible,0,0,0,0,1,0,0,1
term storage,0,1,0,0,0,0,0,1
term strategy,0,0,0,0,1,0,0,1
term weather,0,0,0,1,0,0,0,1
term wellbeing,0,1,0,0,0,0,0,1
term wrote,1,0,0,0,0,0,0,1
term yeah,0,0,0,1,0,0,0,1
termites rob,1,0,0,0,0,0,0,1
terms yeah,0,0,1,0,0,0,0,1
terrain analysis,0,0,0,1,0,0,0,1
terrain maps,0,0,0,1,0,0,0,1
terrebonne parish,1,0,0,0,0,0,0,1
terrible climate,0,1,0,0,0,0,0,1
terrible mankani,1,0,0,0,0,0,0,1
territories managed,0,0,1,0,0,0,0,1
territory dvoretzky,0,0,0,0,0,1,0,1
territory's public,0,0,0,1,0,0,0,1
tesfaye harvest,1,0,0,0,0,0,0,1
teshekpuk lake,0,0,0,0,0,1,0,1
tesla batteries,0,1,0,0,0,0,0,1
test disease,0,0,0,0,0,1,0,1
test kitchen,0,1,0,0,0,0,0,1
test natural,0,0,0,0,1,0,0,1
testimonials people,0,0,0,0,1,0,0,1
testing continues,0,0,0,1,0,0,0,1
testing people,0,0,0,0,1,0,0,1
testy exchange,0,0,0,0,0,1,0,1
texans woke,0,0,0,0,1,0,0,1
texas arkansas,0,0,0,0,0,1,0,1
texas coast,0,0,0,0,0,0,1,1
texas county,0,1,0,0,0,0,0,1
texas deregulated,0,0,0,0,1,0,0,1
texas division,0,1,0,0,0,0,0,1
texas energy,0,0,0,0,1,0,0,1
texas family,0,0,0,0,1,0,0,1
texas farm,0,0,0,0,0,0,1,1
texas gov,0,1,0,0,0,0,0,1
texas grid,0,0,0,0,1,0,0,1
texas house,0,0,0,0,1,0,0,1
texas idabel,0,1,0,0,0,0,0,1
texas industry,0,0,0,0,0,0,1,1
texas jeff,0,1,0,0,0,0,0,1
texas judge,0,1,0,0,0,0,0,1
texas legislators,0,0,0,0,1,0,0,1
texas lewin,0,0,0,0,1,0,0,1
texas medical,1,0,0,0,0,0,0,1
texas parks,0,0,0,0,0,0,1,1
texas shelbie,0,1,0,0,0,0,0,1
text edited,0,1,0,0,0,0,0,1
textured beauty,0,1,0,0,0,0,0,1
thamang bottom,0,1,0,0,0,0,0,1
thamang lhakpa,0,1,0,0,0,0,0,1
thankfully half,0,1,0,0,0,0,0,1
that.gabrielle roesch,0,0,0,1,0,0,0,1
that'll bring,0,0,0,0,0,0,1,1
thaw climate,0,1,0,0,0,0,0,1
thaw permafrost,0,1,0,0,0,0,0,1
thawing arctic,0,1,0,0,0,0,0,1
thawing ground,0,1,0,0,0,0,0,1
thawing ice,0,0,1,0,0,0,0,1
thaws cracking,0,1,0,0,0,0,0,1
thaws permafrost,0,1,0,0,0,0,0,1
thelander's farm,1,0,0,0,0,0,0,1
themed installment,0,0,0,0,0,1,0,1
themed versions,0,0,0,1,0,0,0,1
themes weave,1,0,0,0,0,0,0,1
then.for npr,0,0,0,0,1,0,0,1
theoretical ideas,0,0,0,0,0,1,0,1
theoretically supposed,0,1,0,0,0,0,0,1
theories fabrice,0,0,0,0,0,1,0,1
theories vague,0,0,0,0,0,1,0,1
theorist alex,0,0,0,0,0,1,0,1
theory describing,0,0,0,0,0,1,0,1
theory eating,0,0,0,0,0,1,0,1
theory soak,0,0,0,0,1,0,0,1
therapeutic waters,0,1,0,0,0,0,0,1
there.we visit,0,1,0,0,0,0,0,1
thermal camera,0,0,0,1,0,0,0,1
thermo electron,0,0,0,0,1,0,0,1
thermo fisher,0,0,0,0,1,0,0,1
thick blanket,0,0,0,0,1,0,0,1
thick blankets,0,1,0,0,0,0,0,1
thick layer,1,0,0,0,0,0,0,1
thick layers,1,0,0,0,0,0,0,1
thick snowpack,0,0,0,0,0,1,0,1
thick sturdy,0,0,0,0,1,0,0,1
thierry baudet,0,0,0,0,0,1,0,1
thin cotton,1,0,0,0,0,0,0,1
thin light,1,0,0,0,0,0,0,1
thirsty growing,0,0,0,0,1,0,0,1
thirsty soil,0,0,0,1,0,0,0,1
thirteen counties,0,1,0,0,0,0,0,1
thirteen thousand,0,0,0,0,1,0,0,1
this.al transitions,0,0,0,1,0,0,0,1
thoko chikondi,0,0,0,0,0,1,0,1
thom tillis,0,1,0,0,0,0,0,1
thomas family,1,0,0,0,0,0,0,1
thomas fanning,0,0,1,0,0,0,0,1
thomas lu,0,0,1,0,0,0,0,1
thompson text,0,1,0,0,0,0,0,1
thornier questions,1,0,0,0,0,0,0,1
thorniest issues,0,1,0,0,0,0,0,1
thornton president,1,0,0,0,0,0,0,1
thousand feet,0,0,0,0,1,0,0,1
thousand miles,1,0,0,0,0,0,0,1
thousand oaks,0,0,0,1,0,0,0,1
thousand patients,0,1,0,0,0,0,0,1
threat experts,0,0,0,1,0,0,0,1
threat multiplier,1,0,0,0,0,0,0,1
threat posed,0,1,0,0,0,0,0,1
threat remains,0,0,0,1,0,0,0,1
threat ryan,0,1,0,0,0,0,0,1
threaten earthen,1,0,0,0,0,0,0,1
threaten electric,0,0,0,0,1,0,0,1
threaten millions,0,0,0,0,1,0,0,1
threatened export,1,0,0,0,0,0,0,1
threatened homes,0,1,0,0,0,0,0,1
threatened mandatory,1,0,0,0,0,0,0,1
threatening coral's,0,1,0,0,0,0,0,1
threatening flash,1,0,0,0,0,0,0,1
threatening trees,0,0,1,0,0,0,0,1
threats emily,0,0,0,1,0,0,0,1
threshold biedul,0,0,0,0,1,0,0,1
threw soup,0,1,0,0,0,0,0,1
threw tomato,0,1,0,0,0,0,0,1
thriller fare,0,0,0,0,0,0,1,1
thriving coral,0,1,0,0,0,0,0,1
thriving leuser,0,0,0,0,0,0,1,1
thriving reefs,0,1,0,0,0,0,0,1
throat abdominal,0,0,0,0,0,1,0,1
throwaway items,0,0,0,1,0,0,0,1
throwaways designed,0,0,0,0,1,0,0,1
thumb overhand,0,1,0,0,0,0,0,1
thump emerges,1,0,0,0,0,0,0,1
thunberg spoke,0,0,0,0,1,0,0,1
thunderstorm season,1,0,0,0,0,0,0,1
thunderstorms noah,1,0,0,0,0,0,0,1
thunderstorms persisted,0,0,0,0,1,0,0,1
thurman's home,0,0,0,1,0,0,0,1
thursday afternoon,1,0,0,0,0,0,0,1
thursday causing,0,1,0,0,0,0,0,1
thursday chinese,0,1,0,0,0,0,0,1
thursday disney,0,1,0,0,0,0,0,1
thursday morning's,0,1,0,0,0,0,0,1
thursday named,0,0,0,1,0,0,0,1
thursday nicole,0,1,0,0,0,0,0,1
thursday seventeen,0,1,0,0,0,0,0,1
thwaites chaotic,0,0,0,0,1,0,0,1
thwaites ice,0,0,0,0,1,0,0,1
thwaites program,0,0,0,0,1,0,0,1
thwaites researchers,0,0,0,0,1,0,0,1
tide events,0,0,0,0,1,0,0,1
tide leading,0,0,0,1,0,0,0,1
tide skip,0,1,0,0,0,0,0,1
tidewater va,0,1,0,0,0,0,0,1
tidy defra's,0,0,0,1,0,0,0,1
tight tomato,0,0,0,0,0,1,0,1
tighten regulations,0,1,0,0,0,0,0,1
tightens regulations,0,0,0,0,1,0,0,1
tighter regulations,0,0,0,0,1,0,0,1
tiktok amassing,0,0,0,0,0,1,0,1
tiktok marne,0,1,0,0,0,0,0,1
tiktok user,0,0,0,1,0,0,0,1
tiktok's daily,0,0,0,0,0,1,0,1
till mid,0,1,0,0,0,0,0,1
tilling phil,0,1,0,0,0,0,0,1
tilt meters,0,0,0,1,0,0,0,1
tim carroll,0,0,0,0,0,0,1,1
tim miller,0,0,0,1,0,0,0,1
timber stands,1,0,0,0,0,0,0,1
timberline zones,0,0,0,0,0,1,0,1
time abd,0,1,0,0,0,0,0,1
time analysts,0,0,1,0,0,0,0,1
time arachnologist,1,0,0,0,0,0,0,1
time city,1,0,0,0,0,0,0,1
time coming,0,0,0,1,0,0,0,1
time cycle,0,0,0,1,0,0,0,1
time davis,0,0,0,1,0,0,0,1
time detailing,0,0,0,0,1,0,0,1
time dreamer,0,0,0,0,1,0,0,1
time drop,0,1,0,0,0,0,0,1
time estimated,0,0,0,1,0,0,0,1
time familiar,0,1,0,0,0,0,0,1
time finding,0,0,0,0,1,0,0,1
time forming,0,0,0,0,0,1,0,1
time frame,0,1,0,0,0,0,0,1
time greenhouse,0,0,0,0,1,0,0,1
time gutierrez,0,0,1,0,0,0,0,1
time hailed,0,0,0,0,1,0,0,1
time highs,1,0,0,0,0,0,0,1
time hollywood,0,0,1,0,0,0,0,1
time houser,0,0,0,0,1,0,0,1
time john,0,1,0,0,0,0,0,1
time jones,0,0,0,0,1,0,0,1
time kirk,0,0,0,0,1,0,0,1
time laughter,0,0,0,1,0,0,0,1
time machine,0,1,0,0,0,0,0,1
time magazine's,0,0,0,0,1,0,0,1
time makes,0,0,0,1,0,0,0,1
time massive,1,0,0,0,0,0,0,1
time meet,0,1,0,0,0,0,0,1
time mexicans,0,0,0,0,0,1,0,1
time national,0,0,0,0,0,1,0,1
time officials,0,0,0,1,0,0,0,1
time ogunseitan,0,0,0,0,0,1,0,1
time opportunities,0,0,0,1,0,0,0,1
time ostrager,0,0,0,1,0,0,0,1
time period,1,0,0,0,0,0,0,1
time ralston,0,0,0,0,1,0,0,1
time record,0,0,0,0,1,0,0,1
time reporter,0,0,1,0,0,0,0,1
time rising,0,1,0,0,0,0,0,1
time riverboat,0,1,0,0,0,0,0,1
time riverboats,0,0,0,0,0,1,0,1
time scale,0,0,0,0,0,1,0,1
time taking,0,0,0,1,0,0,0,1
time versus,0,0,0,1,0,0,0,1
time warmth,0,0,0,0,0,0,1,1
time weather,0,1,0,0,0,0,0,1
time williams,0,0,0,0,1,0,0,1
timeless rural,0,0,0,0,0,1,0,1
timeline attached,0,1,0,0,0,0,0,1
times bigger,0,0,0,0,1,0,0,1
times cheaper,0,1,0,0,0,0,0,1
times health,1,0,0,0,0,0,0,1
times kids,0,0,0,1,0,0,0,1
times lower,0,1,0,0,0,0,0,1
times people,1,0,0,0,0,0,0,1
times recent,0,1,0,0,0,0,0,1
times reported,0,0,0,1,0,0,0,1
times saltier,0,1,0,0,0,0,0,1
times square,0,0,0,0,1,0,0,1
times terimaine,0,1,0,0,0,0,0,1
times unesco,0,1,0,0,0,0,0,1
times union,0,0,1,0,0,0,0,1
timmermans added,0,0,0,0,0,1,0,1
timmermans executive,0,1,0,0,0,0,0,1
timo koivisto,0,1,0,0,0,0,0,1
tin cup,0,0,1,0,0,0,0,1
tin spodumene,0,1,0,0,0,0,0,1
tinderboxes introducing,0,0,1,0,0,0,0,1
tiniest planktonic,0,0,0,0,0,1,0,1
tiny baby,0,0,0,1,0,0,0,1
tiny fire,0,1,0,0,0,0,0,1
tiny fraction,0,0,0,0,0,1,0,1
tiny frolicking,0,1,0,0,0,0,0,1
tiny nubs,0,0,0,0,0,1,0,1
tiny overshoot,0,0,0,1,0,0,0,1
tiny patches,0,1,0,0,0,0,0,1
tiny satellite,1,0,0,0,0,0,0,1
tiny shells,0,0,0,0,0,1,0,1
tiny squash,0,0,0,0,0,1,0,1
tiny surrounded,0,0,0,1,0,0,0,1
tire companies,1,0,0,0,0,0,0,1
tired essentially,0,0,0,0,0,1,0,1
tired laugh,1,0,0,0,0,0,0,1
tissue samples,0,0,0,0,0,1,0,1
title holder,0,1,0,0,0,0,0,1
titled climate,0,0,0,0,0,1,0,1
titled live,0,0,0,0,0,1,0,1
tn8 television,1,0,0,0,0,0,0,1
toasted seeds,0,1,0,0,0,0,0,1
tobacco industry,0,0,0,1,0,0,0,1
toboggan championships,0,0,0,0,1,0,0,1
tobyn pilot,0,1,0,0,0,0,0,1
today's announcement,0,0,0,0,0,1,0,1
today's children,0,1,0,0,0,0,0,1
today's deep,0,0,0,1,0,0,0,1
today's falling,1,0,0,0,0,0,0,1
today's ice,1,0,0,0,0,0,0,1
today's meeting.martí,0,0,0,0,0,1,0,1
today's population,1,0,0,0,0,0,0,1
todd spitler,0,0,0,1,0,0,0,1
toddler mankani,1,0,0,0,0,0,0,1
toilet flushing,0,0,0,0,1,0,0,1
toilet paper,0,0,0,1,0,0,0,1
told assembled,0,1,0,0,0,0,0,1
told australian,0,1,0,0,0,0,0,1
told authorities,1,0,0,0,0,0,0,1
told axios,0,0,0,0,0,1,0,1
told customers,1,0,0,0,0,0,0,1
told energy,0,0,0,0,0,1,0,1
told geoff,0,0,0,0,0,1,0,1
told official,1,0,0,0,0,0,0,1
told public,0,0,1,0,0,0,0,1
told tn8,1,0,0,0,0,0,0,1
told wls,0,0,0,0,0,0,1,1
told wnyc,0,0,0,0,1,0,0,1
toledo geographer,0,0,0,1,0,0,0,1
tolerance policy,0,1,0,0,0,0,0,1
tolerate nimby,0,0,0,1,0,0,0,1
toll climbed,1,0,0,0,0,0,0,1
toll free,0,0,0,0,0,1,0,1
toll npr's,0,0,0,1,0,0,0,1
tom carhart,0,1,0,0,0,0,0,1
tom fiedler,0,0,1,0,0,0,0,1
tom yamada,0,0,0,0,1,0,0,1
tomato line,0,0,0,0,0,1,0,1
tomato supplies,0,0,0,0,0,1,0,1
tomatoes customers,0,0,0,0,0,1,0,1
tomorrow sadly,0,0,0,0,0,1,0,1
tomorrow soaking,0,0,0,1,0,0,0,1
ton bags,1,0,0,0,0,0,0,1
ton carbon,0,1,0,0,0,0,0,1
tonight stapleton,0,1,0,0,0,0,0,1
tonight's program,0,1,0,0,0,0,0,1
tonkonogy warned,0,1,0,0,0,0,0,1
tony phelan,0,0,1,0,0,0,0,1
tool employs,0,1,0,0,0,0,0,1
tool gore,0,1,0,0,0,0,0,1
tools funds,0,1,0,0,0,0,0,1
top air,0,1,0,0,0,0,0,1
top hotels,0,1,0,0,0,0,0,1
top ice,0,1,0,0,0,0,0,1
top invertebrate,1,0,0,0,0,0,0,1
top lobbyist,0,0,1,0,0,0,0,1
top offerings,0,0,0,0,0,0,1,1
top officials,0,0,0,0,0,1,0,1
top oil,0,0,0,0,0,1,0,1
top polluters,0,1,0,0,0,0,0,1
top priorities,0,0,0,0,1,0,0,1
top public,0,0,0,1,0,0,0,1
top republican,0,1,0,0,0,0,0,1
top views,0,0,0,0,0,1,0,1
top white,0,0,0,0,0,1,0,1
topic joyner,0,0,0,0,0,0,1,1
topics sharing,0,0,0,0,1,0,0,1
toppled trees,0,0,0,0,1,0,0,1
tops poking,0,0,0,0,0,1,0,1
torchinsky's firm,0,0,0,0,1,0,0,1
tornado approached,0,0,0,0,0,0,1,1
tornado barreled,0,1,0,0,0,0,0,1
tornado chandan,0,0,0,0,0,1,0,1
tornado climate,0,0,0,0,0,1,0,1
tornado emergency,0,0,0,1,0,0,0,1
tornado expert,0,0,0,0,0,1,0,1
tornado fits,0,0,0,0,0,1,0,1
tornado landed,0,0,0,0,0,1,0,1
tornado outbreak,0,0,0,0,0,1,0,1
tornado overhead,0,0,0,1,0,0,0,1
tornado passed,0,0,0,0,0,0,1,1
tornado path,0,0,0,0,0,1,0,1
tornado rural,0,0,0,0,0,1,0,1
tornado shot,0,0,0,1,0,0,0,1
tornado sirens,0,1,0,0,0,0,0,1
tornado struck,0,0,0,1,0,0,0,1
tornado threat,0,0,0,0,0,1,0,1
tornado warning,0,0,0,0,0,1,0,1
tornadoes averaging,0,0,0,0,0,1,0,1
tornadoes devastated,0,0,0,0,0,0,1,1
tornadoes form,0,0,0,0,0,1,0,1
tornadoes happen,0,0,0,1,0,0,0,1
tornadoes recently,0,0,0,0,0,1,0,1
tornadoes tend,0,0,0,0,0,1,0,1
tornadoes wind,0,0,0,0,0,1,0,1
tornados occasionally,0,1,0,0,0,0,0,1
toronto star,0,1,0,0,0,0,0,1
torrential downpour,1,0,0,0,0,0,0,1
torrential heavy,0,1,0,0,0,0,0,1
torrential monsoon,1,0,0,0,0,0,0,1
torrential rains,1,0,0,0,0,0,0,1
tortured completes,0,0,0,0,1,0,0,1
toss litter,0,0,0,0,0,1,0,1
total cost,0,1,0,0,0,0,0,1
total dollars,0,1,0,0,0,0,0,1
total emissions,1,0,0,0,0,0,0,1
total global,0,0,0,0,0,1,0,1
total pledge,0,1,0,0,0,0,0,1
total precipitation,0,0,0,0,1,0,0,1
total reliance,0,0,0,0,1,0,0,1
total strangers,0,1,0,0,0,0,0,1
total victory,0,1,0,0,0,0,0,1
totaled cars,0,0,0,0,1,0,0,1
totally cut,1,0,0,0,0,0,0,1
totally destroyed,0,1,0,0,0,0,0,1
totally gutted,0,1,0,0,0,0,0,1
totally hear,0,1,0,0,0,0,0,1
totally logical,0,0,0,0,1,0,0,1
totally ready,0,0,0,0,1,0,0,1
totals central,0,0,0,0,1,0,0,1
toting bug,0,0,0,0,0,1,0,1
touch appalachia,0,1,0,0,0,0,0,1
touched african,1,0,0,0,0,0,0,1
touched snow,0,1,0,0,0,0,0,1
touches mankani's,1,0,0,0,0,0,0,1
tough bits,0,1,0,0,0,0,0,1
tough challenges,0,0,0,0,1,0,0,1
tough decisions,1,0,0,0,0,0,0,1
tough emissions,0,0,0,1,0,0,0,1
tough pill,0,1,0,0,0,0,0,1
tough sell,0,0,0,1,0,0,0,1
tough time,1,0,0,0,0,0,0,1
tougher language,0,0,1,0,0,0,0,1
tougher punishment,0,0,1,0,0,0,0,1
tounsi afp,0,0,0,0,0,0,1,1
tour flooded,0,0,0,0,1,0,0,1
tour guide,0,0,0,0,1,0,0,1
tour mathew,0,0,1,0,0,0,0,1
tour matthew,0,0,1,0,0,0,0,1
tour recently,0,0,0,1,0,0,0,1
tourism kenya,0,1,0,0,0,0,0,1
tourist office,0,0,0,1,0,0,0,1
touted progress,0,0,0,0,1,0,0,1
towering dams,0,0,0,1,0,0,0,1
towering hundreds,0,1,0,0,0,0,0,1
towering ocean,0,0,0,0,1,0,0,1
town ap,1,0,0,0,0,0,0,1
town called,0,0,1,0,0,0,0,1
town david,0,0,0,0,1,0,0,1
town fearful,0,1,0,0,0,0,0,1
town flooded,0,1,0,0,0,0,0,1
town furthest,0,1,0,0,0,0,0,1
town lajas,0,1,0,0,0,0,0,1
town margaret,0,0,0,0,1,0,0,1
town politics,0,0,0,0,1,0,0,1
town sits,0,1,0,0,0,0,0,1
town's chairperson,0,0,0,1,0,0,0,1
town's maintenance,0,1,0,0,0,0,0,1
town's mayor,0,1,0,0,0,0,0,1
town's monastery,0,1,0,0,0,0,0,1
town's water,0,1,0,0,0,0,0,1
towns including,0,0,0,0,0,1,0,1
towns lack,1,0,0,0,0,0,0,1
toxic disaster,0,0,0,1,0,0,0,1
toxic dust,0,0,0,0,1,0,0,1
toxic lead,0,0,1,0,0,0,0,1
toxic materials,0,0,0,0,1,0,0,1
toxic waste,1,0,0,0,0,0,0,1
toyota argues,0,0,0,0,1,0,0,1
toyota highlander,0,0,0,0,1,0,0,1
toyota motor,0,0,0,0,1,0,0,1
toyota's hybrid,0,0,0,0,1,0,0,1
toyota's minivan,0,0,0,0,1,0,0,1
trace amounts,0,0,0,0,1,0,0,1
trace found,0,1,0,0,0,0,0,1
traces lin's,0,1,0,0,0,0,0,1
tracey spencer,0,1,0,0,0,0,0,1
track cyclones,0,0,0,0,0,1,0,1
track domestic,1,0,0,0,0,0,0,1
track nations,1,0,0,0,0,0,0,1
track shifted,0,1,0,0,0,0,0,1
tracked sno,0,0,0,0,0,1,0,1
tracker maximiliano,0,0,0,1,0,0,0,1
tracker uae,0,0,0,0,0,1,0,1
tracking app,1,0,0,0,0,0,0,1
tracking millions,0,1,0,0,0,0,0,1
tracking radiosondes,0,0,0,0,1,0,0,1
tracks companies,0,0,1,0,0,0,0,1
tracks corporate,0,0,1,0,0,0,0,1
tracks investment,0,1,0,0,0,0,0,1
tractor trailer,0,0,1,0,0,0,0,1
trade agreement,0,0,0,0,0,1,0,1
trade blame,0,1,0,0,0,0,0,1
traded companies,0,0,0,0,0,0,1,1
tradeoff allowing,0,0,0,0,0,1,0,1
tradition canada's,0,0,0,0,0,1,0,1
tradition marks,0,0,0,0,0,1,0,1
traditional activity,0,0,1,0,0,0,0,1
traditional arts,0,1,0,0,0,0,0,1
traditional burger,0,1,0,0,0,0,0,1
traditional cool,0,0,0,0,0,0,1,1
traditional cotton,1,0,0,0,0,0,0,1
traditional ecological,0,0,0,0,0,1,0,1
traditional electric,0,0,0,1,0,0,0,1
traditional fishing,1,0,0,0,0,0,0,1
traditional forms,0,1,0,0,0,0,0,1
traditional gas,0,0,0,0,1,0,0,1
traditional investments,0,0,1,0,0,0,0,1
traditional journalistic,0,0,1,0,0,0,0,1
traditional lands,0,0,1,0,0,0,0,1
traditional marketing,0,1,0,0,0,0,0,1
traditional mitigation,1,0,0,0,0,0,0,1
traditional plant,0,1,0,0,0,0,0,1
traditional puerto,0,1,0,0,0,0,0,1
traditional sense,0,0,0,0,1,0,0,1
traditional sunday,0,1,0,0,0,0,0,1
traditional tornado,0,0,0,0,0,1,0,1
traditionally selma,0,0,0,1,0,0,0,1
traditions tied,0,0,1,0,0,0,0,1
traffic brown,0,1,0,0,0,0,0,1
traffic clogged,0,0,0,0,1,0,0,1
traffic damon,0,0,0,0,1,0,0,1
traffic flowing,0,1,0,0,0,0,0,1
traffic pratt,0,0,1,0,0,0,0,1
traffic snarling,1,0,0,0,0,0,0,1
trafficked roads,0,0,1,0,0,0,0,1
tragedy elderly,1,0,0,0,0,0,0,1
tragedy galvanized,0,0,0,1,0,0,0,1
tragically killed,0,0,0,1,0,0,0,1
trailer concrete,0,1,0,0,0,0,0,1
trailer release,0,0,1,0,0,0,0,1
train derailment,0,0,0,0,0,0,1,1
train kyle,0,0,0,1,0,0,0,1
train line,0,0,0,1,0,0,0,1
train loaded,0,0,0,1,0,0,0,1
trained african,0,1,0,0,0,0,0,1
trained eye,0,0,1,0,0,0,0,1
trained midwife,1,0,0,0,0,0,0,1
trained technicians,0,0,0,0,0,0,1,1
training base,0,1,0,0,0,0,0,1
training educators,0,0,0,0,1,0,0,1
transfer deals,0,0,0,0,1,0,0,1
transfer money,0,1,0,0,0,0,0,1
transferable skills,0,1,0,0,0,0,0,1
transform daily,0,1,0,0,0,0,0,1
transformed life,0,1,0,0,0,0,0,1
transforming river,1,0,0,0,0,0,0,1
transit agency,0,0,0,0,1,0,0,1
transit designing,0,0,0,0,0,1,0,1
transition ani,0,1,0,0,0,0,0,1
transition due,0,0,0,0,0,1,0,1
transition energy,0,1,0,0,0,0,0,1
transition poses,0,0,0,0,1,0,0,1
transition reducing,0,0,0,0,1,0,0,1
transition tomorrow,0,1,0,0,0,0,0,1
transition wow,0,0,0,1,0,0,0,1
translational research,0,0,0,0,1,0,0,1
transmission line,0,0,0,1,0,0,0,1
transparency companies,0,1,0,0,0,0,0,1
transparent unaffected,0,0,1,0,0,0,0,1
transport meredith,0,0,0,0,1,0,0,1
transport projects,0,1,0,0,0,0,0,1
transportation alternatives,0,0,0,0,1,0,0,1
transportation dedicated,1,0,0,0,0,0,0,1
transportation emissions,0,0,0,0,0,1,0,1
transportation fuel,0,0,0,0,1,0,0,1
transportation route,0,0,0,0,0,0,1,1
transportation system,1,0,0,0,0,0,0,1
transportation tweeted,0,0,1,0,0,0,0,1
transporting gas,0,0,1,0,0,0,0,1
transporting vegetables,1,0,0,0,0,0,0,1
trapped pratt,0,0,1,0,0,0,0,1
trapping carbon,0,0,0,1,0,0,0,1
trapping emissions,0,1,0,0,0,0,0,1
trapping greenhouse,1,0,0,0,0,0,0,1
trapping heat,1,0,0,0,0,0,0,1
trapping pollution.martí,0,0,0,0,1,0,0,1
traumatized hollywood,0,0,1,0,0,0,0,1
travel agency,0,1,0,0,0,0,0,1
travel arrangements,0,1,0,0,0,0,0,1
travel trailers,0,1,0,0,0,0,0,1
traveled southward,0,0,0,0,1,0,0,1
traveled sunday,0,0,0,0,0,0,1,1
traveled thousands,0,1,0,0,0,0,0,1
traveling north,1,0,0,0,0,0,0,1
trays bowls,0,0,0,1,0,0,0,1
tre watson,0,0,1,0,0,0,0,1
treacherous journey,0,1,0,0,0,0,0,1
treasured winter,0,0,0,0,1,0,0,1
treasury department,1,0,0,0,0,0,0,1
treat rivers,0,0,0,1,0,0,0,1
treat storm,0,0,0,1,0,0,0,1
treated sewage,0,0,0,1,0,0,0,1
treatment facilities,0,0,0,1,0,0,0,1
treatment facility,1,0,0,0,0,0,0,1
treatment setup,0,0,0,1,0,0,0,1
treaty luckily,0,0,0,0,0,1,0,1
tree branches,1,0,0,0,0,0,0,1
tree canopy.liberia,0,0,0,1,0,0,0,1
tree farm,0,0,1,0,0,0,0,1
tree farms,0,0,1,0,0,0,0,1
tree filled,1,0,0,0,0,0,0,1
tree fretted,1,0,0,0,0,0,0,1
tree grows,0,0,0,0,0,1,0,1
tree hugging,0,0,0,0,1,0,0,1
tree losing,0,0,0,0,0,1,0,1
tree panther,0,1,0,0,0,0,0,1
tree plant,0,0,1,0,0,0,0,1
tree shinaasha,0,0,0,0,0,1,0,1
tree species,0,0,0,0,0,1,0,1
tree students,0,0,0,1,0,0,0,1
trees based,0,0,1,0,0,0,0,1
trees begum,0,0,0,0,0,1,0,1
trees brush,0,0,0,0,0,0,1,1
trees burn,0,0,0,0,1,0,0,1
trees coming,0,0,0,1,0,0,0,1
trees covered,0,0,0,1,0,0,0,1
trees depinte,0,0,1,0,0,0,0,1
trees destroyed,1,0,0,0,0,0,0,1
trees disrupted,0,0,0,0,0,1,0,1
trees dumping,0,0,0,1,0,0,0,1
trees flying,0,0,1,0,0,0,0,1
trees forbidden,0,0,0,1,0,0,0,1
trees killed,0,1,0,0,0,0,0,1
trees leaves,0,0,0,1,0,0,0,1
trees left,0,0,0,0,0,1,0,1
trees primarily,0,0,0,0,0,0,1,1
trees rockslides,0,0,0,0,1,0,0,1
trees set,0,0,0,1,0,0,0,1
trees soak,0,0,0,0,0,0,1,1
trees toppled,1,0,0,0,0,0,0,1
trees tucked,0,0,0,1,0,0,0,1
trees zombie,0,0,0,0,0,1,0,1
treisman adapted,0,1,0,0,0,0,0,1
trekking industry,0,1,0,0,0,0,0,1
tremendous amount,0,0,0,0,0,1,0,1
tremendous cold,0,1,0,0,0,0,0,1
tremendous opportunity,0,0,0,1,0,0,0,1
tremendous personal,1,0,0,0,0,0,0,1
tremendous untapped,0,0,0,0,1,0,0,1
trend lines,1,0,0,0,0,0,0,1
trent carpenter,1,0,0,0,0,0,0,1
trespassing walk,1,0,0,0,0,0,0,1
trial forever,0,0,0,0,1,0,0,1
trial revealed,0,0,0,1,0,0,0,1
trials gavi's,0,0,0,0,0,1,0,1
tribal communities,0,0,1,0,0,0,0,1
tribal health,0,0,1,0,0,0,0,1
tribe fi,0,1,0,0,0,0,0,1
tribe hopes,1,0,0,0,0,0,0,1
tribe sea,1,0,0,0,0,0,0,1
tribe's claim,0,0,0,0,0,1,0,1
tribe's culture,1,0,0,0,0,0,0,1
tribe's efforts,0,0,0,0,0,1,0,1
tribe's legal,0,0,0,0,0,1,0,1
tribe's position,0,0,0,0,0,1,0,1
tribune news,0,1,0,0,0,0,0,1
tricky political,0,0,0,0,0,1,0,1
trigger avalanches,0,0,0,0,0,1,0,1
triggering deadly,0,0,0,0,0,1,0,1
triggering sea,1,0,0,0,0,0,0,1
triggering widespread,0,1,0,0,0,0,0,1
trillion commitment,0,0,0,0,0,1,0,1
trinette minthorn,0,0,0,0,0,1,0,1
trip private,0,0,1,0,0,0,0,1
triple checked,0,0,0,0,0,1,0,1
triple it’s,0,0,0,1,0,0,0,1
triple plastic,1,0,0,0,0,0,0,1
trish mcmichael,0,0,0,0,0,1,0,1
troop amina,0,0,0,1,0,0,0,1
troop tara,0,1,0,0,0,0,0,1
troops live,0,1,0,0,0,0,0,1
tropical moisture,0,0,0,0,0,1,0,1
tropical pacific,0,0,0,0,0,0,1,1
tropical regions,0,1,0,0,0,0,0,1
tropical research,0,0,1,0,0,0,0,1
tropical storms,0,1,0,0,0,0,0,1
trouble finding,0,0,0,1,0,0,0,1
trouble prioritizing,0,0,0,1,0,0,0,1
trouble separating,0,0,1,0,0,0,0,1
troupe frequent,0,0,0,0,1,0,0,1
trout streams,1,0,0,0,0,0,0,1
trout swim,0,0,0,1,0,0,0,1
truck cleaned,0,0,0,1,0,0,0,1
truck drivers,0,0,0,0,0,1,0,1
truck models,0,0,1,0,0,0,0,1
truck plunged,1,0,0,0,0,0,0,1
truck pollution,0,0,0,0,0,1,0,1
truck rule,0,0,1,0,0,0,0,1
truck rules,0,0,1,0,0,0,0,1
truck sales,0,0,1,0,0,0,0,1
truck traffic,0,1,0,0,0,0,0,1
truck volkswagen,0,0,1,0,0,0,0,1
trucking association,0,0,0,0,0,1,0,1
trucking associations,0,0,1,0,0,0,0,1
trucks carrying,0,0,0,0,0,1,0,1
trucks cars,0,0,0,0,0,1,0,1
trucks ford,0,0,0,0,1,0,0,1
trucks immediately,0,1,0,0,0,0,0,1
trucks including,0,0,0,0,0,1,0,1
trucks john,0,0,0,0,1,0,0,1
trucks moving,0,1,0,0,0,0,0,1
trucks pass,0,0,0,0,0,1,0,1
trucks patricio,0,0,1,0,0,0,0,1
trucks ron,0,0,0,0,0,1,0,1
trucks rumble,0,1,0,0,0,0,0,1
trucks semitrailers,0,0,0,0,0,1,0,1
trucks slowed,0,0,0,1,0,0,0,1
trucks today's,0,0,0,0,0,1,0,1
true anymore,0,0,0,1,0,0,0,1
true impact,0,0,1,0,0,0,0,1
true north,0,0,0,0,1,0,0,1
true role,0,1,0,0,0,0,0,1
trumka told,0,0,0,0,1,0,0,1
trump adviser,0,0,0,0,0,1,0,1
trump exceeded,0,0,0,0,0,1,0,1
trump investigation,0,0,0,1,0,0,0,1
trump launched,1,0,0,0,0,0,0,1
trump reversed,0,0,0,0,0,1,0,1
trump traveled,1,0,0,0,0,0,0,1
trump white,0,0,0,1,0,0,0,1
trump's home,0,0,0,1,0,0,0,1
trump's unfounded,0,0,0,0,1,0,0,1
trunk's glacier,0,0,0,0,1,0,0,1
trust law,0,0,0,0,0,1,0,1
trust trust,0,0,1,0,0,0,0,1
trusted confidant,0,0,0,1,0,0,0,1
trusts flood,1,0,0,0,0,0,0,1
truth helped,0,0,0,0,0,0,1,1
truth unlike,1,0,0,0,0,0,0,1
tsunami survivors,1,0,0,0,0,0,0,1
tubbs fire,0,0,0,0,1,0,0,1
tube experiment,0,0,0,0,0,1,0,1
tucson's habitat,0,1,0,0,0,0,0,1
tuesday afternoon,0,1,0,0,0,0,0,1
tuesday bevin,0,1,0,0,0,0,0,1
tuesday calling,0,0,0,0,0,1,0,1
tuesday news,0,1,0,0,0,0,0,1
tuesday rebecca,0,1,0,0,0,0,0,1
tuesday referencing,0,0,0,0,1,0,0,1
tuesday's midterm,0,1,0,0,0,0,0,1
tumiwa executive,0,0,0,0,1,0,0,1
tuna billfish,0,0,0,0,0,1,0,1
tunnel valleys,1,0,0,0,0,0,0,1
tunneled mines,0,0,0,0,1,0,0,1
tunneler's life,0,1,0,0,0,0,0,1
tupelo birmingham,0,0,0,0,0,1,0,1
turf reduction,0,0,0,0,1,0,0,1
turner bitton,0,0,0,0,1,0,0,1
turnip sandwich,0,0,0,0,0,1,0,1
turnips british,0,0,0,0,0,1,0,1
turquoise water,0,1,0,0,0,0,0,1
turtles toads,1,0,0,0,0,0,0,1
tuscon arizona,0,1,0,0,0,0,0,1
tuvalu theoretically,0,1,0,0,0,0,0,1
tv cell,0,0,0,0,0,1,0,1
tv crew,0,1,0,0,0,0,0,1
tv hide,0,0,0,0,0,0,1,1
tv production,0,0,0,0,0,0,1,1
tv reported,0,0,0,0,1,0,0,1
tv scripts,0,0,1,0,0,0,0,1
tweet shortly,0,0,0,0,0,1,0,1
tweeted accompanied,0,0,0,0,0,1,0,1
tweeted environmental,0,0,0,1,0,0,0,1
tweeted tuesday,0,0,0,1,0,0,0,1
twentieth century,0,0,0,0,1,0,0,1
twenty gallons,0,0,0,0,1,0,0,1
twin cities,0,0,0,0,1,0,0,1
twin falls,0,0,0,0,1,0,0,1
twisted metal,0,1,0,0,0,0,0,1
twister noaa,0,0,0,0,0,1,0,1
twisting path,1,0,0,0,0,0,0,1
twitter account,0,0,0,0,0,1,0,1
twitter fkritz,0,0,0,0,0,1,0,1
twitter florida,0,0,0,1,0,0,0,1
twitter kamal_t,0,1,0,0,0,0,0,1
ty o'neil,0,0,0,1,0,0,0,1
tyler childers,0,1,0,0,0,0,0,1
tyler fleming,1,0,0,0,0,0,0,1
typhoon lagoon,0,1,0,0,0,0,0,1
typhoon merbok,0,0,1,0,0,0,0,1
typical eco,0,0,0,0,0,0,1,1
typical time,0,0,0,0,0,0,1,1
typical tornado,0,0,0,0,0,1,0,1
typically accumulates,0,0,0,1,0,0,0,1
typically cheaper,0,0,0,0,0,0,1,1
typically drive,0,0,0,1,0,0,0,1
typically meet,0,0,0,0,1,0,0,1
typically pick,0,0,0,1,0,0,0,1
typically reservoirs,0,0,0,1,0,0,0,1
typically sets,0,0,0,0,0,1,0,1
typically tapers,0,0,0,0,0,1,0,1
typically waits,0,0,0,0,1,0,0,1
u.k based,1,0,0,0,0,0,0,1
u.k minister,0,0,0,0,0,1,0,1
u.k officials,0,0,0,1,0,0,0,1
u.k sir,0,1,0,0,0,0,0,1
u.n bodies,0,0,1,0,0,0,0,1
u.n convention,0,0,1,0,0,0,0,1
u.n cultural,0,1,0,0,0,0,0,1
u.n educational,0,0,0,0,0,1,0,1
u.n estimated,1,0,0,0,0,0,0,1
u.n estimates,0,0,0,0,0,1,0,1
u.n experts,1,0,0,0,0,0,0,1
u.n goals,0,0,0,0,0,1,0,1
u.n meetings,0,0,0,0,1,0,0,1
u.n organization,0,1,0,0,0,0,0,1
u.n plan,0,1,0,0,0,0,0,1
u.n population,0,1,0,0,0,0,0,1
u.n process,0,1,0,0,0,0,0,1
u.n published,0,1,0,0,0,0,0,1
u.n rations,0,0,1,0,0,0,0,1
u.n supplies,0,0,1,0,0,0,0,1
u.n talks,0,0,0,0,1,0,0,1
u.n weather,1,0,0,0,0,0,0,1
u.n world,0,0,0,0,0,1,0,1
u.n's climate,1,0,0,0,0,0,0,1
u.s abrams,0,0,0,1,0,0,0,1
u.s accept,1,0,0,0,0,0,0,1
u.s agencies,1,0,0,0,0,0,0,1
u.s agriculture,0,0,1,0,0,0,0,1
u.s airspace,0,0,0,0,1,0,0,1
u.s allison,0,1,0,0,0,0,0,1
u.s allowed,0,1,0,0,0,0,0,1
u.s announced,0,1,0,0,0,0,0,1
u.s army,0,1,0,0,0,0,0,1
u.s assistant,0,0,0,0,1,0,0,1
u.s atlantic,0,0,0,0,1,0,0,1
u.s attorney,0,0,0,1,0,0,0,1
u.s authorities,0,0,0,0,1,0,0,1
u.s bank,0,1,0,0,0,0,0,1
u.s border,1,0,0,0,0,0,0,1
u.s canadian,0,1,0,0,0,0,0,1
u.s centers,0,0,0,0,0,1,0,1
u.s circuit,0,0,0,1,0,0,0,1
u.s coast,0,1,0,0,0,0,0,1
u.s commitment,0,1,0,0,0,0,0,1
u.s development,0,1,0,0,0,0,0,1
u.s dollars,1,0,0,0,0,0,0,1
u.s drought,0,0,0,0,0,1,0,1
u.s east,0,0,0,1,0,0,0,1
u.s election,0,1,0,0,0,0,0,1
u.s extreme,1,0,0,0,0,0,0,1
u.s farmer,0,1,0,0,0,0,0,1
u.s federal,0,0,0,0,0,1,0,1
u.s fine,0,1,0,0,0,0,0,1
u.s food,0,0,0,0,0,1,0,1
u.s gathered,0,0,1,0,0,0,0,1
u.s germany,0,0,0,1,0,0,0,1
u.s giving,0,1,0,0,0,0,0,1
u.s gore,0,1,0,0,0,0,0,1
u.s government's,0,0,0,0,1,0,0,1
u.s governments,1,0,0,0,0,0,0,1
u.s infrastructure,1,0,0,0,0,0,0,1
u.s invested,0,1,0,0,0,0,0,1
u.s invests,0,1,0,0,0,0,0,1
u.s japan,0,1,0,0,0,0,0,1
u.s job,0,0,0,0,0,1,0,1
u.s journalism,0,0,1,0,0,0,0,1
u.s lawmakers,0,0,0,0,0,1,0,1
u.s leads,0,0,0,0,0,1,0,1
u.s left,0,0,1,0,0,0,0,1
u.s live,1,0,0,0,0,0,0,1
u.s marcio,0,0,0,0,1,0,0,1
u.s marine,0,1,0,0,0,0,0,1
u.s market,0,1,0,0,0,0,0,1
u.s maue,0,0,0,1,0,0,0,1
u.s missile,0,0,0,0,1,0,0,1
u.s oil,0,0,0,1,0,0,0,1
u.s pacific,0,0,0,0,1,0,0,1
u.s pay,0,0,1,0,0,0,0,1
u.s people,0,0,0,0,0,1,0,1
u.s plan,0,1,0,0,0,0,0,1
u.s policy,0,1,0,0,0,0,0,1
u.s pollution,0,1,0,0,0,0,0,1
u.s population,1,0,0,0,0,0,0,1
u.s power,0,0,1,0,0,0,0,1
u.s president,0,0,0,0,1,0,0,1
u.s private,0,0,0,1,0,0,0,1
u.s produces,0,1,0,0,0,0,0,1
u.s production,1,0,0,0,0,0,0,1
u.s raced,0,0,0,0,0,0,1,1
u.s record,0,0,0,0,1,0,0,1
u.s refinery,1,0,0,0,0,0,0,1
u.s regulators,0,0,0,0,0,0,1,1
u.s rely,0,1,0,0,0,0,0,1
u.s rep,0,0,0,1,0,0,0,1
u.s responsibility,0,1,0,0,0,0,0,1
u.s role,0,1,0,0,0,0,0,1
u.s russia,0,1,0,0,0,0,0,1
u.s sales,0,0,0,0,0,1,0,1
u.s senate,0,0,1,0,0,0,0,1
u.s signed,0,0,1,0,0,0,0,1
u.s soil,0,0,0,0,0,1,0,1
u.s southeast,0,0,0,0,0,1,0,1
u.s specifically,0,1,0,0,0,0,0,1
u.s strategic,0,0,0,0,0,1,0,1
u.s subject,0,0,0,0,1,0,0,1
u.s supreme,0,0,0,0,0,1,0,1
u.s territory's,0,0,0,1,0,0,0,1
u.s trucking,0,0,1,0,0,0,0,1
u.s underreport,0,1,0,0,0,0,0,1
u.s universities,0,1,0,0,0,0,0,1
u.s utility,0,0,1,0,0,0,0,1
u.s views,0,0,0,0,0,1,0,1
u.s warming,1,0,0,0,0,0,0,1
u.s wealth,0,0,0,0,0,1,0,1
u.s wildlife,1,0,0,0,0,0,0,1
uae based,0,0,0,0,1,0,0,1
uae minister,0,0,0,0,0,1,0,1
uae's appointment,0,0,0,1,0,0,0,1
uae's clean,0,0,0,1,0,0,0,1
uae's climate,0,0,0,1,0,0,0,1
uae's economy,0,0,0,1,0,0,0,1
uc berkeley,0,0,0,0,0,0,1,1
uc san,0,0,0,1,0,0,0,1
ucla climate,0,0,0,0,0,0,1,1
ucla expect,0,0,0,1,0,0,0,1
ucla medical,0,1,0,0,0,0,0,1
uk japan,0,1,0,0,0,0,0,1
ukraine disrupted,0,1,0,0,0,0,0,1
ukraine npr's,0,0,0,1,0,0,0,1
ukraine reacting,0,0,0,1,0,0,0,1
ukraine rising,1,0,0,0,0,0,0,1
ukraine russia,0,1,0,0,0,0,0,1
ukraine russia's,0,1,0,0,0,0,0,1
ukraine skyrocketing,0,1,0,0,0,0,0,1
ukraine's allies,0,0,0,1,0,0,0,1
ukraine's foreign,0,0,0,1,0,0,0,1
ukraine's president,0,1,0,0,0,0,0,1
ukraine's western,0,0,0,1,0,0,0,1
ukrainian city,0,1,0,0,0,0,0,1
ukrainian war,0,0,0,0,1,0,0,1
ulet ifansasti,0,0,1,0,0,0,0,1
ulrike franke,0,0,0,1,0,0,0,1
ulterior motives,0,0,1,0,0,0,0,1
ultimate goal,0,0,0,0,0,1,0,1
ultimate product,1,0,0,0,0,0,0,1
ultimate storms,0,0,0,0,0,1,0,1
ultimately agreed,0,0,1,0,0,0,0,1
ultimately approved,0,0,0,0,1,0,0,1
ultimately buy,0,1,0,0,0,0,0,1
ultimately climate,0,0,0,1,0,0,0,1
ultimately closing,0,0,0,0,1,0,0,1
ultimately interior,0,0,0,0,0,1,0,1
ultimately recycled,0,0,1,0,0,0,0,1
ultimately suharsono,0,0,0,0,1,0,0,1
ultimately vetoed,0,0,1,0,0,0,0,1
umami style,0,1,0,0,0,0,0,1
umatilla indian,0,0,0,0,0,1,0,1
umatilla tribes,0,0,0,0,0,1,0,1
umbilical cord,1,0,0,0,0,0,0,1
umngot river,0,0,0,0,0,1,0,1
un's convention,0,0,1,0,0,0,0,1
unabated coal,0,0,0,0,1,0,0,1
unacceptable environmental,0,0,0,0,0,1,0,1
unacceptable rate,0,0,1,0,0,0,0,1
unaltered pumpkins,0,1,0,0,0,0,0,1
unanimous support,0,0,0,0,1,0,0,1
unauthorized discharges,0,0,0,1,0,0,0,1
unauthorized removal,0,0,0,1,0,0,0,1
unavoidably connected,0,1,0,0,0,0,0,1
unbearable globally,0,0,1,0,0,0,0,1
unbelievable boom,0,0,1,0,0,0,0,1
uncalculated move,0,1,0,0,0,0,0,1
uncertainty surrounding,0,0,0,0,0,1,0,1
unclear china,0,0,0,0,0,1,0,1
unconstitutional bals,0,0,1,0,0,0,0,1
uncontrolled development,0,0,0,0,1,0,0,1
uncontrolled growth,0,0,0,0,1,0,0,1
uncontrolled pumping,0,0,0,0,1,0,0,1
undercurrent hits,0,0,1,0,0,0,0,1
undergoing surgery,0,0,0,1,0,0,0,1
underground fires,0,0,0,0,1,0,0,1
underground mining,1,0,0,0,0,0,0,1
underground municipal,0,0,0,1,0,0,0,1
underground tank,0,0,0,0,1,0,0,1
underlying psychology,0,0,0,1,0,0,0,1
underlying tension,0,1,0,0,0,0,0,1
underreporting prevents,0,1,0,0,0,0,0,1
underserved women,1,0,0,0,0,0,0,1
understand issues,1,0,0,0,0,0,0,1
understand larger,0,0,0,1,0,0,0,1
understandably scared,0,0,0,1,0,0,0,1
understands arabic,0,1,0,0,0,0,0,1
understated design,0,1,0,0,0,0,0,1
understood development,1,0,0,0,0,0,0,1
underwater highway,1,0,0,0,0,0,0,1
underwater microphones,1,0,0,0,0,0,0,1
underwater surveying,0,0,0,0,1,0,0,1
undisturbed public,0,0,0,0,0,1,0,1
unelected leadership,0,0,0,1,0,0,0,1
unemployment climbing,0,0,0,0,0,1,0,1
unemployment remains,0,0,0,0,0,1,0,1
unesco adding,0,1,0,0,0,0,0,1
unesco director,0,1,0,0,0,0,0,1
unesco makes,0,1,0,0,0,0,0,1
unesco world,0,1,0,0,0,0,0,1
unesco's report,0,1,0,0,0,0,0,1
unethical practices,0,0,1,0,0,0,0,1
uneven rows,0,1,0,0,0,0,0,1
unevenly enforced,0,0,0,0,1,0,0,1
unexpected dry,0,1,0,0,0,0,0,1
unfettered flooding,0,1,0,0,0,0,0,1
unfolding specifically,1,0,0,0,0,0,0,1
unforeseen biological,0,1,0,0,0,0,0,1
unforgiving space,0,0,0,0,0,1,0,1
unfortunate politicization,0,0,0,0,1,0,0,1
unfortunate situation,0,0,0,0,0,1,0,1
unfounded claim,0,0,0,0,1,0,0,1
ungloved hands,0,0,1,0,0,0,0,1
unharmed critics,0,1,0,0,0,0,0,1
unhealthy trees,0,0,1,0,0,0,0,1
unhoused people,0,0,0,0,1,0,0,1
unhoused populations,0,1,0,0,0,0,0,1
unhurt chainsaws,0,0,0,0,0,0,1,1
unified agreement,0,0,0,0,1,0,0,1
unified message,0,0,0,0,0,1,0,1
uniformed services,0,1,0,0,0,0,0,1
uniformly committed,0,0,0,1,0,0,0,1
unimaginably vast,1,0,0,0,0,0,0,1
unincorporated lee,1,0,0,0,0,0,0,1
unincorporated sliver,0,0,0,0,1,0,0,1
uninhabitable bitton,0,0,0,0,1,0,0,1
union approved,0,0,0,0,0,1,0,1
union hide,0,0,1,0,0,0,0,1
union jobs,0,0,0,0,0,1,0,1
union meet,0,0,0,0,0,0,1,1
union representing,0,0,0,0,0,1,0,1
union single,0,0,0,1,0,0,0,1
union visits,0,0,0,0,0,1,0,1
unique environment,0,1,0,0,0,0,0,1
unique flavor.for,0,0,0,0,0,0,1,1
unique letters,0,0,0,0,0,1,0,1
unique monthly,0,0,1,0,0,0,0,1
unique solution,1,0,0,0,0,0,0,1
universal language,0,0,0,1,0,0,0,1
universal trends,0,0,0,0,0,1,0,1
universities warn,0,0,0,0,1,0,0,1
university agriculture,0,0,0,0,1,0,0,1
university bacteria,0,1,0,0,0,0,0,1
university citizens,0,0,0,0,1,0,0,1
university climate,0,0,0,1,0,0,0,1
university environment,0,0,0,1,0,0,0,1
university extension,0,1,0,0,0,0,0,1
university featured,0,0,0,0,0,1,0,1
university geologist,1,0,0,0,0,0,0,1
university glaciologist,0,0,0,0,1,0,0,1
university historian,0,0,1,0,0,0,0,1
university ice,0,0,0,0,1,0,0,1
university invariably,0,0,0,1,0,0,0,1
university lawrence,0,0,0,0,1,0,0,1
university medical,0,0,0,0,1,0,0,1
university meteorology,0,0,0,1,0,0,0,1
university tall,0,0,0,0,0,1,0,1
university top,0,1,0,0,0,0,0,1
university tornado,0,0,0,0,0,1,0,1
university warned,0,0,0,0,1,0,0,1
university wrote,0,0,0,0,0,1,0,1
university's noah,0,0,0,1,0,0,0,1
unknowing population,0,0,0,0,0,1,0,1
unknowingly immersing,0,0,1,0,0,0,0,1
unlawful entry,0,1,0,0,0,0,0,1
unlawful imprisonment,0,0,0,0,1,0,0,1
unlicensed palm,0,0,0,0,0,0,1,1
unlike companies,1,0,0,0,0,0,0,1
unlike indonesia,0,0,0,0,0,0,1,1
unlivable conditions,0,1,0,0,0,0,0,1
unlivable late,0,0,0,0,1,0,0,1
unloads stacking,1,0,0,0,0,0,0,1
unlock billions,0,1,0,0,0,0,0,1
unlock private,0,1,0,0,0,0,0,1
unnatural disasters,0,0,0,0,1,0,0,1
unparalleled protections,0,0,0,0,0,1,0,1
unprecedented change,0,1,0,0,0,0,0,1
unprecedented feat,0,0,1,0,0,0,0,1
unprecedented interventions,1,0,0,0,0,0,0,1
unprecedented monsoon,1,0,0,0,0,0,0,1
unprecedented population,0,0,0,0,0,1,0,1
unprecedented red,0,0,0,1,0,0,0,1
unprecedented storm,0,0,0,0,0,1,0,1
unprecedented strain,0,1,0,0,0,0,0,1
unprecedented wet,1,0,0,0,0,0,0,1
unpredictable climate,0,1,0,0,0,0,0,1
unpredictable crops,0,1,0,0,0,0,0,1
unpredictable weather,0,1,0,0,0,0,0,1
unprepared agency,0,0,0,0,0,0,1,1
unquote breadbasket,0,0,1,0,0,0,0,1
unrealistic patchwork,0,0,0,0,0,1,0,1
unreliable energy,0,0,0,0,1,0,0,1
unreliable rain,0,1,0,0,0,0,0,1
unrepaired damage,0,1,0,0,0,0,0,1
unsafe gun,0,0,0,0,1,0,0,1
unseasonably warm,0,0,0,1,0,0,0,1
unseen lobbying,0,0,1,0,0,0,0,1
unsheltered people,0,0,0,0,1,0,0,1
unsustainable debts,1,0,0,0,0,0,0,1
unsustainable track,0,1,0,0,0,0,0,1
untapped solar,0,0,0,0,1,0,0,1
untilled ground,0,1,0,0,0,0,0,1
untouched reefs,0,1,0,0,0,0,0,1
untreated wastewater,0,0,0,0,0,1,0,1
unused fruits,0,1,0,0,0,0,0,1
unusual cold,0,0,0,0,1,0,0,1
unusual discovery,0,0,0,1,0,0,0,1
unusual guantanamo,0,0,0,0,1,0,0,1
unusual mortality,0,0,0,0,1,0,0,1
unusual scrutiny,0,0,1,0,0,0,0,1
unusually heavy,1,0,0,0,0,0,0,1
unusually snowy,0,0,0,0,1,0,0,1
unusually wavy,0,0,0,1,0,0,0,1
unveiled bills,0,0,0,0,1,0,0,1
unveiled monday,0,1,0,0,0,0,0,1
upcoming decision,0,1,0,0,0,0,0,1
upcoming round,0,0,0,0,1,0,0,1
upcoming tax,0,0,0,0,0,0,1,1
upcoming trade,0,0,0,0,1,0,0,1
upcoming trends,0,0,0,0,1,0,0,1
upcoming united,0,0,0,1,0,0,0,1
updating flood,1,0,0,0,0,0,0,1
updraft enables,0,0,0,0,0,1,0,1
upgrade flash,0,1,0,0,0,0,0,1
upgrading paddy's,0,0,0,1,0,0,0,1
upheld restrictions,0,0,0,0,0,1,0,1
uphill trek,0,0,0,0,0,1,0,1
uplands colville,0,0,0,0,0,1,0,1
upper air,0,0,0,0,1,0,0,1
upper echelons,0,0,0,0,1,0,0,1
upper floor,0,1,0,0,0,0,0,1
upper limit,0,0,0,1,0,0,0,1
upper tana,0,0,0,0,0,1,0,1
upright amid,0,1,0,0,0,0,0,1
uproar amid,0,0,0,0,1,0,0,1
uproot people's,0,0,0,0,1,0,0,1
upscale neighborhood,0,1,0,0,0,0,0,1
upset environmentalists,0,0,0,1,0,0,0,1
upside food's,0,1,0,0,0,0,0,1
upside's cultivated,0,1,0,0,0,0,0,1
upside's production,0,1,0,0,0,0,0,1
upstream people,0,0,0,0,1,0,0,1
urban centers,0,0,0,1,0,0,0,1
urban demand,0,0,0,0,0,1,0,1
urban dwellers,0,0,0,0,1,0,0,1
urban expansion,0,1,0,0,0,0,0,1
urban growth,0,0,0,0,1,0,0,1
urban infrastructure,0,0,0,1,0,0,0,1
urban planners,1,0,0,0,0,0,0,1
urban planning,0,0,0,0,1,0,0,1
urban populations,0,0,0,1,0,0,0,1
urban search,1,0,0,0,0,0,0,1
urban wastewater,0,0,0,0,0,1,0,1
urban wildlife,0,0,1,0,0,0,0,1
urdu alphabet,1,0,0,0,0,0,0,1
urge residents,0,0,0,1,0,0,0,1
urged people,0,1,0,0,0,0,0,1
urged stronger,0,0,0,0,0,1,0,1
urged swift,0,0,0,0,0,1,0,1
urged world,0,0,0,0,0,0,1,1
urgency signaled,0,1,0,0,0,0,0,1
urgent call,0,1,0,0,0,0,0,1
urgent efforts,0,0,1,0,0,0,0,1
urgent health,1,0,0,0,0,0,0,1
urgent joshi,0,0,0,0,0,1,0,1
urgent priority,1,0,0,0,0,0,0,1
urgent rummer,0,1,0,0,0,0,0,1
ursula von,0,0,0,0,0,1,0,1
usda funding,0,0,0,1,0,0,0,1
users repeated,0,0,0,0,0,1,0,1
usual messaging,0,1,0,0,0,0,0,1
usual route,0,0,0,1,0,0,0,1
usual yeah,0,0,0,0,0,0,1,1
utah arizona,0,0,0,1,0,0,0,1
utah governor,0,0,0,0,1,0,0,1
utah lawmakers,0,0,0,0,1,0,0,1
utah leaders,0,0,0,0,1,0,0,1
utah physicians,0,0,0,0,1,0,0,1
utah study,0,0,0,0,1,0,0,1
utah universities,0,0,0,0,1,0,0,1
utah's famous,0,0,0,0,1,0,0,1
utah's largest,0,0,0,0,1,0,0,1
utilities developed,0,0,0,1,0,0,0,1
utilities discharging,0,0,0,1,0,0,0,1
utilities feature,0,0,0,1,0,0,0,1
utilities profits,0,0,1,0,0,0,0,1
utilities reimburse,0,0,0,0,1,0,0,1
utilities switch,0,0,0,1,0,0,0,1
utility based,0,0,1,0,0,0,0,1
utility bill,0,1,0,0,0,0,0,1
utility commission,0,0,0,0,1,0,0,1
utility crews,0,0,0,0,0,0,1,1
utility customers,0,0,0,0,1,0,0,1
utility district,0,0,0,1,0,0,0,1
utility florida,0,0,1,0,0,0,0,1
utility manager,0,1,0,0,0,0,0,1
utility pole,0,0,0,1,0,0,0,1
utility scale,0,0,0,1,0,0,0,1
utility services,0,0,0,0,0,1,0,1
utility's net,0,0,1,0,0,0,0,1
utukok uplands,0,0,0,0,0,1,0,1
va tucked,0,0,0,0,1,0,0,1
vacated development,0,0,0,0,0,1,0,1
vacations upended,0,0,1,0,0,0,0,1
vaccine alliance,0,0,0,0,0,1,0,1
vaccine developed,0,0,0,1,0,0,0,1
vaccine immediately,0,0,0,0,0,1,0,1
vacuum carbon,0,0,0,0,1,0,0,1
vague promises,0,1,0,0,0,0,0,1
vaibhav chaturvedi,0,0,0,0,1,0,0,1
valadez estimates,0,0,0,0,0,1,0,1
valencia spain,0,0,0,0,0,1,0,1
valentine's flood,0,0,0,1,0,0,0,1
valentine's weekend,0,0,0,1,0,0,0,1
valeti acknowledged,0,1,0,0,0,0,0,1
valeti brian,0,1,0,0,0,0,0,1
valeti quickly,0,1,0,0,0,0,0,1
valeti told,0,1,0,0,0,0,0,1
valeti's leap,0,1,0,0,0,0,0,1
valid concerns,0,0,0,0,1,0,0,1
valid rights,0,0,0,0,0,1,0,1
valley groundwater,0,0,0,0,0,1,0,1
valley including,0,0,0,1,0,0,0,1
valley residents,0,0,0,1,0,0,0,1
valley san,0,0,0,1,0,0,0,1
valley stretches,0,0,0,0,0,1,0,1
valley tainted,0,0,0,0,0,1,0,1
valuable ambassador,0,0,1,0,0,0,0,1
valuable assets,1,0,0,0,0,0,0,1
valuable atmospheric,0,0,0,0,1,0,0,1
valuable information,0,0,0,1,0,0,0,1
valuable source,0,1,0,0,0,0,0,1
valued stakeholders,0,0,1,0,0,0,0,1
valuing light,0,0,0,0,1,0,0,1
valuing lives,0,0,0,0,1,0,0,1
van gogh,0,1,0,0,0,0,0,1
van gogh's,0,1,0,0,0,0,0,1
vanderbilt institute,0,0,0,0,1,0,0,1
vanderbilt university,0,0,0,0,1,0,0,1
vanessa castillo,0,1,0,0,0,0,0,1
vannatter's land,1,0,0,0,0,0,0,1
vans drop,0,0,0,0,0,1,0,1
vanuatu vanuatu,0,0,0,1,0,0,0,1
vapor driving,0,0,0,1,0,0,0,1
variable bolendra,0,1,0,0,0,0,0,1
variable rainfall,0,1,0,0,0,0,0,1
variable weather,0,0,1,0,0,0,0,1
varies widely,0,0,0,0,0,1,0,1
varying levels,0,1,0,0,0,0,0,1
vast amounts,0,0,0,1,0,0,0,1
vast aquifers,0,0,0,0,0,1,0,1
vast blankets,0,0,0,0,1,0,0,1
vast economic,0,1,0,0,0,0,0,1
vast expanse,0,0,1,0,0,0,0,1
vast irrigated,1,0,0,0,0,0,0,1
vast marine,0,0,0,0,1,0,0,1
vast mineral,0,0,0,0,1,0,0,1
vast snow,0,0,0,0,0,1,0,1
vast swath,0,0,0,0,0,1,0,1
vast tracts,0,0,0,0,1,0,0,1
vast utility,0,0,1,0,0,0,0,1
vegan stopped,0,1,0,0,0,0,0,1
vegetables fruits,0,1,0,0,0,0,0,1
vegetated overpass,0,0,1,0,0,0,0,1
vegetation data,0,0,0,0,0,1,0,1
vegetation died,0,1,0,0,0,0,0,1
vegetation increases,0,0,0,1,0,0,0,1
vegetation mohamed,0,0,0,1,0,0,0,1
vehicle batteries.one,0,0,1,0,0,0,0,1
vehicle chargers,0,0,0,0,1,0,0,1
vehicle charging,0,0,0,0,1,0,0,1
vehicle crashes,1,0,0,0,0,0,0,1
vehicle daniel,0,0,0,0,1,0,0,1
vehicle emission,0,0,0,0,0,1,0,1
vehicle future,0,0,1,0,0,0,0,1
vehicle ideally,0,0,1,0,0,0,0,1
vehicle production,0,0,0,0,0,1,0,1
vehicle segments,0,0,0,0,1,0,0,1
vehicle standards,0,0,0,0,1,0,0,1
vehicle strike,0,0,1,0,0,0,0,1
vehicles beginning,0,0,0,0,0,1,0,1
vehicles canada,0,0,0,0,0,1,0,1
vehicles canada's,0,0,0,0,0,1,0,1
vehicles emit,0,0,0,0,0,1,0,1
vehicles european,0,0,0,0,0,1,0,1
vehicles gabriel,0,0,0,0,0,1,0,1
vehicles grows,0,0,1,0,0,0,0,1
vehicles include,0,0,0,0,0,1,0,1
vehicles including,0,0,0,0,0,1,0,1
vehicles powered,0,0,0,0,1,0,0,1
vehicles remain,0,0,0,0,1,0,0,1
vehicles rick,0,0,0,0,1,0,0,1
vehicles slowing,0,0,0,0,1,0,0,1
vehicles sold,0,0,0,1,0,0,0,1
vehicles wind,0,0,0,1,0,0,0,1
veil picked,1,0,0,0,0,0,0,1
veltman npr,0,1,0,0,0,0,0,1
venezuela responding,0,0,0,0,0,1,0,1
venezuela yuri,0,0,0,0,0,1,0,1
vented outdoors,0,0,0,0,1,0,0,1
venton reports,0,0,0,1,0,0,0,1
vents outdoors,0,0,0,0,1,0,0,1
ventura calif,0,0,0,0,0,1,0,1
ventura counties,0,0,0,1,0,0,0,1
ventura freeway,0,0,1,0,0,0,0,1
venues centers,0,1,0,0,0,0,0,1
venues restoring,0,1,0,0,0,0,0,1
verdugo mountains,0,0,1,0,0,0,0,1
verifiable result,0,1,0,0,0,0,0,1
verified information,0,1,0,0,0,0,0,1
verywell health,0,0,0,0,0,1,0,1
vessel decorated,1,0,0,0,0,0,0,1
vessel strike,0,0,0,0,1,0,0,1
vet quality,0,1,0,0,0,0,0,1
veteran diplomat,0,0,0,1,0,0,0,1
veteran technocrat,0,0,0,1,0,0,0,1
veteran tom,0,1,0,0,0,0,0,1
veteran's day,0,1,0,0,0,0,0,1
veto proof,0,1,0,0,0,0,0,1
viability derocher,0,0,1,0,0,0,0,1
viable technique,0,1,0,0,0,0,0,1
viana notes,0,0,0,1,0,0,0,1
viana writes,0,0,0,1,0,0,0,1
viana's article,0,0,0,1,0,0,0,1
vibrant biologically,1,0,0,0,0,0,0,1
vic fedeli,0,0,0,0,0,1,0,1
vice chair,0,1,0,0,0,0,0,1
vice mayor,0,0,0,0,1,0,0,1
vicinity coo,1,0,0,0,0,0,0,1
vickie patton,0,0,0,1,0,0,0,1
victims meloni,0,1,0,0,0,0,0,1
victor andasan,0,0,0,0,0,1,0,1
victoria hatcher,1,0,0,0,0,0,0,1
victory now.but,0,1,0,0,0,0,0,1
video outlet,0,0,0,0,0,1,0,1
video pleading,0,0,1,0,0,0,0,1
video provided,1,0,0,0,0,0,0,1
videos outlining,0,0,0,0,0,1,0,1
viet le,0,0,1,0,0,0,0,1
vietnam veteran,0,1,0,0,0,0,0,1
view climate,0,0,0,1,0,0,0,1
view destruction,1,0,0,0,0,0,0,1
view gas,0,0,0,1,0,0,0,1
view telling,1,0,0,0,0,0,0,1
view water,0,0,0,0,0,1,0,1
viewed millions,0,0,0,0,0,1,0,1
viewers online,0,1,0,0,0,0,0,1
views misleading,1,0,0,0,0,0,0,1
vigorous modern,1,0,0,0,0,0,0,1
village additional,1,0,0,0,0,0,0,1
village called,1,0,0,0,0,0,0,1
village caved,0,0,0,0,1,0,0,1
village diaa,1,0,0,0,0,0,0,1
village ghansadih,0,0,0,0,1,0,0,1
village including,0,0,0,0,1,0,0,1
village lies,1,0,0,0,0,0,0,1
village survived,0,0,0,0,0,1,0,1
villagers fled,1,0,0,0,0,0,0,1
villages firewood,0,0,1,0,0,0,0,1
villainous tech,0,0,0,0,0,0,1,1
vince leone,0,0,1,0,0,0,0,1
vines grow,0,0,0,1,0,0,0,1
vinyl map,0,1,0,0,0,0,0,1
violence begins,0,0,0,1,0,0,0,1
violence broke,0,1,0,0,0,0,0,1
violently rotating,0,0,0,0,0,1,0,1
violet baker,0,1,0,0,0,0,0,1
viral misinformation,0,0,0,1,0,0,0,1
viral sample,0,0,0,0,0,1,0,1
virgin islands,0,0,0,0,0,1,0,1
virginia beautiful,1,0,0,0,0,0,0,1
virginia coast,0,1,0,0,0,0,0,1
virginia county,0,0,0,0,1,0,0,1
virginia gov,1,0,0,0,0,0,0,1
virginia houser,0,0,0,0,1,0,0,1
virginia jake,0,0,0,0,1,0,0,1
virginia ph,0,1,0,0,0,0,0,1
virginia task,1,0,0,0,0,0,0,1
virtually tied,0,1,0,0,0,0,0,1
virtually untouched,0,1,0,0,0,0,0,1
virus diagnosis,0,0,0,0,0,1,0,1
virus disease,0,0,0,0,0,1,0,1
virus public,0,0,0,0,0,1,0,1
virus spreads,0,0,0,0,0,1,0,1
virus toting,0,0,0,0,0,1,0,1
viruses moving,0,0,0,0,0,1,0,1
visas visas,0,1,0,0,0,0,0,1
visible authority,0,0,1,0,0,0,0,1
visible issue,0,1,0,0,0,0,0,1
visible shimmering,0,0,0,0,1,0,0,1
visible winnie,0,1,0,0,0,0,0,1
vision hyndside,0,0,0,1,0,0,0,1
visit africa,0,1,0,0,0,0,0,1
visit crawford,0,0,0,0,0,0,1,1
visit national,0,1,0,0,0,0,0,1
visit senegal,0,1,0,0,0,0,0,1
visit times,0,0,0,0,1,0,0,1
visited arcadia,1,0,0,0,0,0,0,1
visited goree,1,0,0,0,0,0,0,1
visited masdar,0,0,0,1,0,0,0,1
visiting scholar,0,0,0,0,1,0,0,1
visitor's grandfather's,0,1,0,0,0,0,0,1
visitors insights,0,1,0,0,0,0,0,1
visits home,0,1,0,0,0,0,0,1
visits president,0,0,0,0,0,1,0,1
visual dance,0,1,0,0,0,0,0,1
visual images,0,0,0,1,0,0,0,1
visual storyteller,0,1,0,0,0,0,0,1
visually confirm,0,0,0,0,0,1,0,1
vital neurological,0,0,0,0,1,0,0,1
vital supplies,0,0,0,0,0,1,0,1
vitamins iron,1,0,0,0,0,0,0,1
vitor espirito,0,1,0,0,0,0,0,1
viviana figueroa,0,0,1,0,0,0,0,1
vladimir putin,0,1,0,0,0,0,0,1
vocal repertoire,0,0,0,0,0,1,0,1
vocalist kevin,0,1,0,0,0,0,0,1
vocally skeptical,0,0,0,0,1,0,0,1
vogel ap,0,0,0,0,1,0,0,1
voiced frustration,0,1,0,0,0,0,0,1
voices fellow,0,0,0,0,1,0,0,1
voices university,0,1,0,0,0,0,0,1
void left,0,0,1,0,0,0,0,1
volcanic eruptions,1,0,0,0,0,0,0,1
volkswagen navistar,0,0,1,0,0,0,0,1
volodymyr zelenskyy,0,1,0,0,0,0,0,1
volpe president,0,0,0,0,0,1,0,1
voluntary basis,0,0,0,0,0,1,0,1
voluntary carbon,0,1,0,0,0,0,0,1
voluntary measures,1,0,0,0,0,0,0,1
volunteer army,0,0,0,0,1,0,0,1
volunteer basis,0,0,0,0,1,0,0,1
volunteer calls,1,0,0,0,0,0,0,1
volunteer firefighters,0,0,1,0,0,0,0,1
volunteer fireman,0,0,0,1,0,0,0,1
volunteer softball,0,1,0,0,0,0,0,1
volunteers award,0,1,0,0,0,0,0,1
volunteers ferried,1,0,0,0,0,0,0,1
volunteers gather,0,0,0,0,0,1,0,1
volunteers nelson,0,0,0,0,0,1,0,1
volunteers plan,0,0,0,0,0,1,0,1
volunteers weigh,0,0,0,0,0,1,0,1
volvo daimler,0,0,1,0,0,0,0,1
vomiting chest,0,0,0,0,0,1,0,1
vote counts,0,1,0,0,0,0,0,1
vote npr's,0,0,0,0,1,0,0,1
vote president,0,0,0,0,0,1,0,1
vote ralston,0,0,0,0,1,0,0,1
vote trump,0,1,0,0,0,0,0,1
voter focused,0,0,0,0,1,0,0,1
voters polls,1,0,0,0,0,0,0,1
voting rights,0,0,0,1,0,0,0,1
vox news,0,1,0,0,0,0,0,1
voyage wrote,0,0,0,0,0,1,0,1
vucci ap,1,0,0,0,0,0,0,1
vujnovich jr,0,1,0,0,0,0,0,1
vulnerability index,0,0,0,1,0,0,0,1
vulnerable build,0,1,0,0,0,0,0,1
vulnerable citizens,0,0,0,0,0,1,0,1
vulnerable climate,0,1,0,0,0,0,0,1
vulnerable housing,0,0,0,0,0,1,0,1
vulnerable marsh,0,1,0,0,0,0,0,1
vulnerable nations,0,1,0,0,0,0,0,1
vulnerable regions,0,0,0,0,0,1,0,1
vulnerable residents,0,0,0,1,0,0,0,1
vulnerable resources,0,0,0,0,0,1,0,1
vulnerable villages,0,0,0,0,1,0,0,1
wabe reports,0,0,0,1,0,0,0,1
waer reporter,0,0,0,0,1,0,0,1
wage regions,0,0,0,0,0,1,0,1
wah umngi,0,0,0,0,0,1,0,1
wailing toddler,1,0,0,0,0,0,0,1
wait drags,0,0,0,0,0,1,0,1
wait till,0,1,0,0,0,0,0,1
wait wait,0,0,0,0,1,0,0,1
waiting boat,1,0,0,0,0,0,0,1
waiting hours,1,0,0,0,0,0,0,1
waiting women,1,0,0,0,0,0,0,1
wales approved,0,0,0,1,0,0,0,1
walk laps,0,1,0,0,0,0,0,1
walk past,0,1,0,0,0,0,0,1
walk takes,1,0,0,0,0,0,0,1
walk's green,1,0,0,0,0,0,0,1
walkable communities,0,0,0,0,1,0,0,1
walked past,0,1,0,0,0,0,0,1
walked swam,0,0,1,0,0,0,0,1
walker ashley,0,0,0,0,0,1,0,1
walking creeks,0,0,0,1,0,0,0,1
wall brian,0,1,0,0,0,0,0,1
wall mohamed,0,0,0,1,0,0,0,1
wall yeah,0,1,0,0,0,0,0,1
walloped south,0,0,0,1,0,0,0,1
walls putting,0,1,0,0,0,0,0,1
walrus carcasses,0,0,0,1,0,0,0,1
walruses ice,0,0,0,0,0,1,0,1
wam quoted,0,0,0,1,0,0,0,1
wanna send,0,0,0,0,1,0,0,1
war cpsc,0,0,0,0,1,0,0,1
war dragging,0,0,0,1,0,0,0,1
war el,0,0,0,1,0,0,0,1
war famine,0,1,0,0,0,0,0,1
war story,0,0,1,0,0,0,0,1
war yeah,0,1,0,0,0,0,0,1
war zone,0,0,0,1,0,0,0,1
warehouse dense,0,0,0,0,0,1,0,1
warehouses restaurant,0,1,0,0,0,0,0,1
warm air,0,0,0,1,0,0,0,1
warm arctic,0,0,0,1,0,0,0,1
warm elizabeth,0,0,1,0,0,0,0,1
warm fall,0,1,0,0,0,0,0,1
warm kqed,0,0,0,0,1,0,0,1
warm lake,0,0,0,1,0,0,0,1
warm light,0,1,0,0,0,0,0,1
warm rain,0,0,0,0,0,1,0,1
warm saturday,0,0,0,0,1,0,0,1
warm scientists,0,1,0,0,0,0,0,1
warm sea,0,0,0,1,0,0,0,1
warm subtropics,0,0,0,1,0,0,0,1
warm ties,0,0,1,0,0,0,0,1
warm water,0,0,1,0,0,0,0,1
warm weather,0,0,0,0,0,1,0,1
warm winds,0,0,0,0,0,1,0,1
warmer climate,0,1,0,0,0,0,0,1
warmer oceans,0,1,0,0,0,0,0,1
warmer plankton,0,0,0,0,0,1,0,1
warmer storm,0,0,0,0,0,1,0,1
warmer water,0,0,0,0,1,0,0,1
warmer world,0,0,0,0,0,0,1,1
warming atmosphere,1,0,0,0,0,0,0,1
warming contributes,0,1,0,0,0,0,0,1
warming countries,1,0,0,0,0,0,0,1
warming data,0,0,0,1,0,0,0,1
warming dead,0,0,0,1,0,0,0,1
warming decimated,0,1,0,0,0,0,0,1
warming effects,0,0,0,1,0,0,0,1
warming extends,1,0,0,0,0,0,0,1
warming faster,0,0,1,0,0,0,0,1
warming found,1,0,0,0,0,0,0,1
warming goals,0,1,0,0,0,0,0,1
warming gora,0,0,1,0,0,0,0,1
warming greenhouse,0,0,1,0,0,0,0,1
warming hsiang's,0,0,0,0,0,1,0,1
warming huts,0,0,0,0,1,0,0,1
warming limit,0,0,0,1,0,0,0,1
warming markus,0,0,1,0,0,0,0,1
warming methane,0,1,0,0,0,0,0,1
warming past,0,0,0,1,0,0,0,1
warming potential,0,0,0,0,0,0,1,1
warming requires,0,0,0,0,1,0,0,1
warming ryan,0,1,0,0,0,0,0,1
warming scenario,0,0,0,0,0,1,0,1
warming schaeffer,0,0,1,0,0,0,0,1
warming shelters,0,0,0,0,1,0,0,1
warming simulation,0,0,0,0,0,1,0,1
warming studies,0,0,0,0,0,0,1,1
warming that'll,0,0,0,0,0,0,1,1
warming vulnerable,0,1,0,0,0,0,0,1
warming watch,0,1,0,0,0,0,0,1
warming world,0,0,0,1,0,0,0,1
warming worsens,0,0,0,0,0,1,0,1
warms california,0,0,0,1,0,0,0,1
warms city,1,0,0,0,0,0,0,1
warn texans,0,0,0,0,1,0,0,1
warned ahead,0,1,0,0,0,0,0,1
warned lawmakers,0,0,0,0,0,0,1,1
warned valeti's,0,1,0,0,0,0,0,1
warning bells,1,0,0,0,0,0,0,1
warning measures,0,1,0,0,0,0,0,1
warning nur,0,0,0,0,0,1,0,1
warning people,0,0,0,1,0,0,0,1
warning period,0,0,0,0,0,1,0,1
warning remains,0,0,0,0,1,0,0,1
warning residents,0,1,0,0,0,0,0,1
warnings persisted,0,1,0,0,0,0,0,1
warnings save,0,1,0,0,0,0,0,1
warp speed,0,0,0,0,0,1,0,1
warped wood,0,1,0,0,0,0,0,1
warren oregon,1,0,0,0,0,0,0,1
warren snowdon,0,1,0,0,0,0,0,1
wasatch mountains,0,0,0,0,1,0,0,1
wash vegetables,0,0,0,0,1,0,0,1
washing machine,0,0,0,0,0,0,1,1
washington governor,0,0,0,0,1,0,0,1
washington hey,0,1,0,0,0,0,0,1
washington jessica,0,0,0,0,1,0,0,1
washington mall,0,0,0,0,1,0,0,1
washington missed,0,0,0,0,1,0,0,1
washington npr,0,0,0,1,0,0,0,1
washington politics,0,0,0,1,0,0,0,1
washington summit's,0,0,0,0,1,0,0,1
washington tours,0,1,0,0,0,0,0,1
washington weather,0,0,0,0,1,0,0,1
washington world,1,0,0,0,0,0,0,1
washington yeah,0,0,0,0,0,1,0,1
washington's house,1,0,0,0,0,0,0,1
washington's policy,0,0,0,0,1,0,0,1
washouts combine,0,1,0,0,0,0,0,1
waste grease,1,0,0,0,0,0,0,1
waste management,1,0,0,0,0,0,0,1
waste media,0,0,0,1,0,0,0,1
wastewater globally,0,0,0,0,0,1,0,1
wastewater including,0,0,0,0,0,1,0,1
wastewater industry,0,0,0,1,0,0,0,1
wastewater rats,0,0,0,0,0,1,0,1
wastewater reuse,0,0,0,1,0,0,0,1
watch extends,0,1,0,0,0,0,0,1
watch netflix,0,0,0,1,0,0,0,1
watch noting,1,0,0,0,0,0,0,1
watch rehman's,0,1,0,0,0,0,0,1
watch send,1,0,0,0,0,0,0,1
watchdog influencemap,0,0,1,0,0,0,0,1
watchdog warned,0,0,0,0,0,0,1,1
watched boats,1,0,0,0,0,0,0,1
watched otters,0,1,0,0,0,0,0,1
watches remain,0,1,0,0,0,0,0,1
watches thursday,0,0,0,0,0,1,0,1
watching closest,0,1,0,0,0,0,0,1
watching episodes,0,0,0,0,1,0,0,1
watching negotiations,0,0,0,0,1,0,0,1
water access,0,0,0,0,0,1,0,1
water advisor,0,0,0,0,1,0,0,1
water agencies,0,0,0,1,0,0,0,1
water allocation,0,0,0,1,0,0,0,1
water allowed,1,0,0,0,0,0,0,1
water availability,0,0,0,1,0,0,0,1
water basins,0,0,0,0,0,1,0,1
water body,1,0,0,0,0,0,0,1
water buckeye,0,0,0,0,1,0,0,1
water carried,0,1,0,0,0,0,0,1
water carved,1,0,0,0,0,0,0,1
water center,0,0,0,0,0,1,0,1
water central,1,0,0,0,0,0,0,1
water coming,0,0,0,1,0,0,0,1
water considered,0,0,1,0,0,0,0,1
water created,0,1,0,0,0,0,0,1
water creates,0,0,1,0,0,0,0,1
water customers,0,1,0,0,0,0,0,1
water cutbacks,0,0,0,0,0,1,0,1
water cuts,0,0,0,0,1,0,0,1
water deadly,0,1,0,0,0,0,0,1
water delivery,0,1,0,0,0,0,0,1
water demand,0,0,0,0,1,0,0,1
water depth,0,1,0,0,0,0,0,1
water destroyed,1,0,0,0,0,0,0,1
water disputes,0,0,0,0,0,1,0,1
water distribution,1,0,0,0,0,0,0,1
water droplets,0,0,0,0,0,1,0,1
water due,1,0,0,0,0,0,0,1
water edged,0,0,0,0,0,1,0,1
water electricity,1,0,0,0,0,0,0,1
water expert,0,0,0,0,0,1,0,1
water extreme,0,0,0,0,0,1,0,1
water facilities,0,0,0,1,0,0,0,1
water falling,0,0,0,0,0,1,0,1
water falls,0,0,0,1,0,0,0,1
water flood,0,1,0,0,0,0,0,1
water flowing,1,0,0,0,0,0,0,1
water flows,0,0,0,1,0,0,0,1
water food,0,0,0,0,0,1,0,1
water freezes,1,0,0,0,0,0,0,1
water globally,0,0,0,0,0,1,0,1
water grant,1,0,0,0,0,0,0,1
water groundwater,0,0,0,0,1,0,0,1
water gulping,0,0,0,0,1,0,0,1
water hauling,0,0,0,0,1,0,0,1
water heading,1,0,0,0,0,0,0,1
water hit,0,0,0,0,1,0,0,1
water home,0,0,0,0,0,1,0,1
water hook,0,0,0,0,0,1,0,1
water hungry,0,0,0,0,0,1,0,1
water hyacinth,0,0,0,0,0,1,0,1
water ice,0,1,0,0,0,0,0,1
water initiatives,0,0,0,0,0,0,1,1
water insecure,0,0,0,0,0,1,0,1
water jose,0,0,0,1,0,0,0,1
water land,1,0,0,0,0,0,0,1
water lauren,0,0,0,0,0,1,0,1
water leaps,0,0,0,0,0,1,0,1
water learn,0,0,0,0,1,0,0,1
water lifeline,0,0,0,1,0,0,0,1
water line,0,1,0,0,0,0,0,1
water locally,0,0,0,0,0,1,0,1
water management,0,0,0,0,0,1,0,1
water managers,0,0,0,1,0,0,0,1
water mark,0,1,0,0,0,0,0,1
water marks,1,0,0,0,0,0,0,1
water mexico,0,0,0,0,0,1,0,1
water mobile,1,0,0,0,0,0,0,1
water nestling,0,0,0,1,0,0,0,1
water nibbles,0,0,0,0,1,0,0,1
water notice,1,0,0,0,0,0,0,1
water npr's,0,0,0,0,1,0,0,1
water orsborn,0,0,0,0,1,0,0,1
water overwhelmed,0,1,0,0,0,0,0,1
water page,0,1,0,0,0,0,0,1
water pans,1,0,0,0,0,0,0,1
water park,0,1,0,0,0,0,0,1
water past,1,0,0,0,0,0,0,1
water policymakers,0,0,0,0,0,1,0,1
water pouring,1,0,0,0,0,0,0,1
water prediction,0,0,0,1,0,0,0,1
water pump,1,0,0,0,0,0,0,1
water purposes,0,0,0,0,0,1,0,1
water raises,0,0,0,0,1,0,0,1
water rates,0,1,0,0,0,0,0,1
water recently,0,0,0,0,0,1,0,1
water regulation,0,0,1,0,0,0,0,1
water rely,0,0,0,0,0,1,0,1
water rescue,0,0,0,1,0,0,0,1
water rescues,0,0,0,0,1,0,0,1
water rises,1,0,0,0,0,0,0,1
water runoff,0,0,0,0,0,1,0,1
water runs,0,0,0,1,0,0,0,1
water samples,0,0,0,1,0,0,0,1
water saved,1,0,0,0,0,0,0,1
water schools,0,1,0,0,0,0,0,1
water sector,0,0,0,1,0,0,0,1
water seeps,0,0,0,1,0,0,0,1
water soaked,0,1,0,0,0,0,0,1
water sounds,1,0,0,0,0,0,0,1
water sources,0,1,0,0,0,0,0,1
water specialist,0,0,0,0,0,1,0,1
water storage,0,0,0,0,0,1,0,1
water stuff,0,1,0,0,0,0,0,1
water submerging,0,0,0,0,0,0,1,1
water supplier,0,0,0,0,0,1,0,1
water sympathy,0,0,0,0,0,1,0,1
water tanker,0,0,0,0,0,1,0,1
water temperatures,0,0,0,0,0,0,1,1
water tend,0,1,0,0,0,0,0,1
water tobyn,0,1,0,0,0,0,0,1
water treatment,1,0,0,0,0,0,0,1
water trickling,0,0,0,0,0,0,1,1
water uphill,0,1,0,0,0,0,0,1
water utilities,0,0,0,1,0,0,0,1
water washed,1,0,0,0,0,0,0,1
water whatsoever,1,0,0,0,0,0,0,1
water's edge,0,1,0,0,0,0,0,1
water's salinity,0,0,0,0,1,0,0,1
waterlogged weary,0,0,0,0,0,1,0,1
waters manu,0,1,0,0,0,0,0,1
waters top,0,1,0,0,0,0,0,1
waters warm,0,0,0,0,0,1,0,1
waters washed,0,0,0,0,0,1,0,1
waterton glacier,0,1,0,0,0,0,0,1
waterways laura,0,0,1,0,0,0,0,1
watery landscape,0,1,0,0,0,0,0,1
watkins reports,0,0,0,0,0,0,1,1
watsonville officials,0,0,0,1,0,0,0,1
waugh noaa,1,0,0,0,0,0,0,1
wave based,1,0,0,0,0,0,0,1
wave hurricane,0,1,0,0,0,0,0,1
wave npr's,1,0,0,0,0,0,0,1
wave podcast,1,0,0,0,0,0,0,1
wave warnings,0,1,0,0,0,0,0,1
waves climate,0,1,0,0,0,0,0,1
waves forest,0,1,0,0,0,0,0,1
waves hit,0,1,0,0,0,0,0,1
waves mass,0,1,0,0,0,0,0,1
waves rising,0,0,0,0,1,0,0,1
waves students,0,1,0,0,0,0,0,1
wavier jet,0,0,0,0,1,0,0,1
wavy jet,0,0,0,1,0,0,0,1
wax figure,0,1,0,0,0,0,0,1
wax paint,0,1,0,0,0,0,0,1
way.npr's eric,0,0,0,1,0,0,0,1
wayne winegarden,0,0,0,0,0,1,0,1
waynesboro tennessee,0,0,0,0,0,0,1,1
waziya phot,0,1,0,0,0,0,0,1
weak mandate,0,0,0,0,1,0,0,1
weaken u.s,0,0,1,0,0,0,0,1
weakened growth,1,0,0,0,0,0,0,1
weakened rules,1,0,0,0,0,0,0,1
weakening pipelines,0,0,1,0,0,0,0,1
wealth fund,0,0,0,1,0,0,0,1
wealth gap,0,0,1,0,0,0,0,1
wealthy enclave,0,0,0,1,0,0,0,1
wealthy people,0,0,0,0,1,0,0,1
wealthy phoenix,0,0,0,0,1,0,0,1
wealthy private,0,0,1,0,0,0,0,1
weapon usage,0,0,0,0,1,0,0,1
weaponry upgrade,0,0,0,1,0,0,0,1
wearing pastel,0,0,0,1,0,0,0,1
wearing thick,0,0,0,0,1,0,0,1
wears grubby,1,0,0,0,0,0,0,1
weary california,0,0,0,0,0,1,0,1
weary northerners,1,0,0,0,0,0,0,1
weather agency,1,0,0,0,0,0,0,1
weather appears,0,0,0,0,1,0,0,1
weather balloons,0,0,0,0,1,0,0,1
weather called,0,0,0,1,0,0,0,1
weather change,1,0,0,0,0,0,0,1
weather channel,0,0,0,0,0,1,0,1
weather conditions,0,0,0,0,0,0,1,1
weather confidence,0,1,0,0,0,0,0,1
weather cycle,0,1,0,0,0,0,0,1
weather cycles,1,0,0,0,0,0,0,1
weather damage,0,1,0,0,0,0,0,1
weather emergencies,0,1,0,0,0,0,0,1
weather forecast,0,0,0,1,0,0,0,1
weather front,0,0,0,0,0,1,0,1
weather future,0,0,0,0,0,1,0,1
weather gear,0,0,0,0,1,0,0,1
weather heavy,0,0,0,1,0,0,0,1
weather hemel,0,0,0,0,1,0,0,1
weather hurricane,0,1,0,0,0,0,0,1
weather including,0,0,0,0,0,1,0,1
weather nadel,0,0,0,0,0,0,1,1
weather observatory,0,0,0,0,1,0,0,1
weather office,0,0,0,0,1,0,0,1
weather patricia,0,0,0,0,0,1,0,1
weather people,0,1,0,0,0,0,0,1
weather policy,0,0,0,1,0,0,0,1
weather randy,0,0,0,0,1,0,0,1
weather records,0,0,0,1,0,0,0,1
weather season,0,1,0,0,0,0,0,1
weather slack's,0,0,0,1,0,0,0,1
weather storms,0,0,0,0,0,1,0,1
weather stuff,0,0,0,0,0,0,1,1
weather system,0,0,0,1,0,0,0,1
weather tracker,0,0,0,1,0,0,0,1
weather underground,0,0,0,1,0,0,0,1
weather warnings,0,1,0,0,0,0,0,1
weather water,0,0,0,1,0,0,0,1
weather weirdness,0,0,0,1,0,0,0,1
weather wizard,0,0,0,0,0,1,0,1
weather woe,0,0,0,0,0,1,0,1
weather's causing,0,0,0,0,1,0,0,1
weather's unpredictable,0,0,0,1,0,0,0,1
weatherization paddie,0,0,0,0,1,0,0,1
web copy,0,0,0,0,0,0,1,1
web including,0,0,0,0,0,1,0,1
webb webb,0,0,0,0,1,0,0,1
webinar hosted,1,0,0,0,0,0,0,1
webinar material,0,0,0,0,1,0,0,1
website britt,0,0,1,0,0,0,0,1
website design,0,0,1,0,0,0,0,1
website links,0,0,0,0,0,1,0,1
website poweroutage.us,0,0,0,0,1,0,0,1
wedge tornado,0,0,0,0,0,1,0,1
wednesday afternoon,0,1,0,0,0,0,0,1
wednesday alaska's,0,0,0,0,0,1,0,1
wednesday calling,1,0,0,0,0,0,0,1
wednesday increasing,0,0,0,1,0,0,0,1
wednesday josh,0,0,0,1,0,0,0,1
wednesday mario,0,0,0,0,1,0,0,1
wednesday morning,0,0,0,0,0,1,0,1
wednesday reuters,0,0,0,0,0,1,0,1
wednesday sections,0,0,0,1,0,0,0,1
wednesday snowpack,0,0,0,1,0,0,0,1
wednesday visit,1,0,0,0,0,0,0,1
wednesday water,0,0,0,0,0,1,0,1
wednesday's journal,0,0,0,0,1,0,0,1
weed lines,1,0,0,0,0,0,0,1
week ahead,0,1,0,0,0,0,0,1
week convention,0,0,1,0,0,0,0,1
week delegates,0,0,1,0,0,0,0,1
week developed,0,1,0,0,0,0,0,1
week fox,0,0,0,1,0,0,0,1
week knocking,0,0,0,1,0,0,0,1
week lauren,0,0,0,0,0,1,0,1
week lawmakers,0,0,0,0,1,0,0,1
week leaders,0,1,0,0,0,0,0,1
week luiz,0,1,0,0,0,0,0,1
week madam,0,0,1,0,0,0,0,1
week meeting,0,1,0,0,0,0,0,1
week possibly,0,0,0,1,0,0,0,1
week republicans,0,0,0,1,0,0,0,1
week residents,0,0,0,0,1,0,0,1
week schools,0,0,0,1,0,0,0,1
week stephen,0,0,0,0,1,0,0,1
week texans,0,0,0,0,1,0,0,1
week threw,0,1,0,0,0,0,0,1
week united,0,1,0,0,0,0,0,1
week voyage,0,1,0,0,0,0,0,1
week's rainwater,0,1,0,0,0,0,0,1
week's storm,0,0,0,0,1,0,0,1
week's storms,0,0,0,1,0,0,0,1
weekend china,0,0,0,0,1,0,0,1
weekend due,0,0,1,0,0,0,0,1
weekend snow,0,0,0,0,1,0,0,1
weekend yeah,0,0,0,1,0,0,0,1
weekend's weather,0,0,0,0,1,0,0,1
weeklong series,0,1,0,0,0,0,0,1
weekly newsletter,0,0,1,0,0,0,0,1
weeks officials,1,0,0,0,0,0,0,1
weekslong parade,0,0,0,0,0,0,1,1
weight loss,0,0,0,0,0,1,0,1
weird message,0,0,0,0,1,0,0,1
weiss afp,0,0,0,1,0,0,0,1
weizmann institute,0,1,0,0,0,0,0,1
welcomes yellen's,1,0,0,0,0,0,0,1
welcoming people,0,1,0,0,0,0,0,1
wenig ap,0,0,0,0,1,0,0,1
wenig seth,0,0,0,0,1,0,0,1
wentz graff,1,0,0,0,0,0,0,1
west central,0,0,0,0,0,0,1,1
west farmers,0,0,0,0,0,0,1,1
west past,0,0,0,0,1,0,0,1
west potentially,0,0,0,0,1,0,0,1
west rachel,0,0,0,1,0,0,0,1
west's fall,1,0,0,0,0,0,0,1
westerly winds,0,0,0,0,0,1,0,1
western allies,0,0,0,1,0,0,0,1
western antarctica,0,1,0,0,0,0,0,1
western canada,0,0,0,1,0,0,0,1
western carolina,0,1,0,0,0,0,0,1
western coast,0,1,0,0,0,0,0,1
western designed,0,0,0,1,0,0,0,1
western developed,0,1,0,0,0,0,0,1
western economies,0,0,0,1,0,0,0,1
western europe,0,0,0,0,0,1,0,1
western governors,0,0,0,0,1,0,0,1
western half,1,0,0,0,0,0,0,1
western hemisphere,0,0,0,0,1,0,0,1
western kansas,0,0,1,0,0,0,0,1
western megadrought,0,0,0,0,1,0,0,1
western mississippi,0,0,0,0,0,1,0,1
western nations,0,0,0,1,0,0,0,1
western pacific,0,0,0,1,0,0,0,1
western portions,0,0,0,0,1,0,0,1
western tennessee,0,0,0,0,0,1,0,1
western washington,0,0,0,0,1,0,0,1
western water,0,0,0,0,1,0,0,1
western world,0,1,0,0,0,0,0,1
westervelt joins,0,0,0,1,0,0,0,1
westminster college,0,0,0,0,1,0,0,1
wet escutia,0,0,0,0,0,0,1,1
wet period,1,0,0,0,0,0,0,1
wet periods,0,0,0,1,0,0,0,1
wet snow,0,0,0,0,0,1,0,1
wetlands bottom,0,1,0,0,0,0,0,1
wetlands clean,0,0,1,0,0,0,0,1
whale voiced,0,0,0,0,0,0,1,1
whales die,0,0,0,0,1,0,0,1
whales kim,0,0,0,0,1,0,0,1
whales noaa,0,0,0,0,1,0,0,1
whales north,0,0,0,0,1,0,0,1
whales produce,0,0,0,0,0,1,0,1
whales seals,0,0,0,0,0,1,0,1
whales vocal,0,0,0,0,0,1,0,1
whales washing,0,0,0,0,1,0,0,1
whaling expanded,0,1,0,0,0,0,0,1
whipped seas,1,0,0,0,0,0,0,1
whirlpool corporation,0,0,0,0,1,0,0,1
whispered rodríguez,0,1,0,0,0,0,0,1
whistleblower reprisal,0,0,0,0,0,0,1,1
white balloon,0,0,0,0,1,0,0,1
white collar,0,0,0,0,0,1,0,1
white color,0,1,0,0,0,0,0,1
white community,0,0,0,1,0,0,0,1
white eggs,0,0,0,0,0,1,0,1
white glow,0,0,0,1,0,0,0,1
white identitarian,0,0,0,0,0,1,0,1
white mine,1,0,0,0,0,0,0,1
white mountains,0,0,0,0,1,0,0,1
white patches,0,1,0,0,0,0,0,1
white sand,0,0,0,0,1,0,0,1
white sandstone,0,1,0,0,0,0,0,1
white stalk,0,0,0,0,0,1,0,1
white van,0,0,0,0,1,0,0,1
whiteface mountain,0,0,0,0,1,0,0,1
whitesburg water,0,1,0,0,0,0,0,1
who've called,0,0,0,0,0,1,0,1
who've glued,0,0,1,0,0,0,0,1
who've lived,0,1,0,0,0,0,0,1
who've reached,0,0,0,0,0,1,0,1
who've recently,0,0,0,1,0,0,0,1
who've suffered,0,1,0,0,0,0,0,1
who've traveled,0,1,0,0,0,0,0,1
whooshing sounds,0,0,0,0,0,0,1,1
wide access,0,0,0,0,0,1,0,1
wide fund,0,0,0,0,1,0,0,1
wide north,0,1,0,0,0,0,0,1
wide ranging,0,0,0,0,0,1,0,1
wide scale,0,0,0,0,0,1,0,1
wide solution,0,1,0,0,0,0,0,1
wide spread,0,1,0,0,0,0,0,1
wide swaths,0,0,0,0,0,0,1,1
wide trailer,0,0,0,1,0,0,0,1
widely circulated,0,1,0,0,0,0,0,1
widening rivers,0,0,0,0,1,0,0,1
wider adoption,0,0,0,0,1,0,0,1
wider damage,0,0,0,1,0,0,0,1
wider plastic,0,0,0,1,0,0,0,1
wider public,0,0,0,0,0,1,0,1
widespread adoption,0,0,0,0,1,0,0,1
widespread calamities,0,1,0,0,0,0,0,1
widespread child,1,0,0,0,0,0,0,1
widespread damage,0,0,0,1,0,0,0,1
widespread dissatisfaction,0,0,0,1,0,0,0,1
widespread flood,0,0,0,0,1,0,0,1
widespread gusty,0,0,0,0,1,0,0,1
widespread loss,0,0,1,0,0,0,0,1
widespread losses,1,0,0,0,0,0,0,1
widespread melting,0,1,0,0,0,0,0,1
widespread public,0,0,0,1,0,0,0,1
widespread rain,0,0,0,0,1,0,0,1
widespread snowstorm,0,0,0,0,1,0,0,1
widespread stifling,0,1,0,0,0,0,0,1
widespread support,0,0,0,0,1,0,0,1
widest glacier,0,0,0,0,1,0,0,1
wife bake,0,0,0,0,1,0,0,1
wife lori,0,1,0,0,0,0,0,1
wild counterparts,0,0,0,0,0,0,1,1
wild experience,0,0,0,0,1,0,0,1
wild inaudible,0,0,1,0,0,0,0,1
wild reefs,0,0,0,0,0,0,1,1
wild species,0,0,1,0,0,0,0,1
wild texas,0,0,0,0,0,0,1,1
wild world,0,0,1,0,0,0,0,1
wild.the beams,0,0,1,0,0,0,0,1
wilder's house,1,0,0,0,0,0,0,1
wildfire chip,0,0,0,0,0,1,0,1
wildfire people,0,0,0,0,1,0,0,1
wildfire prevention,0,0,1,0,0,0,0,1
wildfire response,0,0,1,0,0,0,0,1
wildfire season,1,0,0,0,0,0,0,1
wildfire stretching,0,0,0,0,0,1,0,1
wildfires blazed,1,0,0,0,0,0,0,1
wildfires boosted,1,0,0,0,0,0,0,1
wildlife advocates,0,0,1,0,0,0,0,1
wildlife authorities,1,0,0,0,0,0,0,1
wildlife conservation,0,0,1,0,0,0,0,1
wildlife death,0,0,1,0,0,0,0,1
wildlife experts,1,0,0,0,0,0,0,1
wildlife federation,0,0,1,0,0,0,0,1
wildlife officials,1,0,0,0,0,0,0,1
wildlife program,0,1,0,0,0,0,0,1
wildlife remove,0,1,0,0,0,0,0,1
wildlife sick,0,0,0,1,0,0,0,1
wildlife supporting,0,0,0,0,0,1,0,1
wilhelmina bay,0,1,0,0,0,0,0,1
willem alexander,0,0,0,0,0,1,0,1
william moomaw,1,0,0,0,0,0,0,1
william ruto,1,0,0,0,0,0,0,1
williams cautioned,0,0,0,0,1,0,0,1
williams gas,0,0,0,0,1,0,0,1
williams williams,0,0,0,0,1,0,0,1
willie rivera,0,1,0,0,0,0,0,1
willie rivera's,0,1,0,0,0,0,0,1
willow fits,0,0,0,0,0,1,0,1
willow risks,0,0,0,0,0,1,0,1
willow site,0,0,0,0,0,1,0,1
willow's impact,0,0,0,0,0,1,0,1
willow's proposed,0,0,0,0,0,1,0,1
willowproject stopwillow,0,0,0,0,0,1,0,1
wilmington del,0,0,0,0,0,1,0,1
wilson center,0,0,0,0,0,1,0,1
wilson reports,0,0,0,0,1,0,0,1
wimmer ceo,0,1,0,0,0,0,0,1
win contracts,0,0,1,0,0,0,0,1
win lose,0,0,0,0,1,0,0,1
wind advocates,0,0,0,0,1,0,0,1
wind anderson,0,0,0,0,1,0,0,1
wind beat,0,0,0,1,0,0,0,1
wind chills,0,0,0,0,1,0,0,1
wind experts,0,0,0,0,1,0,0,1
wind parks,0,0,0,1,0,0,0,1
wind project,0,0,0,0,1,0,0,1
wind projects,0,0,0,0,1,0,0,1
wind risk,0,0,0,0,1,0,0,1
wind solar,0,0,0,0,1,0,0,1
wind speed,0,0,0,0,0,1,0,1
wind surveying,0,0,0,0,1,0,0,1
wind whipped,0,1,0,0,0,0,0,1
wind whistling,0,0,0,0,0,1,0,1
windchill temperature,0,0,0,0,1,0,0,1
windchill temperatures,0,0,0,0,1,0,0,1
windfall compared,1,0,0,0,0,0,0,1
windfall taxes,1,0,0,0,0,0,0,1
winding streets,0,1,0,0,0,0,0,1
window screen,0,0,0,0,1,0,0,1
windows diaa,1,0,0,0,0,0,0,1
winds blowing,0,0,0,0,1,0,0,1
winds composed,0,0,0,0,1,0,0,1
winds extend,0,1,0,0,0,0,0,1
winds mudslides,0,0,0,0,0,1,0,1
winds picked,1,0,0,0,0,0,0,1
winds toppled,0,0,0,0,1,0,0,1
windshield wipers,0,0,0,0,1,0,0,1
windsor consulting,0,0,0,0,1,0,0,1
windsor essex,0,0,0,0,0,1,0,1
windsor mayor,0,0,0,0,0,1,0,1
wine insect,0,0,0,0,0,1,0,1
wing donors,0,0,0,0,1,0,0,1
wing figures,0,0,0,0,0,1,0,1
wing furor,0,0,0,1,0,0,0,1
wing politicians,0,0,0,0,0,1,0,1
wing pundits,0,0,0,0,0,1,0,1
wing vernacular,0,0,0,0,0,1,0,1
wings jerk,1,0,0,0,0,0,0,1
winner malala,0,0,0,0,1,0,0,1
winnie omwakwe,0,1,0,0,0,0,0,1
winning dunn,0,0,1,0,0,0,0,1
winning platform,0,1,0,0,0,0,0,1
winona staying,0,0,0,0,0,1,0,1
winter davis,0,0,0,1,0,0,0,1
winter disappear,0,0,0,1,0,0,0,1
winter explains,0,1,0,0,0,0,0,1
winter fantasy,0,0,0,0,1,0,0,1
winter games,0,0,0,0,1,0,0,1
winter harold,0,0,0,1,0,0,0,1
winter heating,0,0,0,1,0,0,0,1
winter hit,0,0,0,0,0,1,0,1
winter income,0,0,0,1,0,0,0,1
winter produce,0,0,0,0,0,1,0,1
winter temperatures,0,0,0,0,1,0,0,1
winter traditions,0,0,0,0,1,0,0,1
winter vegetables,0,0,0,0,0,1,0,1
winter warming,0,0,0,1,0,0,0,1
winter weary,1,0,0,0,0,0,0,1
winter wonderland,0,0,0,0,1,0,0,1
winter's cold,0,0,0,0,0,0,1,1
winter's storms,0,0,0,0,0,0,1,1
winter's strong,0,0,0,1,0,0,0,1
winterization christi,0,0,0,0,1,0,0,1
winterize critics,0,0,0,0,1,0,0,1
wintertime cold,0,0,0,0,1,0,0,1
wintertime position,0,0,0,0,0,0,1,1
wintry precipitation,0,0,0,0,1,0,0,1
withholding information,0,1,0,0,0,0,0,1
withstand droughts,0,0,1,0,0,0,0,1
withstand dry,0,0,1,0,0,0,0,1
withstand increasingly,0,0,0,1,0,0,0,1
witnessed profound,0,1,0,0,0,0,0,1
witnesses demonstrated,0,0,0,1,0,0,0,1
witnessing people,1,0,0,0,0,0,0,1
wittpenn bloomberg,0,1,0,0,0,0,0,1
wizard daniel,0,0,0,0,0,1,0,1
wls tv,0,0,0,0,0,0,1,1
wmo secretary,1,0,0,0,0,0,0,1
wmo sets,1,0,0,0,0,0,0,1
woke saturday,0,0,0,0,0,0,1,1
wolfgang berger,1,0,0,0,0,0,0,1
woman balances,0,0,0,0,0,1,0,1
woman calls,1,0,0,0,0,0,0,1
woman died,0,0,0,1,0,0,0,1
woman explains,1,0,0,0,0,0,0,1
woman frantically,0,0,0,0,1,0,0,1
woman impatiently,1,0,0,0,0,0,0,1
woman screaming,0,0,0,0,0,1,0,1
woman shakes,1,0,0,0,0,0,0,1
woman walks,1,0,0,0,0,0,0,1
woman's swollen,1,0,0,0,0,0,0,1
women built,1,0,0,0,0,0,0,1
women crammed,1,0,0,0,0,0,0,1
women describe,0,0,0,0,0,1,0,1
women entrepreneurs,0,1,0,0,0,0,0,1
women exclusively,0,1,0,0,0,0,0,1
women farmer,0,1,0,0,0,0,0,1
women farmers,0,1,0,0,0,0,0,1
women follow,1,0,0,0,0,0,0,1
women generate,0,1,0,0,0,0,0,1
women grow,0,1,0,0,0,0,0,1
women helps,0,1,0,0,0,0,0,1
women involved,0,1,0,0,0,0,0,1
women swayam,0,1,0,0,0,0,0,1
women zinat,1,0,0,0,0,0,0,1
women's rights,0,0,0,0,0,1,0,1
women's suffrage,0,0,0,0,0,1,0,1
won brazil's,0,1,0,0,0,0,0,1
won election,0,0,1,0,0,0,0,1
wood fell,0,0,0,0,0,0,1,1
wood frames,0,1,0,0,0,0,0,1
wood mackenzie,0,0,1,0,0,0,0,1
wood paneled,0,1,0,0,0,0,0,1
wood products,1,0,0,0,0,0,0,1
wooden sticks,1,0,0,0,0,0,0,1
wooden utensils,0,0,0,1,0,0,0,1
woodland hills,0,0,0,0,1,0,0,1
woodlands dead,0,0,1,0,0,0,0,1
woodlands tree,0,0,1,0,0,0,0,1
woods capture,1,0,0,0,0,0,0,1
woodwell climate,0,0,0,1,0,0,0,1
wool hat,0,1,0,0,0,0,0,1
word answer,1,0,0,0,0,0,0,1
word ban,0,0,0,1,0,0,0,1
word berhe,0,0,1,0,0,0,0,1
word breakthrough,0,0,0,0,1,0,0,1
word choice,0,0,0,0,1,0,0,1
word debate,0,1,0,0,0,0,0,1
word kenya,0,1,0,0,0,0,0,1
word migration,0,0,0,0,1,0,0,1
word nate,0,0,0,0,0,1,0,1
word solutions,0,0,0,0,1,0,0,1
words fears,0,0,0,1,0,0,0,1
words im,0,0,0,1,0,0,0,1
words matter,0,0,0,0,1,0,0,1
words partnership,0,1,0,0,0,0,0,1
worker moomal,1,0,0,0,0,0,0,1
worker obligations,1,0,0,0,0,0,0,1
workers building,0,1,0,0,0,0,0,1
workers jharia,0,0,0,0,1,0,0,1
workers music,0,1,0,0,0,0,0,1
workers roll,0,1,0,0,0,0,0,1
workers searching,0,1,0,0,0,0,0,1
workers stand,0,1,0,0,0,0,0,1
workers suhani,0,0,0,0,1,0,0,1
workers sweating,0,1,0,0,0,0,0,1
workers wait,0,1,0,0,0,0,0,1
workers walaa,0,0,0,0,1,0,0,1
workforce capable,0,0,0,0,0,1,0,1
workforce.martí npr's,0,0,0,0,0,1,0,1
workforces india,0,1,0,0,0,0,0,1
workplace accidents,0,1,0,0,0,0,0,1
workplace health,0,0,0,0,1,0,0,1
world ahead,0,0,0,0,0,1,0,1
world airport,0,0,1,0,0,0,0,1
world airports,0,0,1,0,0,0,0,1
world alongside,0,0,1,0,0,0,0,1
world american,1,0,0,0,0,0,0,1
world chronicled,0,0,0,1,0,0,0,1
world climate,0,1,0,0,0,0,0,1
world continues,0,0,0,0,1,0,0,1
world credit,0,1,0,0,0,0,0,1
world depend,0,1,0,0,0,0,0,1
world economies,0,1,0,0,0,0,0,1
world extreme,0,0,0,0,0,1,0,1
world facing,0,0,0,0,0,1,0,1
world famous,0,1,0,0,0,0,0,1
world flores,0,0,0,0,0,0,1,1
world food,0,0,1,0,0,0,0,1
world forecasters,0,0,0,0,1,0,0,1
world gore,0,1,0,0,0,0,0,1
world grapples,0,0,0,0,1,0,0,1
world hey,0,0,0,0,1,0,0,1
world history,0,0,0,1,0,0,0,1
world hunger,0,1,0,0,0,0,0,1
world huq,0,0,0,0,0,1,0,1
world increasingly,0,0,0,1,0,0,0,1
world invested,0,0,0,0,0,1,0,1
world jeremy,0,1,0,0,0,0,0,1
world kelleher,0,0,0,0,1,0,0,1
world kenyan,0,1,0,0,0,0,0,1
world kqed's,0,0,0,0,0,0,1,1
world leader,0,1,0,0,0,0,0,1
world meets,0,1,0,0,0,0,0,1
world muriente,0,0,0,1,0,0,0,1
world ocean,0,0,1,0,0,0,0,1
world organisation,0,0,0,0,0,1,0,1
world passes,0,1,0,0,0,0,0,1
world people,0,1,0,0,0,0,0,1
world police,0,0,0,0,1,0,0,1
world provide,0,0,0,0,1,0,0,1
world pushing,0,0,0,1,0,0,0,1
world quickly,0,0,0,0,0,1,0,1
world recession,1,0,0,0,0,0,0,1
world risks,0,1,0,0,0,0,0,1
world runs,0,0,0,1,0,0,0,1
world sala,0,1,0,0,0,0,0,1
world series,1,0,0,0,0,0,0,1
world shadow,0,0,0,0,0,1,0,1
world simply,1,0,0,0,0,0,0,1
world soil,0,0,1,0,0,0,0,1
world spending,0,1,0,0,0,0,0,1
world stage,0,1,0,0,0,0,0,1
world starts,0,0,0,0,1,0,0,1
world tackle,0,1,0,0,0,0,0,1
world tyrone,0,1,0,0,0,0,0,1
world urgently,0,0,0,0,1,0,0,1
world violet,0,1,0,0,0,0,0,1
world warms,0,0,0,0,0,1,0,1
world weather,0,0,0,1,0,0,0,1
world wide,0,0,0,0,1,0,0,1
world yeah,0,0,0,1,0,0,0,1
world's biggest,0,0,0,1,0,0,0,1
world's biodiversity,0,0,1,0,0,0,0,1
world's cities,0,0,0,0,0,1,0,1
world's climate,0,1,0,0,0,0,0,1
world's economic,0,1,0,0,0,0,0,1
world's environment,0,0,1,0,0,0,0,1
world's forests,0,1,0,0,0,0,0,1
world's freezer,0,1,0,0,0,0,0,1
world's glaciers,0,0,0,1,0,0,0,1
world's greenhouse,0,1,0,0,0,0,0,1
world's hottest,0,0,0,1,0,0,0,1
world's lands,0,0,1,0,0,0,0,1
world's leading,0,0,1,0,0,0,0,1
world's lithium,0,1,0,0,0,0,0,1
world's nations,0,1,0,0,0,0,0,1
world's natural,0,0,1,0,0,0,0,1
world's potential,0,1,0,0,0,0,0,1
world's rare,0,0,0,1,0,0,0,1
world's richest,0,1,0,0,0,0,0,1
world's roughly,0,0,0,1,0,0,0,1
world's soil,0,0,1,0,0,0,0,1
world's tallest,0,0,0,1,0,0,0,1
world's top,0,1,0,0,0,0,0,1
world's water,0,0,0,0,0,1,0,1
world's worst,0,0,0,0,0,1,0,1
worldwide climate,0,0,1,0,0,0,0,1
worldwide depend,0,1,0,0,0,0,0,1
worldwide inflation,0,1,0,0,0,0,0,1
worldwide spread,0,0,0,0,0,1,0,1
worldwide thornton,1,0,0,0,0,0,0,1
worldwide toll,0,1,0,0,0,0,0,1
worms prompting,0,0,0,0,0,1,0,1
worried carly,0,0,0,0,1,0,0,1
worries scientists,0,0,1,0,0,0,0,1
worry slightly,0,0,0,1,0,0,0,1
worrying decline,0,0,1,0,0,0,0,1
worrying environmental,0,0,0,1,0,0,0,1
worse brazil,0,1,0,0,0,0,0,1
worse climate,0,0,0,1,0,0,0,1
worse dan,0,0,0,1,0,0,0,1
worse diffenbaugh,0,0,0,1,0,0,0,1
worse due,0,0,0,0,0,0,1,1
worse fit,0,0,0,1,0,0,0,1
worse food,1,0,0,0,0,0,0,1
worse harford,0,0,0,0,0,1,0,1
worse scientists,0,1,0,0,0,0,0,1
worse thomas,1,0,0,0,0,0,0,1
worse yeah,0,0,0,0,1,0,0,1
worsen climate,0,0,0,0,0,1,0,1
worsening homelessness,1,0,0,0,0,0,0,1
worsening supercells,0,0,0,0,0,1,0,1
worsens include,0,0,0,0,0,1,0,1
worsens wildfires,0,0,0,1,0,0,0,1
worst affected,1,0,0,0,0,0,0,1
worst air,0,0,0,0,0,1,0,1
worst airport,0,0,1,0,0,0,0,1
worst begum,0,0,0,0,0,1,0,1
worst cyclones,0,0,0,0,0,1,0,1
worst drought,1,0,0,0,0,0,0,1
worst flash,0,0,0,0,0,1,0,1
worst flood,0,0,0,1,0,0,0,1
worst nightmare,0,0,0,1,0,0,0,1
worst rainfall,1,0,0,0,0,0,0,1
worst storm,1,0,0,0,0,0,0,1
worst sufferers,0,0,0,0,0,1,0,1
worst week,0,0,0,0,0,0,1,1
worth confirmed,0,1,0,0,0,0,0,1
worth metroplex,0,0,0,0,0,0,1,1
worth millions,0,0,0,0,1,0,0,1
worth saving,1,0,0,0,0,0,0,1
wow consumers,0,1,0,0,0,0,0,1
wrapped representatives,0,1,0,0,0,0,0,1
wrecked homes,0,0,0,0,0,0,1,1
wresnford describes,0,0,1,0,0,0,0,1
wright retired,0,0,0,0,1,0,0,1
write climate,0,1,0,0,0,0,0,1
write favorably,0,0,1,0,0,0,0,1
write plans,1,0,0,0,0,0,0,1
writer ayana,0,0,0,1,0,0,0,1
writer published,0,0,0,0,0,1,0,1
writhing baby,1,0,0,0,0,0,0,1
writing form,0,0,0,0,0,1,0,1
writing plans,0,0,0,0,0,1,0,1
written statement,0,0,0,1,0,0,0,1
wrong citizens,0,0,0,0,1,0,0,1
wrote american,0,0,0,0,1,0,0,1
wrote amtrak,1,0,0,0,0,0,0,1
wrote consecutive,0,0,0,0,0,1,0,1
wrote cpsc,0,0,0,0,1,0,0,1
wrote critically,0,0,1,0,0,0,0,1
wrote directly,0,0,0,0,0,1,0,1
wrote exxonmobil,0,0,0,1,0,0,0,1
wrote fda,0,1,0,0,0,0,0,1
wrote u.s,0,0,0,1,0,0,0,1
wuhan market,0,0,0,0,0,1,0,1
wunc reports,0,1,0,0,0,0,0,1
wwno's halle,1,0,0,0,0,0,0,1
wyn wiley,1,0,0,0,0,0,0,1
wynne arkansas,0,0,0,0,0,0,1,1
wyoming montana,0,0,0,0,1,0,0,1
wyoming senator,0,1,0,0,0,0,0,1
xenophobic politicians,1,0,0,0,0,0,0,1
xie zhenhua,0,1,0,0,0,0,0,1
ximena bustillo,0,0,0,0,0,0,1,1
xl oil,0,0,0,0,0,1,0,1
yael kiro,0,1,0,0,0,0,0,1
yagana ali,0,0,1,0,0,0,0,1
yale program,0,0,0,1,0,0,0,1
yamada collects,0,0,0,0,1,0,0,1
yamada drags,0,0,0,0,1,0,0,1
yangtze river,0,0,0,0,0,1,0,1
yankee hurricane,0,1,0,0,0,0,0,1
yanoviak quantitative,0,0,1,0,0,0,0,1
yard communities,0,0,0,0,0,1,0,1
yard mentality,0,0,0,0,1,0,0,1
yardstick stuck,0,0,0,0,0,1,0,1
yasuhiro oba,0,0,0,0,0,1,0,1
yawning supply,0,0,0,1,0,0,0,1
yeah admittedly,0,1,0,0,0,0,0,1
yeah amazing,0,0,0,0,0,1,0,1
yeah desperately,0,0,0,1,0,0,0,1
yeah diop,0,1,0,0,0,0,0,1
yeah europeans,0,1,0,0,0,0,0,1
yeah house,0,0,0,1,0,0,0,1
yeah lauren,0,0,0,1,0,0,0,1
yeah luckily,1,0,0,0,0,0,0,1
yeah pretty,0,0,0,0,1,0,0,1
yeah saturday,0,0,0,1,0,0,0,1
yeah southern,1,0,0,0,0,0,0,1
yeah speaking,0,0,1,0,0,0,0,1
yeah yeah.the,0,1,0,0,0,0,0,1
year.congresswoman chellie,0,0,0,1,0,0,0,1
year.daniel estrin,0,1,0,0,0,0,0,1
year.for npr,0,0,0,0,1,0,0,1
year.martí yeah,0,0,0,0,0,1,0,1
year.one concrete,0,1,0,0,0,0,0,1
year's brought,0,0,0,1,0,0,0,1
year's cbd,0,0,1,0,0,0,0,1
year's conference,0,1,0,0,0,0,0,1
year's cyclone,0,0,0,0,0,1,0,1
year's deluges,0,0,0,0,0,1,0,1
year's devastating,0,0,0,0,0,1,0,1
year's drought,0,1,0,0,0,0,0,1
year's events,0,0,0,0,0,0,1,1
year's helsinki,0,1,0,0,0,0,0,1
year's holiday,0,0,0,1,0,0,0,1
year's huge,1,0,0,0,0,0,0,1
year's negotiations,0,0,0,0,0,1,0,1
year's storms,0,0,0,0,0,1,0,1
year's tax,0,0,0,0,0,0,1,1
year's united,0,0,0,1,0,0,0,1
year's weekend,0,0,0,1,0,0,0,1
year's winter,0,0,0,0,0,1,0,1
yearly rainfall,1,0,0,0,0,0,0,1
yeast fermentation,0,1,0,0,0,0,0,1
yellen called,0,1,0,0,0,0,0,1
yellen delivered,1,0,0,0,0,0,0,1
yellen meets,0,0,0,0,1,0,0,1
yellen's leadership,1,0,0,0,0,0,0,1
yellow colored,0,0,0,0,0,0,1,1
yellow gadsden,0,0,0,1,0,0,0,1
yellow line,1,0,0,0,0,0,0,1
yellow snowplow,0,0,0,1,0,0,0,1
yellowhammer multimedia,0,0,1,0,0,0,0,1
yellowhorse kesler,0,0,1,0,0,0,0,1
yenigun sarah,0,1,0,0,0,0,0,1
yesterday basically,0,0,0,0,0,1,0,1
yesterday frostbite,0,0,0,0,1,0,0,1
yesterday president,0,0,0,0,0,1,0,1
yesterday rivers,0,0,0,0,0,1,0,1
yesterday's news,0,0,0,0,0,1,0,1
yglesias tweeted,0,0,0,1,0,0,0,1
yi walks,0,1,0,0,0,0,0,1
yi yi,0,1,0,0,0,0,0,1
yiddish curses,0,0,0,1,0,0,0,1
ynez mountains,0,0,0,1,0,0,0,1
yoakam chris,0,1,0,0,0,0,0,1
yogurt cups,1,0,0,0,0,0,0,1
york attorney,0,0,0,1,0,0,0,1
york based,0,0,0,1,0,0,0,1
york boston,1,0,0,0,0,0,0,1
york city's,0,0,1,0,0,0,0,1
york company,0,0,0,0,1,0,0,1
york dropped,0,0,0,0,1,0,0,1
york maine,0,0,0,0,1,0,0,1
york massachusetts,0,0,1,0,0,0,0,1
york oregon,0,0,0,0,0,1,0,1
york program,0,1,0,0,0,0,0,1
york suzanne,0,0,1,0,0,0,0,1
york times,0,1,0,0,0,0,0,1
york townhouse,0,0,0,1,0,0,0,1
yosemite national,0,1,0,0,0,0,0,1
youngkin republicans,1,0,0,0,0,0,0,1
youth bulge,0,1,0,0,0,0,0,1
youth education,0,1,0,0,0,0,0,1
youth led,0,1,0,0,0,0,0,1
youthful continent,0,1,0,0,0,0,0,1
youtube video,0,0,0,0,0,1,0,1
yucel afp,1,0,0,0,0,0,0,1
yugtun jobe,0,0,1,0,0,0,0,1
yunnan province,0,1,0,0,0,0,0,1
yuri cortez,0,0,0,0,0,1,0,1
zach thompson,0,1,0,0,0,0,0,1
zakariya mallah,1,0,0,0,0,0,0,1
zaken ph,0,1,0,0,0,0,0,1
zaman ruksana,1,0,0,0,0,0,0,1
zardari joins,0,1,0,0,0,0,0,1
zayed al,0,0,0,1,0,0,0,1
zealand prime,0,0,0,0,1,0,0,1
zealand thinking,0,0,0,0,1,0,0,1
zealand's aging,0,0,0,0,1,0,0,1
zealand's cities,0,0,0,0,1,0,0,1
zealand's national,0,0,0,0,1,0,0,1
zealand's te,0,1,0,0,0,0,0,1
zeke hausfather,0,0,0,1,0,0,0,1
zem soul,1,0,0,0,0,0,0,1
zemela ph,1,0,0,0,0,0,0,1
zemela pope,1,0,0,0,0,0,0,1
zeng yuqun,0,1,0,0,0,0,0,1
zers passionate,0,0,0,0,0,1,0,1
zinat's daughter,1,0,0,0,0,0,0,1
zones elevations,0,0,0,0,0,1,0,1
zoning rules,0,1,0,0,0,0,0,1
